//MAP CONVERTED BY dmm2tgm.py THIS HEADER COMMENT PREVENTS RECONVERSION, DO NOT REMOVE
"a" = (
/turf/simulated/floor/road,
/area/dmm_suite/clear_area)
"b" = (
/turf/dmm_suite/clear_turf,
/area/dmm_suite/clear_area)
"d" = (
/obj/structure/interactive/stopsign,
/turf/simulated/floor/sidewalk,
/area/dmm_suite/clear_area)
"e" = (
/obj/decal/road_marking/solid_line{
	icon_state = "1";
	dir = 4
	},
/turf/simulated/floor/road,
/area/dmm_suite/clear_area)
"i" = (
/obj/decal/road_marking/dotted_line/half{
	icon_state = "1";
	dir = 1
	},
/turf/simulated/floor/road,
/area/dmm_suite/clear_area)
"j" = (
/obj/decal/road_marking/solid_stop,
/turf/simulated/floor/road,
/area/dmm_suite/clear_area)
"k" = (
/obj/decal/road_marking/dotted_line/half{
	icon_state = "1";
	dir = 8
	},
/turf/simulated/floor/road,
/area/dmm_suite/clear_area)
"l" = (
/obj/decal/road_marking/solid_cross,
/turf/simulated/floor/road,
/area/dmm_suite/clear_area)
"m" = (
/obj/decal/road_marking/dotted_line/half,
/turf/simulated/floor/road,
/area/dmm_suite/clear_area)
"n" = (
/obj/structure/interactive/lighting/roadlamp{
	icon_state = "lamp";
	dir = 1
	},
/turf/simulated/floor/sidewalk,
/area/dmm_suite/clear_area)
"o" = (
/obj/decal/road_marking/solid_line/offset/yellow{
	icon_state = "1";
	dir = 4
	},
/turf/simulated/floor/road,
/area/dmm_suite/clear_area)
"p" = (
/obj/decal/road_marking/dotted_line/half{
	icon_state = "1";
	dir = 4
	},
/turf/simulated/floor/road,
/area/dmm_suite/clear_area)
"q" = (
/obj/structure/interactive/stopsign{
	icon_state = "sign";
	dir = 8
	},
/turf/simulated/floor/sidewalk,
/area/dmm_suite/clear_area)
"s" = (
/obj/marker/prefab/city/parking,
/turf/dmm_suite/clear_turf,
/area/dmm_suite/clear_area)
"v" = (
/obj/marker/blob,
/turf/simulated/floor/road,
/area/dmm_suite/clear_area)
"x" = (
/obj/structure/interactive/stopsign{
	icon_state = "sign";
	dir = 1
	},
/obj/structure/interactive/stopsign{
	icon_state = "sign";
	dir = 1
	},
/turf/dmm_suite/clear_turf,
/area/dmm_suite/clear_area)
"z" = (
/obj/decal/road_marking/solid_line/offset/yellow{
	icon_state = "1";
	dir = 8
	},
/turf/simulated/floor/road,
/area/dmm_suite/clear_area)
"C" = (
/obj/decal/road_marking/solid_cross,
/turf/dmm_suite/clear_turf,
/area/dmm_suite/clear_area)
"E" = (
/obj/decal/road_marking/solid_stop{
	icon_state = "1";
	dir = 8
	},
/turf/simulated/floor/road,
/area/dmm_suite/clear_area)
"F" = (
/turf/simulated/floor/sidewalk,
/area/dmm_suite/clear_area)
"I" = (
/obj/decal/road_marking/solid_line,
/turf/simulated/floor/road,
/area/dmm_suite/clear_area)
"J" = (
/obj/decal/road_marking/solid_line/offset/yellow,
/turf/simulated/floor/road,
/area/dmm_suite/clear_area)
"K" = (
/obj/structure/interactive/lighting/roadlamp{
	icon_state = "lamp";
	dir = 8
	},
/turf/simulated/floor/sidewalk,
/area/dmm_suite/clear_area)
"N" = (
/obj/structure/interactive/lighting/roadlamp,
/turf/simulated/floor/sidewalk,
/area/dmm_suite/clear_area)
"O" = (
/obj/structure/interactive/stopsign{
	icon_state = "sign";
	dir = 4
	},
/turf/simulated/floor/sidewalk,
/area/dmm_suite/clear_area)
"T" = (
/obj/marker/prefab/city/store{
	dir = 1
	},
/turf/dmm_suite/clear_turf,
/area/dmm_suite/clear_area)
"U" = (
/obj/marker/prefab/city/store,
/turf/dmm_suite/clear_turf,
/area/dmm_suite/clear_area)
"W" = (
/obj/decal/road_marking/solid_stop{
	icon_state = "1";
	dir = 4
	},
/turf/simulated/floor/road,
/area/dmm_suite/clear_area)
"Y" = (
/obj/decal/road_marking/solid_cross{
	icon_state = "1";
	dir = 4
	},
/turf/simulated/floor/road,
/area/dmm_suite/clear_area)

(1,1,1) = {"
b
b
b
b
b
b
b
b
b
b
b
b
b
b
b
b
U
F
e
a
m
i
a
e
F
b
b
b
b
b
b
b
b
b
b
b
b
b
b
b
b
b
"}
(2,1,1) = {"
b
b
b
b
b
b
b
b
b
b
b
b
b
b
b
b
b
F
e
a
m
i
a
e
F
b
b
b
b
b
b
b
b
b
b
b
b
b
b
b
T
b
"}
(3,1,1) = {"
b
b
b
b
b
b
b
b
b
b
b
b
b
b
b
b
b
F
e
a
m
i
a
e
F
b
b
b
b
b
b
b
b
b
b
b
b
b
b
b
b
b
"}
(4,1,1) = {"
b
b
b
b
b
b
b
b
b
b
b
b
b
b
b
b
b
F
e
a
m
i
a
e
F
b
b
b
b
b
b
b
b
b
b
b
b
b
b
b
b
b
"}
(5,1,1) = {"
b
b
b
b
b
b
b
b
b
b
b
b
b
b
b
b
b
F
e
a
m
i
a
e
F
b
b
b
b
b
b
b
b
b
b
b
b
b
b
b
b
b
"}
(6,1,1) = {"
b
b
b
b
b
b
b
b
b
b
b
b
b
b
b
b
b
F
e
a
m
i
a
e
F
b
b
b
b
b
b
b
b
b
b
b
b
b
b
b
b
b
"}
(7,1,1) = {"
b
b
b
b
b
b
b
b
b
b
b
b
b
b
b
b
b
F
e
a
m
i
a
e
F
b
b
b
b
b
b
b
b
b
b
b
b
b
b
b
b
b
"}
(8,1,1) = {"
b
b
b
b
b
b
b
b
b
b
b
b
b
b
b
b
b
F
e
a
m
i
a
e
F
b
b
b
b
b
b
b
b
b
b
b
b
b
b
b
b
b
"}
(9,1,1) = {"
b
b
b
b
b
b
b
b
b
b
b
b
b
b
b
b
b
F
e
a
m
i
a
e
F
b
b
b
b
b
b
b
b
b
b
b
b
b
b
b
b
b
"}
(10,1,1) = {"
b
b
b
b
b
b
b
b
b
b
b
b
b
b
b
b
b
F
e
a
m
i
a
e
F
b
b
b
b
b
b
b
b
b
b
b
b
b
b
b
b
b
"}
(11,1,1) = {"
b
b
b
b
b
b
b
b
b
b
b
b
b
b
b
b
b
F
e
a
m
i
a
e
F
b
b
b
b
b
b
b
b
b
b
b
b
b
b
b
b
b
"}
(12,1,1) = {"
b
b
b
b
b
b
b
b
b
b
b
b
b
b
b
b
b
F
e
a
m
i
a
e
F
b
b
b
b
b
b
b
b
b
b
b
b
b
b
b
b
b
"}
(13,1,1) = {"
b
b
b
b
b
b
b
b
b
b
b
b
b
b
b
b
b
F
e
a
m
i
a
e
F
b
b
b
b
b
b
b
b
b
b
b
b
b
b
b
b
b
"}
(14,1,1) = {"
b
b
b
b
b
b
b
b
b
b
b
b
b
b
b
b
b
F
e
a
m
z
a
e
F
b
b
b
b
b
b
b
b
b
b
b
b
b
b
b
b
b
"}
(15,1,1) = {"
b
b
b
b
b
b
b
b
b
b
b
b
b
b
b
b
b
F
e
a
m
z
a
e
F
b
b
b
b
b
b
b
b
b
b
b
b
b
b
b
b
b
"}
(16,1,1) = {"
b
b
b
b
b
b
b
b
b
b
b
b
b
b
b
b
b
N
e
a
m
z
a
e
q
b
b
b
b
b
b
b
b
b
b
b
b
b
b
b
b
b
"}
(17,1,1) = {"
b
b
b
b
b
b
b
b
b
b
b
b
b
b
b
b
b
s
e
a
a
E
E
E
n
b
b
b
b
b
b
b
b
b
b
b
b
b
b
b
b
b
"}
(18,1,1) = {"
b
b
b
b
b
b
b
b
b
b
b
b
b
b
b
b
b
b
Y
Y
Y
Y
Y
Y
F
F
F
F
F
F
F
F
F
F
F
F
F
F
F
F
F
F
"}
(19,1,1) = {"
b
b
b
b
b
b
b
F
b
b
b
b
b
b
b
b
b
x
a
a
a
a
a
a
l
I
I
I
I
I
I
I
I
I
I
I
I
I
I
I
I
I
"}
(20,1,1) = {"
b
b
b
b
b
b
b
F
b
b
b
b
b
b
b
b
b
C
a
a
a
a
a
a
l
a
a
a
a
a
a
a
a
a
a
a
a
a
a
a
a
a
"}
(21,1,1) = {"
b
b
b
b
b
b
b
F
b
b
b
b
b
b
b
b
b
C
a
a
a
a
a
a
l
a
p
p
p
p
p
p
p
p
p
p
p
p
p
p
p
p
"}
(22,1,1) = {"
b
b
b
b
b
b
b
F
b
b
b
b
b
b
b
b
b
C
a
a
a
v
a
a
l
j
J
J
J
k
k
k
k
k
k
k
k
k
k
k
k
k
"}
(23,1,1) = {"
b
b
b
b
b
b
b
F
b
b
b
b
b
b
b
b
b
C
a
a
a
a
a
a
l
j
a
a
a
a
a
a
a
a
a
a
a
a
a
a
a
a
"}
(24,1,1) = {"
b
b
b
b
b
b
b
F
b
b
b
b
b
b
b
b
b
b
a
a
a
a
a
a
l
j
I
I
I
I
I
I
I
I
I
I
I
I
I
I
I
I
"}
(25,1,1) = {"
b
b
b
b
b
b
b
b
b
b
b
b
b
b
b
b
b
b
Y
Y
Y
Y
Y
Y
F
K
d
F
F
F
F
F
F
F
F
F
F
F
F
F
F
F
"}
(26,1,1) = {"
b
b
b
b
b
b
b
b
b
b
b
b
b
b
b
b
b
b
W
W
W
a
a
e
F
b
b
b
b
b
b
b
b
b
b
b
b
b
b
b
T
b
"}
(27,1,1) = {"
b
b
b
b
b
b
b
b
b
b
b
b
b
b
b
b
U
O
e
a
o
i
a
e
F
b
b
b
b
b
b
b
b
b
b
b
b
b
b
b
b
b
"}
(28,1,1) = {"
b
b
b
b
b
b
b
b
b
b
b
b
b
b
b
b
b
F
e
a
o
i
a
e
F
b
b
b
b
b
b
b
b
b
b
b
b
b
b
b
b
b
"}
(29,1,1) = {"
b
b
b
b
b
b
b
b
b
b
b
b
b
b
b
b
b
F
e
a
o
i
a
e
F
b
b
b
b
b
b
b
b
b
b
b
b
b
b
b
b
b
"}
(30,1,1) = {"
b
b
b
b
b
b
b
b
b
b
b
b
b
b
b
b
b
F
e
a
m
i
a
e
F
b
b
b
b
b
b
b
b
b
b
b
b
b
b
b
b
b
"}
(31,1,1) = {"
b
b
b
b
b
b
b
b
b
b
b
b
b
b
b
b
b
F
e
a
m
i
a
e
F
b
b
b
b
b
b
b
b
b
b
b
b
b
b
b
b
b
"}
(32,1,1) = {"
b
b
b
b
b
b
b
b
b
b
b
b
b
b
b
b
b
F
e
a
m
i
a
e
F
b
b
b
b
b
b
b
b
b
b
b
b
b
b
b
b
b
"}
(33,1,1) = {"
b
b
b
b
b
b
b
b
b
b
b
b
b
b
b
b
b
F
e
a
m
i
a
e
F
b
b
b
b
b
b
b
b
b
b
b
b
b
b
b
b
b
"}
(34,1,1) = {"
b
b
b
b
b
b
b
b
b
b
b
b
b
b
b
b
b
F
e
a
m
i
a
e
F
b
b
b
b
b
b
b
b
b
b
b
b
b
b
b
b
b
"}
(35,1,1) = {"
b
b
b
b
b
b
b
b
b
b
b
b
b
b
b
b
b
F
e
a
m
i
a
e
F
b
b
b
b
b
b
b
b
b
b
b
b
b
b
b
b
b
"}
(36,1,1) = {"
b
b
b
b
b
b
b
b
b
b
b
b
b
b
b
b
b
F
e
a
m
i
a
e
F
b
b
b
b
b
b
b
b
b
b
b
b
b
b
b
b
b
"}
(37,1,1) = {"
b
b
b
b
b
b
b
b
b
b
b
b
b
b
b
b
b
F
e
a
m
i
a
e
F
b
b
b
b
b
b
b
b
b
b
b
b
b
b
b
b
b
"}
(38,1,1) = {"
b
b
b
b
b
b
b
b
b
b
b
b
b
b
b
b
b
F
e
a
m
i
a
e
F
b
b
b
b
b
b
b
b
b
b
b
b
b
b
b
b
b
"}
(39,1,1) = {"
b
b
b
b
b
b
b
b
b
b
b
b
b
b
b
b
b
F
e
a
m
i
a
e
F
b
b
b
b
b
b
b
b
b
b
b
b
b
b
b
b
b
"}
(40,1,1) = {"
b
b
b
b
b
b
b
b
b
b
b
b
b
b
b
b
b
F
e
a
m
i
a
e
F
b
b
b
b
b
b
b
b
b
b
b
b
b
b
b
b
b
"}
(41,1,1) = {"
b
b
b
b
b
b
b
b
b
b
b
b
b
b
b
b
b
F
e
a
m
i
a
e
F
b
b
b
b
b
b
b
b
b
b
b
b
b
b
b
b
b
"}
(42,1,1) = {"
b
b
b
b
b
b
b
b
b
b
b
b
b
b
b
b
b
F
e
a
m
i
a
e
F
b
b
b
b
b
b
b
b
b
b
b
b
b
b
b
b
b
"}
