//MAP CONVERTED BY dmm2tgm.py THIS HEADER COMMENT PREVENTS RECONVERSION, DO NOT REMOVE
"b" = (
/obj/marker/prefab/city/parking{
	icon_state = "parking";
	dir = 8
	},
/turf/dmm_suite/clear_turf,
/area/dmm_suite/clear_area)
"d" = (
/obj/decal/road_marking/dotted_line{
	icon_state = "1";
	dir = 8
	},
/turf/simulated/floor/road,
/area/dmm_suite/clear_area)
"e" = (
/obj/marker/prefab/city/parking{
	icon_state = "parking";
	dir = 10
	},
/turf/dmm_suite/clear_turf,
/area/dmm_suite/clear_area)
"f" = (
/obj/structure/interactive/stopsign{
	icon_state = "sign";
	dir = 4
	},
/turf/simulated/floor/sidewalk,
/area/dmm_suite/clear_area)
"g" = (
/turf/simulated/floor/sidewalk,
/area/dmm_suite/clear_area)
"i" = (
/obj/decal/road_marking/solid_stop{
	icon_state = "1";
	dir = 8
	},
/turf/simulated/floor/road,
/area/dmm_suite/clear_area)
"k" = (
/obj/marker/prefab/city/store{
	dir = 1
	},
/turf/dmm_suite/clear_turf,
/area/dmm_suite/clear_area)
"o" = (
/obj/decal/road_marking/solid_line/offset/yellow,
/turf/simulated/floor/road,
/area/dmm_suite/clear_area)
"p" = (
/obj/marker/blob,
/turf/simulated/floor/road,
/area/dmm_suite/clear_area)
"q" = (
/obj/decal/road_marking/dotted_line/half,
/turf/simulated/floor/road,
/area/dmm_suite/clear_area)
"s" = (
/obj/structure/interactive/stopsign{
	icon_state = "sign";
	dir = 1
	},
/turf/simulated/floor/sidewalk,
/area/dmm_suite/clear_area)
"u" = (
/turf/simulated/floor/road,
/area/dmm_suite/clear_area)
"y" = (
/obj/structure/interactive/lighting/roadlamp{
	icon_state = "lamp";
	dir = 1
	},
/turf/simulated/floor/sidewalk,
/area/dmm_suite/clear_area)
"D" = (
/obj/decal/road_marking/solid_line,
/turf/simulated/floor/road,
/area/dmm_suite/clear_area)
"E" = (
/obj/decal/road_marking/solid_stop,
/turf/simulated/floor/road,
/area/dmm_suite/clear_area)
"H" = (
/obj/decal/road_marking/solid_stop{
	icon_state = "1";
	dir = 4
	},
/turf/simulated/floor/road,
/area/dmm_suite/clear_area)
"I" = (
/obj/structure/interactive/lighting/roadlamp{
	icon_state = "lamp";
	dir = 8
	},
/turf/simulated/floor/sidewalk,
/area/dmm_suite/clear_area)
"J" = (
/obj/structure/interactive/stopsign,
/turf/simulated/floor/sidewalk,
/area/dmm_suite/clear_area)
"K" = (
/obj/structure/scenery/flowers,
/turf/simulated/floor/colored/grass,
/area/dmm_suite/clear_area)
"L" = (
/obj/decal/road_marking/dotted_line/half{
	icon_state = "1";
	dir = 4
	},
/turf/simulated/floor/road,
/area/dmm_suite/clear_area)
"N" = (
/obj/marker/prefab/city/parking{
	icon_state = "parking";
	dir = 6
	},
/turf/dmm_suite/clear_turf,
/area/dmm_suite/clear_area)
"O" = (
/obj/decal/road_marking/solid_line/offset/yellow{
	icon_state = "1";
	dir = 8
	},
/turf/simulated/floor/road,
/area/dmm_suite/clear_area)
"P" = (
/obj/decal/road_marking/solid_cross,
/turf/simulated/floor/road,
/area/dmm_suite/clear_area)
"R" = (
/obj/decal/road_marking/solid_line/offset/yellow{
	icon_state = "1";
	dir = 4
	},
/turf/simulated/floor/road,
/area/dmm_suite/clear_area)
"S" = (
/obj/structure/interactive/stopsign{
	icon_state = "sign";
	dir = 8
	},
/turf/simulated/floor/sidewalk,
/area/dmm_suite/clear_area)
"T" = (
/obj/structure/interactive/lighting/roadlamp,
/turf/simulated/floor/sidewalk,
/area/dmm_suite/clear_area)
"U" = (
/obj/decal/road_marking/dotted_line/half{
	icon_state = "1";
	dir = 8
	},
/turf/simulated/floor/road,
/area/dmm_suite/clear_area)
"V" = (
/turf/dmm_suite/clear_turf,
/area/dmm_suite/clear_area)
"W" = (
/obj/decal/road_marking/solid_cross{
	icon_state = "1";
	dir = 4
	},
/turf/simulated/floor/road,
/area/dmm_suite/clear_area)
"X" = (
/obj/decal/road_marking/solid_line{
	icon_state = "1";
	dir = 4
	},
/turf/simulated/floor/road,
/area/dmm_suite/clear_area)
"Z" = (
/obj/decal/road_marking/dotted_line/half{
	icon_state = "1";
	dir = 1
	},
/turf/simulated/floor/road,
/area/dmm_suite/clear_area)

(1,1,1) = {"
V
V
V
V
V
V
V
V
V
V
V
V
V
V
V
V
V
g
X
u
q
Z
u
X
g
V
V
V
V
V
V
V
V
V
V
V
V
V
V
V
V
V
"}
(2,1,1) = {"
V
V
V
V
V
V
V
V
V
V
V
V
V
V
V
V
V
g
X
u
q
Z
u
X
g
V
V
V
V
V
V
V
V
V
V
V
V
V
V
V
k
V
"}
(3,1,1) = {"
V
V
V
V
V
V
V
V
V
V
V
V
V
V
V
V
V
g
X
u
q
Z
u
X
g
V
V
V
V
V
V
V
V
V
V
V
V
V
V
V
V
V
"}
(4,1,1) = {"
V
V
V
V
V
V
V
V
V
V
V
V
V
V
V
V
V
g
X
u
q
Z
u
X
g
V
V
V
V
V
V
V
V
V
V
V
V
V
V
V
V
V
"}
(5,1,1) = {"
V
V
V
V
V
g
g
g
g
g
g
g
g
g
g
g
g
g
X
u
q
Z
u
X
g
V
V
V
V
V
V
V
V
V
V
V
V
V
V
V
V
V
"}
(6,1,1) = {"
V
V
V
V
V
g
K
K
K
K
K
K
K
K
K
K
K
g
X
u
q
Z
u
X
g
V
V
V
V
V
V
V
V
V
V
V
V
V
V
V
V
V
"}
(7,1,1) = {"
V
V
V
V
V
g
K
V
V
V
V
V
V
V
V
V
N
g
X
u
q
Z
u
X
g
V
V
V
V
V
V
V
V
V
V
V
V
V
V
V
V
V
"}
(8,1,1) = {"
V
V
V
V
V
g
K
V
V
V
V
V
V
V
V
V
V
g
X
u
q
Z
u
X
g
V
V
V
V
V
V
V
V
V
V
V
V
V
V
V
V
V
"}
(9,1,1) = {"
V
V
V
V
V
g
K
V
V
V
V
V
V
V
V
V
V
g
X
u
q
Z
u
X
g
V
V
V
V
V
V
V
V
V
V
V
V
V
V
V
V
V
"}
(10,1,1) = {"
V
V
V
V
V
g
K
V
V
V
V
V
V
V
V
V
V
P
d
u
q
Z
u
X
g
V
V
V
V
V
V
V
V
V
V
V
V
V
V
V
V
V
"}
(11,1,1) = {"
V
V
V
V
V
g
K
V
V
V
V
V
V
V
V
V
V
P
d
u
q
Z
u
X
g
V
V
V
V
V
V
V
V
V
V
V
V
V
V
V
V
V
"}
(12,1,1) = {"
V
V
V
V
V
g
K
V
V
V
V
V
V
V
V
V
V
P
d
u
q
Z
u
X
g
V
V
V
V
V
V
V
V
V
V
V
V
V
V
V
V
V
"}
(13,1,1) = {"
V
V
V
V
V
g
K
V
V
V
V
V
V
V
V
V
V
P
d
u
q
Z
u
X
g
V
V
V
V
V
V
V
V
V
V
V
V
V
V
V
V
V
"}
(14,1,1) = {"
V
V
V
V
V
g
K
V
V
V
V
V
V
V
V
V
V
s
X
u
q
O
u
X
g
V
V
V
V
V
V
V
V
V
V
V
V
V
V
V
V
V
"}
(15,1,1) = {"
V
V
V
V
V
g
K
V
V
V
V
V
V
V
V
V
V
g
X
u
q
O
u
X
g
V
V
V
V
V
V
V
V
V
V
V
V
V
V
V
V
V
"}
(16,1,1) = {"
V
V
V
V
V
g
K
V
V
V
V
V
V
V
V
V
V
g
X
u
q
O
u
X
S
V
V
V
V
V
V
V
V
V
V
V
V
V
V
V
V
V
"}
(17,1,1) = {"
V
V
V
V
V
g
K
V
V
V
V
V
V
V
V
V
b
g
X
u
u
i
i
i
y
V
V
V
V
V
V
V
V
V
V
V
V
V
V
V
V
V
"}
(18,1,1) = {"
V
V
V
V
V
g
K
V
V
V
V
V
V
V
V
V
V
u
W
W
W
W
W
W
g
g
g
g
g
g
g
g
g
g
g
g
g
g
g
g
g
g
"}
(19,1,1) = {"
V
V
V
V
V
g
K
V
V
V
V
V
V
V
V
V
V
u
X
u
u
u
u
u
P
D
D
D
D
D
D
D
D
D
D
D
D
D
D
D
D
D
"}
(20,1,1) = {"
V
V
V
V
V
g
K
V
V
V
V
V
V
V
V
V
V
u
X
u
u
u
u
u
P
u
u
u
u
u
u
u
u
u
u
u
u
u
u
u
u
u
"}
(21,1,1) = {"
V
V
V
V
V
g
K
V
V
V
V
V
V
V
V
V
V
u
X
u
u
u
u
u
P
u
L
L
L
L
L
L
L
L
L
L
L
L
L
L
L
L
"}
(22,1,1) = {"
V
V
V
V
V
g
K
V
V
V
V
V
V
V
V
V
V
u
X
u
u
p
u
u
P
E
o
o
o
U
U
U
U
U
U
U
U
U
U
U
U
U
"}
(23,1,1) = {"
V
V
V
V
V
g
K
V
V
V
V
V
V
V
V
V
V
u
X
u
u
u
u
u
P
E
u
u
u
u
u
u
u
u
u
u
u
u
u
u
u
u
"}
(24,1,1) = {"
V
V
V
V
V
g
K
V
V
V
V
V
V
V
V
V
V
u
X
u
u
u
u
u
P
E
D
D
D
D
D
D
D
D
D
D
D
D
D
D
D
D
"}
(25,1,1) = {"
V
V
V
V
V
g
K
V
V
V
V
V
V
V
V
V
V
u
W
W
W
W
W
W
g
I
J
g
g
g
g
g
g
g
g
g
g
g
g
g
g
g
"}
(26,1,1) = {"
V
V
V
V
V
g
K
V
V
V
V
V
V
V
V
V
V
T
H
H
H
u
u
X
g
V
V
V
V
V
V
V
V
V
V
V
V
V
V
V
k
V
"}
(27,1,1) = {"
V
V
V
V
V
g
K
V
V
V
V
V
V
V
V
V
e
f
X
u
R
Z
u
X
g
V
V
V
V
V
V
V
V
V
V
V
V
V
V
V
V
V
"}
(28,1,1) = {"
V
V
V
V
V
g
K
V
V
V
V
V
V
V
V
V
V
g
X
u
R
Z
u
X
g
V
V
V
V
V
V
V
V
V
V
V
V
V
V
V
V
V
"}
(29,1,1) = {"
V
V
V
V
V
g
K
V
V
V
V
V
V
V
V
V
V
s
X
u
R
Z
u
X
g
V
V
V
V
V
V
V
V
V
V
V
V
V
V
V
V
V
"}
(30,1,1) = {"
V
V
V
V
V
g
K
V
V
V
V
V
V
V
V
V
V
P
d
u
q
Z
u
X
g
V
V
V
V
V
V
V
V
V
V
V
V
V
V
V
V
V
"}
(31,1,1) = {"
V
V
V
V
V
g
K
V
V
V
V
V
V
V
V
V
V
P
d
u
q
Z
u
X
g
V
V
V
V
V
V
V
V
V
V
V
V
V
V
V
V
V
"}
(32,1,1) = {"
V
V
V
V
V
g
K
V
V
V
V
V
V
V
V
V
V
P
d
u
q
Z
u
X
g
V
V
V
V
V
V
V
V
V
V
V
V
V
V
V
V
V
"}
(33,1,1) = {"
V
V
V
V
V
g
K
V
V
V
V
V
V
V
V
V
V
P
d
u
q
Z
u
X
g
V
V
V
V
V
V
V
V
V
V
V
V
V
V
V
V
V
"}
(34,1,1) = {"
V
V
V
V
V
g
K
V
V
V
V
V
V
V
V
V
V
g
X
u
q
Z
u
X
g
V
V
V
V
V
V
V
V
V
V
V
V
V
V
V
V
V
"}
(35,1,1) = {"
V
V
V
V
V
g
K
V
V
V
V
V
V
V
V
V
V
g
X
u
q
Z
u
X
g
V
V
V
V
V
V
V
V
V
V
V
V
V
V
V
V
V
"}
(36,1,1) = {"
V
V
V
V
V
g
K
V
V
V
V
V
V
V
V
V
V
g
X
u
q
Z
u
X
g
V
V
V
V
V
V
V
V
V
V
V
V
V
V
V
V
V
"}
(37,1,1) = {"
V
V
V
V
V
g
K
K
K
K
K
K
K
K
K
K
K
g
X
u
q
Z
u
X
g
V
V
V
V
V
V
V
V
V
V
V
V
V
V
V
V
V
"}
(38,1,1) = {"
V
V
V
V
V
g
g
g
g
g
g
g
g
g
g
g
g
g
X
u
q
Z
u
X
g
V
V
V
V
V
V
V
V
V
V
V
V
V
V
V
V
V
"}
(39,1,1) = {"
V
V
V
V
V
V
V
V
V
V
V
V
V
V
V
V
V
g
X
u
q
Z
u
X
g
V
V
V
V
V
V
V
V
V
V
V
V
V
V
V
V
V
"}
(40,1,1) = {"
V
V
V
V
V
V
V
V
V
V
V
V
V
V
V
V
V
g
X
u
q
Z
u
X
g
V
V
V
V
V
V
V
V
V
V
V
V
V
V
V
V
V
"}
(41,1,1) = {"
V
V
V
V
V
V
V
V
V
V
V
V
V
V
V
V
V
g
X
u
q
Z
u
X
g
V
V
V
V
V
V
V
V
V
V
V
V
V
V
V
V
V
"}
(42,1,1) = {"
V
V
V
V
V
V
V
V
V
V
V
V
V
V
V
V
V
g
X
u
q
Z
u
X
g
V
V
V
V
V
V
V
V
V
V
V
V
V
V
V
V
V
"}
