//MAP CONVERTED BY dmm2tgm.py THIS HEADER COMMENT PREVENTS RECONVERSION, DO NOT REMOVE
"a" = (
/obj/decal/road_marking/dotted_line/half{
	icon_state = "1";
	dir = 4
	},
/turf/simulated/floor/road,
/area/dmm_suite/clear_area)
"d" = (
/obj/marker/prefab/city/parking{
	icon_state = "parking";
	dir = 6
	},
/turf/dmm_suite/clear_turf,
/area/dmm_suite/clear_area)
"f" = (
/obj/structure/interactive/lighting/roadlamp{
	icon_state = "lamp";
	dir = 8
	},
/turf/simulated/floor/sidewalk,
/area/dmm_suite/clear_area)
"g" = (
/obj/decal/road_marking/dotted_line/half,
/turf/simulated/floor/road,
/area/dmm_suite/clear_area)
"m" = (
/obj/decal/road_marking/solid_line{
	dir = 9
	},
/turf/simulated/floor/road,
/area/dmm_suite/clear_area)
"n" = (
/obj/decal/road_marking/dotted_line{
	icon_state = "1";
	dir = 4
	},
/turf/simulated/floor/road,
/area/dmm_suite/clear_area)
"o" = (
/obj/decal/road_marking/dotted_line,
/turf/simulated/floor/road,
/area/dmm_suite/clear_area)
"p" = (
/obj/decal/road_marking/solid_line{
	icon_state = "1";
	dir = 4
	},
/turf/simulated/floor/road,
/area/dmm_suite/clear_area)
"q" = (
/obj/decal/road_marking/dotted_line/half{
	icon_state = "1";
	dir = 1
	},
/turf/simulated/floor/road,
/area/dmm_suite/clear_area)
"r" = (
/obj/decal/road_marking/solid_line,
/turf/simulated/floor/road,
/area/dmm_suite/clear_area)
"s" = (
/obj/marker/prefab/city/store,
/turf/dmm_suite/clear_turf,
/area/dmm_suite/clear_area)
"v" = (
/obj/decal/road_marking/dotted_line/half{
	icon_state = "1";
	dir = 4
	},
/obj/decal/road_marking/dotted_line/half{
	icon_state = "1";
	dir = 1
	},
/turf/simulated/floor/road,
/area/dmm_suite/clear_area)
"w" = (
/obj/structure/interactive/stopsign,
/turf/simulated/floor/sidewalk,
/area/dmm_suite/clear_area)
"C" = (
/obj/decal/road_marking/solid_stop,
/turf/simulated/floor/road,
/area/dmm_suite/clear_area)
"D" = (
/turf/dmm_suite/clear_turf,
/area/dmm_suite/clear_area)
"G" = (
/obj/decal/road_marking/solid_line{
	dir = 5
	},
/turf/simulated/floor/road,
/area/dmm_suite/clear_area)
"H" = (
/obj/decal/road_marking/solid_line{
	dir = 10
	},
/turf/simulated/floor/road,
/area/dmm_suite/clear_area)
"I" = (
/obj/decal/road_marking/dotted_line/half{
	icon_state = "1";
	dir = 8
	},
/obj/decal/road_marking/dotted_line/half,
/turf/simulated/floor/road,
/area/dmm_suite/clear_area)
"O" = (
/obj/decal/road_marking/solid_line{
	dir = 6
	},
/turf/simulated/floor/road,
/area/dmm_suite/clear_area)
"Q" = (
/obj/decal/road_marking/dotted_line/half{
	icon_state = "1";
	dir = 8
	},
/turf/simulated/floor/road,
/area/dmm_suite/clear_area)
"R" = (
/turf/simulated/floor/sidewalk,
/area/dmm_suite/clear_area)
"S" = (
/obj/decal/road_marking/dotted_line/half,
/obj/marker/blob,
/turf/simulated/floor/road,
/area/dmm_suite/clear_area)
"T" = (
/turf/simulated/floor/road,
/area/dmm_suite/clear_area)
"U" = (
/obj/decal/road_marking/solid_cross,
/turf/simulated/floor/road,
/area/dmm_suite/clear_area)
"V" = (
/obj/decal/road_marking/solid_cross{
	icon_state = "1";
	dir = 4
	},
/turf/simulated/floor/road,
/area/dmm_suite/clear_area)
"X" = (
/obj/decal/road_marking/dotted_line/half{
	icon_state = "1";
	dir = 1
	},
/obj/decal/road_marking/dotted_line/half{
	icon_state = "1";
	dir = 8
	},
/turf/simulated/floor/road,
/area/dmm_suite/clear_area)
"Y" = (
/obj/decal/road_marking/solid_line/offset/yellow,
/turf/simulated/floor/road,
/area/dmm_suite/clear_area)
"Z" = (
/obj/decal/road_marking/dotted_line/half,
/obj/decal/road_marking/dotted_line/half{
	icon_state = "1";
	dir = 4
	},
/turf/simulated/floor/road,
/area/dmm_suite/clear_area)

(1,1,1) = {"
D
D
D
D
D
D
D
D
D
D
D
D
D
D
D
D
D
R
p
T
g
q
T
p
R
R
R
R
R
R
R
R
R
R
R
R
R
R
D
D
D
D
"}
(2,1,1) = {"
D
D
D
D
D
D
D
D
D
D
D
D
D
D
D
D
D
R
p
T
g
q
T
H
r
r
r
r
r
r
r
r
r
r
r
r
G
R
D
D
D
D
"}
(3,1,1) = {"
D
D
D
D
D
D
D
D
D
D
D
D
D
D
D
D
D
R
p
T
g
q
T
T
T
T
T
T
T
T
T
T
T
T
T
T
p
R
D
D
D
D
"}
(4,1,1) = {"
D
D
D
D
D
D
D
D
D
D
D
D
D
D
D
D
D
R
p
T
g
v
a
a
a
a
a
a
a
a
a
a
a
a
T
T
p
R
D
D
D
D
"}
(5,1,1) = {"
D
D
D
D
D
D
D
D
D
D
D
D
D
D
D
D
D
R
p
T
T
Q
Q
Q
Q
Q
Q
Q
Q
Q
Q
Q
Q
I
q
T
p
R
D
D
D
D
"}
(6,1,1) = {"
D
D
D
D
D
D
D
D
D
D
D
D
D
D
D
D
D
R
p
T
T
T
T
T
T
T
T
T
T
T
T
T
T
g
q
T
p
R
D
D
D
D
"}
(7,1,1) = {"
D
D
D
D
D
D
D
D
D
D
D
D
D
D
D
D
D
R
H
r
r
r
r
r
r
r
r
r
r
r
r
G
T
g
q
T
p
R
D
D
D
D
"}
(8,1,1) = {"
D
D
D
D
D
D
D
D
D
D
D
D
D
D
D
D
D
R
R
R
R
R
R
R
R
R
R
R
R
R
R
p
T
g
q
T
p
R
D
D
D
D
"}
(9,1,1) = {"
D
D
D
D
D
D
D
D
D
D
D
D
D
D
D
D
D
D
D
D
D
D
D
D
D
D
D
D
D
s
R
p
T
g
q
T
p
R
D
D
D
D
"}
(10,1,1) = {"
D
D
D
D
D
D
D
D
D
D
D
D
D
D
D
D
D
D
D
D
D
D
D
D
D
D
D
D
D
D
R
p
T
g
q
T
p
R
D
D
D
D
"}
(11,1,1) = {"
D
D
D
D
D
D
D
D
D
D
D
D
D
D
D
D
D
D
D
D
D
D
D
D
D
D
D
D
D
D
R
p
T
g
q
T
p
R
D
D
D
D
"}
(12,1,1) = {"
D
D
D
D
D
D
D
D
D
D
D
D
D
D
D
D
D
D
D
D
D
D
D
D
D
D
D
D
D
D
R
p
T
g
q
T
p
R
D
D
D
D
"}
(13,1,1) = {"
D
D
D
D
D
D
D
D
D
D
D
D
D
D
D
D
D
D
D
D
D
D
D
D
D
D
D
D
D
D
R
p
T
g
q
T
p
R
D
D
D
D
"}
(14,1,1) = {"
D
D
D
D
D
D
D
D
D
D
D
D
D
D
D
D
D
D
D
D
D
D
D
D
D
D
D
D
D
D
R
p
T
g
q
T
p
R
D
D
D
D
"}
(15,1,1) = {"
D
D
D
D
D
D
D
D
D
D
D
D
D
D
D
D
D
D
D
D
D
D
D
D
D
D
D
D
D
D
R
p
T
g
q
T
p
R
D
D
D
D
"}
(16,1,1) = {"
D
D
D
D
D
D
D
D
D
D
D
D
D
D
D
D
D
D
D
D
D
D
D
D
D
D
D
D
D
D
R
p
T
g
q
T
p
R
D
D
D
D
"}
(17,1,1) = {"
D
D
D
D
D
D
D
D
D
D
D
D
D
D
D
D
D
D
D
D
D
D
D
D
D
D
D
D
D
D
R
p
T
g
q
T
p
R
D
D
D
D
"}
(18,1,1) = {"
D
D
D
D
D
D
D
D
D
D
D
D
D
D
D
D
D
D
D
D
D
D
D
D
D
D
D
D
D
D
R
p
T
g
q
T
p
R
R
R
R
R
"}
(19,1,1) = {"
D
D
D
D
D
D
D
D
D
D
D
D
D
D
D
D
D
D
D
D
D
D
D
D
D
D
D
D
D
D
R
p
T
g
q
T
T
U
r
r
r
r
"}
(20,1,1) = {"
D
D
D
D
D
D
D
D
D
D
D
D
D
D
D
D
D
D
D
D
D
D
D
D
D
D
D
D
D
D
R
p
T
g
q
T
T
U
T
T
T
T
"}
(21,1,1) = {"
D
D
D
D
D
D
D
D
D
D
D
D
D
D
D
D
D
D
D
D
D
D
D
D
D
D
D
D
D
D
R
p
T
g
q
T
T
U
T
a
a
a
"}
(22,1,1) = {"
D
D
D
D
D
D
D
D
D
D
D
D
D
D
D
D
D
D
D
D
D
D
D
D
D
D
D
D
D
D
R
p
T
S
q
T
T
U
C
Y
Y
Y
"}
(23,1,1) = {"
D
D
D
D
D
D
D
D
D
D
D
D
D
D
D
D
D
D
D
D
D
D
D
D
D
D
D
D
D
D
R
p
T
g
q
T
T
U
C
T
T
T
"}
(24,1,1) = {"
D
D
D
D
D
D
D
D
D
D
D
D
D
D
D
D
D
D
D
D
D
D
D
D
D
D
D
D
D
D
R
p
T
g
q
T
T
U
C
r
r
r
"}
(25,1,1) = {"
D
D
D
D
D
D
D
D
D
D
D
D
D
D
D
D
D
D
D
D
D
D
D
D
D
D
D
D
D
d
R
p
T
g
q
T
p
R
f
w
R
R
"}
(26,1,1) = {"
D
D
D
D
D
D
D
D
D
D
D
D
D
D
D
D
D
D
D
D
D
D
D
D
D
D
D
D
D
D
R
p
T
g
q
T
p
R
D
D
D
D
"}
(27,1,1) = {"
D
D
D
D
D
D
D
D
D
D
D
D
D
D
D
D
s
D
D
D
D
D
D
D
D
D
D
D
D
D
R
p
T
g
q
T
p
R
D
D
D
D
"}
(28,1,1) = {"
D
D
D
D
D
D
D
D
D
D
D
D
D
D
D
D
D
D
D
D
D
D
D
D
D
D
D
D
D
D
U
n
T
g
q
T
p
R
D
D
D
D
"}
(29,1,1) = {"
D
D
D
D
D
D
D
D
D
D
D
D
D
D
D
D
D
D
D
D
D
D
D
D
D
D
D
D
D
D
U
n
T
g
q
T
p
R
D
D
D
D
"}
(30,1,1) = {"
D
D
D
D
D
D
D
D
D
D
D
D
D
D
D
D
D
D
D
D
D
D
D
D
D
D
D
D
D
D
U
n
T
g
q
T
p
R
D
D
D
D
"}
(31,1,1) = {"
D
D
D
D
D
D
D
D
D
D
D
D
D
D
D
D
D
D
D
D
D
D
D
D
D
D
D
D
D
D
U
n
T
g
q
T
p
R
D
D
D
D
"}
(32,1,1) = {"
D
D
D
D
D
D
D
D
D
D
D
D
D
D
D
D
D
D
D
D
D
D
D
D
D
D
D
D
D
D
R
p
T
g
q
T
p
R
D
D
D
D
"}
(33,1,1) = {"
D
D
D
D
D
D
D
D
D
D
D
D
D
D
D
D
D
D
D
D
D
D
D
D
D
D
D
D
D
D
R
p
T
g
q
T
p
R
D
D
D
D
"}
(34,1,1) = {"
D
D
D
D
D
D
D
D
D
D
D
D
D
D
D
D
D
D
D
D
D
D
D
D
D
D
D
D
D
D
R
p
T
g
q
T
p
R
D
D
D
D
"}
(35,1,1) = {"
D
D
D
D
D
D
D
D
D
D
D
D
D
D
D
D
D
R
R
R
R
R
R
V
V
V
V
R
R
R
R
p
T
g
q
T
p
R
D
D
D
D
"}
(36,1,1) = {"
D
D
D
D
D
D
D
D
D
D
D
D
D
D
D
D
D
R
O
r
r
r
r
o
o
o
o
r
r
r
r
m
T
g
q
T
p
R
D
D
D
D
"}
(37,1,1) = {"
D
D
D
D
D
D
D
D
D
D
D
D
D
D
D
D
D
R
p
T
T
T
T
T
T
T
T
T
T
T
T
T
T
g
q
T
p
R
D
D
D
D
"}
(38,1,1) = {"
D
D
D
D
D
D
D
D
D
D
D
D
D
D
D
D
D
R
p
T
T
a
a
a
a
a
a
a
a
a
a
a
a
Z
q
T
p
R
D
D
D
D
"}
(39,1,1) = {"
D
D
D
D
D
D
D
D
D
D
D
D
D
D
D
D
D
R
p
T
g
X
Q
Q
Q
Q
Q
Q
Q
Q
Q
Q
Q
Q
T
T
p
R
D
D
D
D
"}
(40,1,1) = {"
D
D
D
D
D
D
D
D
D
D
D
D
D
D
D
D
D
R
p
T
g
q
T
T
T
T
T
T
T
T
T
T
T
T
T
T
p
R
D
D
D
D
"}
(41,1,1) = {"
D
D
D
D
D
D
D
D
D
D
D
D
D
D
D
D
D
R
p
T
g
q
T
O
r
r
r
r
r
r
r
r
r
r
r
r
m
R
D
D
D
D
"}
(42,1,1) = {"
D
D
D
D
D
D
D
D
D
D
D
D
D
D
D
D
D
R
p
T
g
q
T
p
R
R
R
R
R
R
R
R
R
R
R
R
R
R
D
D
D
D
"}
