//MAP CONVERTED BY dmm2tgm.py THIS HEADER COMMENT PREVENTS RECONVERSION, DO NOT REMOVE
"b" = (
/obj/decal/road_marking/solid_line/offset/yellow{
	icon_state = "1";
	dir = 4
	},
/turf/simulated/floor/road,
/area/dmm_suite/clear_area)
"c" = (
/obj/decal/road_marking/solid_line/offset{
	dir = 4
	},
/turf/simulated/floor/road,
/area/dmm_suite/clear_area)
"f" = (
/obj/structure/interactive/lighting/roadlamp{
	icon_state = "lamp";
	dir = 8
	},
/turf/simulated/floor/sidewalk,
/area/dmm_suite/clear_area)
"g" = (
/obj/decal/road_marking/solid_line{
	icon_state = "1";
	dir = 4
	},
/turf/simulated/floor/road,
/area/dmm_suite/clear_area)
"h" = (
/turf/simulated/floor/road,
/area/dmm_suite/clear_area)
"i" = (
/obj/decal/road_marking/dotted_line/half{
	icon_state = "1";
	dir = 1
	},
/turf/simulated/floor/road,
/area/dmm_suite/clear_area)
"k" = (
/obj/decal/road_marking/dotted_line/half{
	icon_state = "1";
	dir = 8
	},
/obj/decal/road_marking/dotted_line/half{
	icon_state = "1";
	dir = 1
	},
/turf/simulated/floor/road,
/area/dmm_suite/clear_area)
"l" = (
/obj/structure/interactive/stopsign{
	icon_state = "sign";
	dir = 8
	},
/turf/simulated/floor/sidewalk,
/area/dmm_suite/clear_area)
"n" = (
/obj/decal/road_marking/solid_line/offset/yellow{
	icon_state = "1";
	dir = 8
	},
/turf/simulated/floor/road,
/area/dmm_suite/clear_area)
"o" = (
/obj/decal/road_marking/dotted_line/half{
	icon_state = "1";
	dir = 8
	},
/turf/simulated/floor/road,
/area/dmm_suite/clear_area)
"q" = (
/obj/decal/road_marking/dotted_line/half{
	icon_state = "1";
	dir = 4
	},
/obj/decal/road_marking/dotted_line/half,
/turf/simulated/floor/road,
/area/dmm_suite/clear_area)
"s" = (
/turf/dmm_suite/clear_turf,
/area/dmm_suite/clear_area)
"t" = (
/obj/marker/prefab/city/store,
/turf/dmm_suite/clear_turf,
/area/dmm_suite/clear_area)
"u" = (
/obj/decal/road_marking/hazard,
/turf/simulated/floor/road,
/area/dmm_suite/clear_area)
"v" = (
/obj/structure/interactive/lighting/roadlamp,
/turf/simulated/floor/sidewalk,
/area/dmm_suite/clear_area)
"w" = (
/obj/structure/interactive/stopsign,
/turf/simulated/floor/sidewalk,
/area/dmm_suite/clear_area)
"y" = (
/obj/decal/road_marking/dotted_line/half{
	icon_state = "1";
	dir = 4
	},
/turf/simulated/floor/road,
/area/dmm_suite/clear_area)
"z" = (
/obj/decal/road_marking/dotted_line/half{
	icon_state = "1";
	dir = 1
	},
/obj/decal/road_marking/dotted_line/half{
	icon_state = "1";
	dir = 4
	},
/turf/simulated/floor/road,
/area/dmm_suite/clear_area)
"B" = (
/obj/structure/interactive/lighting/roadlamp{
	icon_state = "lamp";
	dir = 1
	},
/turf/simulated/floor/sidewalk,
/area/dmm_suite/clear_area)
"C" = (
/obj/structure/scenery/flowers,
/turf/simulated/floor/colored/grass,
/area/dmm_suite/clear_area)
"F" = (
/obj/decal/road_marking/solid_stop,
/turf/simulated/floor/road,
/area/dmm_suite/clear_area)
"H" = (
/obj/structure/interactive/stopsign{
	icon_state = "sign";
	dir = 4
	},
/turf/simulated/floor/sidewalk,
/area/dmm_suite/clear_area)
"I" = (
/obj/decal/road_marking/solid_line{
	dir = 4
	},
/turf/simulated/floor/road,
/area/dmm_suite/clear_area)
"J" = (
/obj/decal/road_marking/solid_line{
	dir = 9
	},
/turf/simulated/floor/road,
/area/dmm_suite/clear_area)
"K" = (
/obj/decal/road_marking/solid_cross,
/turf/simulated/floor/road,
/area/dmm_suite/clear_area)
"L" = (
/obj/decal/road_marking/solid_line,
/turf/simulated/floor/road,
/area/dmm_suite/clear_area)
"M" = (
/obj/decal/road_marking/dotted_line{
	icon_state = "1";
	dir = 4
	},
/turf/simulated/floor/road,
/area/dmm_suite/clear_area)
"N" = (
/obj/decal/road_marking/solid_stop{
	icon_state = "1";
	dir = 8
	},
/turf/simulated/floor/road,
/area/dmm_suite/clear_area)
"P" = (
/obj/decal/road_marking/solid_stop{
	icon_state = "1";
	dir = 4
	},
/turf/simulated/floor/road,
/area/dmm_suite/clear_area)
"Q" = (
/obj/decal/road_marking/dotted_line/half,
/turf/simulated/floor/road,
/area/dmm_suite/clear_area)
"R" = (
/obj/decal/road_marking/solid_cross{
	icon_state = "1";
	dir = 4
	},
/turf/simulated/floor/road,
/area/dmm_suite/clear_area)
"S" = (
/obj/decal/road_marking/solid_line{
	dir = 6
	},
/turf/simulated/floor/road,
/area/dmm_suite/clear_area)
"U" = (
/obj/decal/road_marking/solid_line/offset/yellow,
/turf/simulated/floor/road,
/area/dmm_suite/clear_area)
"V" = (
/obj/decal/road_marking/dotted_line/half{
	icon_state = "1";
	dir = 8
	},
/obj/decal/road_marking/dotted_line/half,
/turf/simulated/floor/road,
/area/dmm_suite/clear_area)
"W" = (
/obj/marker/blob,
/turf/simulated/floor/road,
/area/dmm_suite/clear_area)
"X" = (
/turf/simulated/floor/sidewalk,
/area/dmm_suite/clear_area)
"Y" = (
/obj/decal/road_marking/solid_line{
	dir = 10
	},
/turf/simulated/floor/road,
/area/dmm_suite/clear_area)
"Z" = (
/obj/decal/road_marking/solid_line{
	dir = 5
	},
/turf/simulated/floor/road,
/area/dmm_suite/clear_area)

(1,1,1) = {"
s
s
s
s
s
s
s
s
s
s
s
s
s
s
s
s
t
X
g
h
Q
i
h
g
X
s
s
s
s
s
s
s
s
s
s
s
s
s
s
s
s
s
"}
(2,1,1) = {"
s
s
s
s
s
s
s
s
s
s
s
s
s
s
s
s
s
X
g
h
Q
i
h
g
X
s
s
s
s
s
s
s
s
s
s
s
s
s
s
s
s
s
"}
(3,1,1) = {"
s
s
s
s
s
s
s
s
s
s
s
s
s
s
s
s
s
X
g
h
Q
i
h
g
X
s
s
s
s
s
s
s
s
s
s
s
s
s
s
s
s
s
"}
(4,1,1) = {"
s
s
s
s
s
s
s
s
s
s
s
s
s
s
s
s
s
X
g
h
Q
i
h
g
X
s
s
s
s
s
s
s
s
s
s
s
s
s
s
s
s
s
"}
(5,1,1) = {"
s
s
s
s
s
s
s
s
s
s
s
s
s
s
s
s
s
X
g
h
Q
i
h
g
X
s
s
s
s
s
s
s
s
s
s
s
s
s
s
s
s
s
"}
(6,1,1) = {"
s
s
s
s
s
s
s
s
s
s
s
s
s
s
s
s
s
X
g
h
Q
i
h
g
X
s
s
s
s
s
s
s
s
s
s
s
s
s
s
s
s
s
"}
(7,1,1) = {"
s
s
s
s
s
s
s
s
s
s
s
s
s
s
s
s
s
X
g
h
Q
n
h
g
X
s
s
s
s
s
s
s
s
s
s
s
s
s
s
s
s
s
"}
(8,1,1) = {"
s
s
s
s
s
s
s
s
s
s
s
s
s
s
s
s
s
X
g
h
Q
n
h
g
X
s
s
s
s
s
s
s
s
s
s
s
s
s
s
s
s
s
"}
(9,1,1) = {"
s
s
s
s
s
s
s
s
s
s
s
s
s
s
s
s
s
X
g
h
Q
n
h
g
l
s
s
s
s
s
s
s
s
s
s
s
s
s
s
s
s
s
"}
(10,1,1) = {"
s
s
s
s
s
s
s
s
s
s
s
s
s
s
s
s
s
X
g
h
h
N
N
N
B
s
s
s
s
s
s
s
s
s
s
s
s
s
s
s
s
s
"}
(11,1,1) = {"
s
s
s
s
s
s
s
s
s
s
s
s
s
s
s
s
s
X
R
R
R
R
R
R
X
X
X
X
X
X
X
X
X
X
X
X
X
X
s
s
s
s
"}
(12,1,1) = {"
s
s
s
s
s
s
s
s
s
s
s
s
s
s
s
s
s
X
I
h
h
h
h
Y
L
L
L
L
L
L
L
L
L
L
L
L
Z
X
s
s
s
s
"}
(13,1,1) = {"
s
s
s
s
s
s
s
s
s
s
s
s
s
s
s
s
s
X
I
h
h
h
h
h
h
h
h
h
h
h
h
h
h
h
h
h
I
X
s
s
s
s
"}
(14,1,1) = {"
s
s
s
s
s
s
s
s
s
s
s
s
s
s
s
s
s
X
I
h
h
y
y
y
y
y
y
y
y
y
y
y
y
y
h
h
I
X
s
s
s
s
"}
(15,1,1) = {"
s
s
s
s
s
s
s
s
s
s
s
s
s
s
s
s
s
X
I
h
Q
k
o
o
o
o
o
o
o
o
o
o
o
V
i
h
I
X
s
s
s
s
"}
(16,1,1) = {"
s
s
s
s
s
s
s
s
s
s
s
s
s
s
s
s
s
X
I
h
Q
i
h
h
h
h
h
h
h
h
h
h
h
Q
i
h
I
X
s
s
s
s
"}
(17,1,1) = {"
X
X
X
X
X
X
X
X
X
X
X
X
X
X
X
X
X
X
I
h
Q
i
h
S
L
L
L
L
L
L
L
Z
h
Q
i
h
I
X
s
s
s
s
"}
(18,1,1) = {"
X
h
c
h
c
h
c
h
c
h
c
h
c
h
c
u
u
X
I
h
Q
i
h
I
X
X
X
X
X
X
X
I
h
Q
i
h
I
X
X
X
X
X
"}
(19,1,1) = {"
X
h
c
h
c
h
c
h
c
h
c
h
c
h
c
u
u
X
I
h
Q
i
h
I
X
C
C
C
C
C
X
I
h
Q
i
h
Y
K
L
L
L
L
"}
(20,1,1) = {"
X
h
h
h
h
h
h
h
h
h
h
h
h
h
h
h
h
K
M
h
Q
i
h
I
X
C
C
C
C
C
X
I
h
Q
i
h
h
K
h
h
h
h
"}
(21,1,1) = {"
X
h
h
h
h
h
h
h
h
h
h
h
h
h
h
h
h
K
M
h
Q
i
h
I
X
C
C
C
C
C
X
I
h
Q
i
h
h
K
h
y
y
y
"}
(22,1,1) = {"
X
h
h
h
h
h
h
h
W
h
h
h
h
h
h
h
h
K
M
h
Q
i
h
I
X
C
C
C
C
C
X
I
h
Q
i
h
h
K
F
U
U
U
"}
(23,1,1) = {"
X
h
h
h
h
h
h
h
h
h
h
h
h
h
h
h
h
K
M
h
Q
i
h
I
X
C
C
C
C
C
X
I
h
Q
i
h
h
K
F
h
h
h
"}
(24,1,1) = {"
X
h
c
h
c
h
c
h
c
h
c
h
c
h
c
u
u
X
I
h
Q
i
h
I
X
C
C
C
C
C
X
I
h
Q
i
h
S
K
F
L
L
L
"}
(25,1,1) = {"
X
h
c
h
c
h
c
h
c
h
c
h
c
h
c
u
u
X
I
h
Q
i
h
I
X
X
X
X
X
X
X
I
h
Q
i
h
I
X
f
w
X
X
"}
(26,1,1) = {"
X
X
X
X
X
X
X
X
X
X
X
X
X
X
X
X
X
X
I
h
Q
i
h
Y
L
L
L
L
L
L
L
J
h
Q
i
h
I
X
s
s
s
s
"}
(27,1,1) = {"
s
s
s
s
s
s
s
s
s
s
s
s
s
s
s
s
t
X
I
h
Q
i
h
h
h
h
h
h
h
h
h
h
h
Q
i
h
I
X
s
s
s
s
"}
(28,1,1) = {"
s
s
s
s
s
s
s
s
s
s
s
s
s
s
s
s
s
X
I
h
Q
z
y
y
y
y
y
y
y
y
y
y
y
q
i
h
I
X
s
s
s
s
"}
(29,1,1) = {"
s
s
s
s
s
s
s
s
s
s
s
s
s
s
s
s
s
X
I
h
h
o
o
o
o
o
o
o
o
o
o
o
o
o
h
h
I
X
s
s
s
s
"}
(30,1,1) = {"
s
s
s
s
s
s
s
s
s
s
s
s
s
s
s
s
s
X
I
h
h
h
h
h
h
h
h
h
h
h
h
h
h
h
h
h
I
X
s
s
s
s
"}
(31,1,1) = {"
s
s
s
s
s
s
s
s
s
s
s
s
s
s
s
s
s
X
I
h
h
h
h
S
L
L
L
L
L
L
L
L
L
L
L
L
J
X
s
s
s
s
"}
(32,1,1) = {"
s
s
s
s
s
s
s
s
s
s
s
s
s
s
s
s
s
X
R
R
R
R
R
R
X
X
X
X
X
X
X
X
X
X
X
X
X
X
s
s
s
s
"}
(33,1,1) = {"
s
s
s
s
s
s
s
s
s
s
s
s
s
s
s
s
s
X
P
P
P
h
h
g
X
s
s
s
s
s
s
s
s
s
s
s
s
s
s
s
s
s
"}
(34,1,1) = {"
s
s
s
s
s
s
s
s
s
s
s
s
s
s
s
s
s
v
g
h
b
i
h
g
X
s
s
s
s
s
s
s
s
s
s
s
s
s
s
s
s
s
"}
(35,1,1) = {"
s
s
s
s
s
s
s
s
s
s
s
s
s
s
s
s
s
H
g
h
b
i
h
g
X
s
s
s
s
s
s
s
s
s
s
s
s
s
s
s
s
s
"}
(36,1,1) = {"
s
s
s
s
s
s
s
s
s
s
s
s
s
s
s
s
s
X
g
h
b
i
h
g
X
s
s
s
s
s
s
s
s
s
s
s
s
s
s
s
s
s
"}
(37,1,1) = {"
s
s
s
s
s
s
s
s
s
s
s
s
s
s
s
s
s
X
g
h
Q
i
h
g
X
s
s
s
s
s
s
s
s
s
s
s
s
s
s
s
s
s
"}
(38,1,1) = {"
s
s
s
s
s
s
s
s
s
s
s
s
s
s
s
s
s
X
g
h
Q
i
h
g
X
s
s
s
s
s
s
s
s
s
s
s
s
s
s
s
s
s
"}
(39,1,1) = {"
s
s
s
s
s
s
s
s
s
s
s
s
s
s
s
s
s
X
g
h
Q
i
h
g
X
s
s
s
s
s
s
s
s
s
s
s
s
s
s
s
s
s
"}
(40,1,1) = {"
s
s
s
s
s
s
s
s
s
s
s
s
s
s
s
s
s
X
g
h
Q
i
h
g
X
s
s
s
s
s
s
s
s
s
s
s
s
s
s
s
s
s
"}
(41,1,1) = {"
s
s
s
s
s
s
s
s
s
s
s
s
s
s
s
s
s
X
g
h
Q
i
h
g
X
s
s
s
s
s
s
s
s
s
s
s
s
s
s
s
s
s
"}
(42,1,1) = {"
s
s
s
s
s
s
s
s
s
s
s
s
s
s
s
s
s
X
g
h
Q
i
h
g
X
s
s
s
s
s
s
s
s
s
s
s
s
s
s
s
s
s
"}
