"a" = (/turf/dmm_suite/clear_turf,/area/dmm_suite/clear_area)
"b" = (/obj/marker/prefab/yard,/turf/dmm_suite/clear_turf,/area/dmm_suite/clear_area)
"c" = (/obj/marker/prefab/house,/turf/dmm_suite/clear_turf,/area/dmm_suite/clear_area)
"d" = (/turf/simulated/floor/sidewalk,/area/dmm_suite/clear_area)
"e" = (/obj/structure/interactive/lighting/roadlamp,/turf/simulated/floor/sidewalk,/area/dmm_suite/clear_area)
"f" = (/obj/decal/road_marking/solid_line{icon_state = "1"; dir = 4},/obj/decal/sidewalk_curb{icon_state = "curb"; dir = 1},/turf/simulated/floor/road,/area/dmm_suite/clear_area)
"g" = (/obj/decal/road_marking/solid_line{icon_state = "1"; dir = 10},/obj/decal/sidewalk_curb/corner,/turf/simulated/floor/road,/area/dmm_suite/clear_area)
"h" = (/turf/simulated/floor/road,/area/dmm_suite/clear_area)
"i" = (/obj/decal/road_marking/solid_line,/turf/simulated/floor/road,/area/dmm_suite/clear_area)
"j" = (/obj/marker/map_node/x3,/turf/simulated/floor/road,/area/dmm_suite/clear_area)
"k" = (/obj/marker/map_node/x3,/turf/simulated/floor/sidewalk,/area/dmm_suite/clear_area)
"l" = (/obj/marker/prefab/house{icon_state = ""; dir = 8},/turf/dmm_suite/clear_turf,/area/dmm_suite/clear_area)
"m" = (/obj/structure/interactive/lighting/roadlamp{icon_state = "lamp"; dir = 1},/turf/simulated/floor/sidewalk,/area/dmm_suite/clear_area)
"n" = (/obj/marker/prefab/city/store{icon_state = ""; dir = 1},/turf/dmm_suite/clear_turf,/area/dmm_suite/clear_area)
"o" = (/obj/decal/road_marking/solid_cross,/turf/simulated/floor/road,/area/dmm_suite/clear_area)
"p" = (/obj/decal/road_marking/solid_line{icon_state = "1"; dir = 4},/obj/decal/sidewalk_curb,/turf/simulated/floor/road,/area/dmm_suite/clear_area)
"q" = (/obj/marker/prefab/city/parking{icon_state = "parking"; dir = 4},/turf/dmm_suite/clear_turf,/area/dmm_suite/clear_area)
"r" = (/obj/marker/prefab/city/parking{icon_state = "parking"; dir = 5},/turf/dmm_suite/clear_turf,/area/dmm_suite/clear_area)
"s" = (/obj/structure/scenery/flowers,/turf/simulated/floor/colored/grass,/area/dmm_suite/clear_area)
"t" = (/obj/decal/road_marking/dotted_line/half,/turf/simulated/floor/road,/area/dmm_suite/clear_area)
"u" = (/obj/marker/map_node/x3,/obj/decal/road_marking/dotted_line/half,/turf/simulated/floor/road,/area/dmm_suite/clear_area)
"v" = (/obj/decal/road_marking/dotted_line/half{icon_state = "1"; dir = 1},/turf/simulated/floor/road,/area/dmm_suite/clear_area)
"w" = (/obj/decal/road_marking/dotted_line/half{icon_state = "1"; dir = 1},/obj/decal/road_marking/dotted_line/half{icon_state = "1"; dir = 4},/turf/simulated/floor/road,/area/dmm_suite/clear_area)
"x" = (/obj/decal/road_marking/dotted_line/half{icon_state = "1"; dir = 8},/turf/simulated/floor/road,/area/dmm_suite/clear_area)
"y" = (/obj/decal/road_marking/dotted_line/half{icon_state = "1"; dir = 4},/turf/simulated/floor/road,/area/dmm_suite/clear_area)
"z" = (/obj/decal/road_marking/solid_line,/obj/decal/sidewalk_curb{icon_state = "curb"; dir = 8},/turf/simulated/floor/road,/area/dmm_suite/clear_area)
"A" = (/obj/decal/road_marking/solid_line,/obj/decal/sidewalk_curb{icon_state = "curb"; dir = 4},/turf/simulated/floor/road,/area/dmm_suite/clear_area)
"B" = (/obj/decal/road_marking/solid_line{icon_state = "1"; dir = 10},/obj/decal/sidewalk_curb{icon_state = "curb"; dir = 5},/turf/simulated/floor/road,/area/dmm_suite/clear_area)

(1,1,1) = {"
aaaaaaaaaaaaaaaaaaaaaaaaaaaaaaaaaaaaaaaaaaaaaaaaaaaaaaaaaaaaaaaa
aaaaaaaaaaaaaaaaaaaaaaaaaaaaaaaaaaaaaaaaaaaaaaaaaaaaaaaaaaaaaaaa
aaaaaaaaaaaaaaaaaaaaaaaaaaaaaaaaaaaaaaaaaaaaaaaaaaaaaaaaaaaaaaaa
aaaaaaaaaaaaaaaaaaaaaaaaaaaaaaaaaaaaaaaaaaaaaaaaaaaaaaaaaaaaaaaa
aaaaaaaaaaaaaaaaaaaaaaaaaaaaaaaaaaaaaaaaaaaaaaaaaaaaaaaaaaaaaaaa
aaaaaaaaaaaaaaaaaaaaaaaaaaaaaaaaaaaaaaaaaaaaaaaaaaaaaaaaaaaaaaaa
aaaaaaaaaaaaaaaaaaaaaaaaaaaaaaaaaaaaaaaaaaaaaaaaaaaaaaaaaaaaaaaa
aaaaaaaaaaaaaaaaaaaaaaaaaaaaaaaaaaaaaaaaaaaaaaaaaaaaaaaaaaaaaaaa
aaaaaaaaaaaaaaaaaaaaaaaaaaaaaaaaaaaaaaaaaaaaaaaaaaaaaaaaaaaaaaaa
aaaaaaaaaaaaaaaaaaaaaaaaaaaaaaaaaaaaaaaaaaaaaaaaaaaaaaaaaaaaaaaa
aaaaaaaaaaaaaaaaaaaaaaaaaaaaaaaaaaaaaaaaaaaaaaaaaaaaaaaaaaaaaaaa
abaaaaaaabaaaaaaaabaaaaaaabaaaaaaaaaaaaaaaaaaaaaaaaaaaaaaaaaaaaa
aaaaaaaaaaaaaaaaaaaaaaaaaaaaaaaaaaaaaaaaaaaaaaaaaaaaaaaaaaaaaaaa
aaaaaaaaaaaaaaaaaaaaaaaaaaaaaaaaaaaaaaaaaaaaaaaaaaaaaaaaaaaaaaaa
aaaaaaaaaaaaaaaaaaaaaaaaaaaaaaaaaaaaaaaaaaaaaaaaaaaaaaaaaaaaaaaa
aaaaaaaaaaaaaaaaaaaaaaaaaaaaaaaaaaaaaaaaaaaaaaaaaaaaaaaaaaaaaaaa
aaaaaaaaaaaaaaaaaaaaaaaaaaaaaaaaaaaaaaaaaaaaaaaaaaaaaaaaaaaaaaaa
aaaaaaaaaaaaaaaaaaaaaaaaaaaaaaaaaaaaaaaaaaaaaaaaaaaaaaaaaaaaaaaa
aaaaaaaaaaaaaaaaaaaaaaaaaaaaaaaaaaaaaaaaaaaaaaaaaaaaaaaaaaaaaaaa
aaaaaaaaaaaaaaaaaaaaaaaaaaaaaaaaaaaaaaaaaaaaaaaaaaaaaaaaaaaaaaaa
aaaaaaaaaaaaaaaaaaaaaaaaaaaaaaaaaaaaaaaaaaaaaaaaaaaaaaaaaaaaaaaa
aaaaaaaaaaaaaaaaaaaaaaaaaaaaaaaaaaaaaaaaaaaaaaaaaaaaaaaaaaaaaaaa
aaaaaaaaaaaaaaaaaaaaaaaaaaaaaaaaaaaaaaaaaaaaaaaaaaaaaaaaaaaaaaaa
aaaaaaaaaaaaaaaaaaaaaaaaaaaaaaaaaaaaaaaaaaaaaaaaaaaaaaaaaaaaaaaa
aaaaaaaaaaaaaaaaaaaaaaaaaaaaaaaaaaaaaaaaaaaaaaaaaaaaaaaaaaaaaaaa
aaaaaaaaaaaaaaaaaaaaaaaaaaaaaaaaaaaaaaaaaaaaaaaaaaaaaaaaaaaaaaaa
aaaaaaaaaaaaaaaaaaaaaaaaaaaaaaaaaaaaaaaaaaaaaaaaaaaaaaaaaaaaaaaa
acaaaaaaaaaaaaaaaacaaaaaaaaaaaaaaaaaaaaaaaaaaaaaaaaaabaaaaaaaaaa
dddddddddddddddddddeddddddddddddddddaaaaaaaaaaaaaaaaaaaaaaaaaaaa
ffffffffffffffffffffffffffffffffffBdaaaaaaaaaaaaaaaaaaaaaaaaaaaa
hhhjhhhhjhhhhjhhhhjhhhhhhhhhhhhhhhAdaaaaaaaaaaaaaaaaaaaaaaaaaaaa
tttttttttttttttttttttttuttttuttthjAdaaaaaaaaaaaaaaaaaaaaaaaaaaaa
vvvvvvvvvvvvvvvvvvvvvvvvvvvvvvvwxhAdaaaaaaaaaaaaaaaaaaaaaaaaaaaa
hhhhhhhhhhhhhhhhhhhhhhhhhhhhhhhyxhAdaaaaaaaaaaaaaaaaaaaaaaaaaaaa
pppphhhhpppppppppppppppppppppghyxhAdaaaaaaaaaaaaaaaaaaaaaaaaaaaa
dddkooookddddkddddkddddddddmdzhyxhAdalaaaaaaaaaaaaaaabaaaaaaaaaa
aaadhhhhdsssssssssssssssssssdzhyxjAdaaaaaaaaaaaaaaaaaaaaaaaaaaaa
aaaaaaaaaaaaaaaaaaaaaaaaaaaadzhyxhAdaaaaaaaaaaaaaaaaaaaaaaaaaaaa
aaaaaaaaaaaaaaaaaaaaaaaaaaaadzhyxhAdaaaaaaaaaaaaaaaaaaaaaaaaaaaa
aaaaaaaaaaaaaaaaaaaaaaaaaaaadzhyxhAdaaaaaaaaaaaaaaaaaaaaaaaaaaaa
aaaaaaaaaaaaaaaaaaaaaaaaaaaaaihyxhAdaaaaaaaaaaaaaaaaaaaaaaaaaaaa
aaaaaaaaaaaaaaaaaaaaaaaaaaaaaihyxjAdaaaaaaaaaaaaaaaaaaaaaaaaaaaa
aaaaaaaaaaaaaaaaaaaaaaaaaaaaaihyxhAdaaaaaaaaaaaaaaaaaaaaaaaaaaaa
aaaaaaaaaaaaaaaaaaaaaaaaaaaaaihyxhAdaaaaaaaaaaaaaaaaaaaaaaaaaaaa
aaaaaaaaaaaaaaaaaaaaaaaaaaaadzhyxhAdaaaaaaaaaaaaaaaaaaaaaaaaaaaa
aaaaaaaaaaaaaaaaaaaaaaaaaaaadzhyxhAdaaaaaaaaaaaaaaaaaaaaaaaaaaaa
araaaaaaaaqaaaaaaaaqaaaaaaaadzhyxjAdaaaaaaaaaaaaaaaaaaaaaaaaaaaa
aaaaaaaaaaaaaaaaaaaaaaaaaaaadzhyxhAdaaaaaaaaaaaaaaaaaaaaaaaaaaaa
aaaaaaaaaaaaaaaaaaaaaaaaaaaadzhyxhAdaaaaaaaaaaaaaaaaaaaaaaaaaaaa
aaaaaaaaaaaaaaaaaaaaaaaaaaaadzhyxhAdaaaaaaaaaaaaaaaaaaaaaaaaaaaa
aaaaaaaaaaaaaaaaaaaaaaaaaaaadzhyxhAdaaaaaaaaaaaaaaaaaaaaaaaaaaaa
aaaaaaaaaaaaaaaaaaaaaaaaaaaadzhyxjAdaaaaaaaaaaaaaaaaaaaaaaaaaaaa
aaaaaaaaaaaaaaaaaaaaaaaaaaaadzhyxhAdaaaaaaaaaaaaaaaaaaaaaaaaaaaa
aaaaaaaaaaaaaaaaaaaaaaaaaaaadzhyxhAdaaaaaaaaaaaaaaaaaaaaaaaaaaaa
aaaaaaaaaaaaaaaaaaaaaaaaaaaadzhyxhAdaaaaaaaaaaaaaaaaabaaaaaaaaaa
aaaaaaaaaaaaaaaaaaaaaaaaaaaadzhyxhAdaaaaaaaaaaaaaaaaaaaaaaaaaaaa
aaaaaaaaaaaaaaaaaaaaaaaaaaaadzhyxjAdaaaaaaaaaaaaaaaaaaaaaaaaaaaa
aaaaaaaaaaaaaaaaaaaaaaaaaaaadzhyxhAdaaaaaaaaaaaaaaaaaaaaaaaaaaaa
aaaaaaaaaaaaaaaaaaaaaaaaaaaadzhyxhAdaaaaaaaaaaaaaaaaaaaaaaaaaaaa
aaaaaaaaaaaaaaaaaaaaaaaaaaaadzhyxhAdaaaaaaaaaaaaaaaaaaaaaaaaaaaa
aaaaaaaaaaaaaaaaaaaaaaaaaaaadzhyxhAdaaaaaaaaaaaaaaaaaaaaaaaaaaaa
aaaaaaaaaaaaaaaaaaaaaaaaaaaadzhyxjAdaaaaaaaaaaaaaaaaaaaaaaaaaaaa
aaaaaaanaaaaaaaaaaaaaaaaaaaadzhyxhAdalaaaaaaaaaaaaaaabaaaaaaaaaa
aaaaaaaaaaaaaaaaaaaaaaaaaaaadzhyxhAdaaaaaaaaaaaaaaaaaaaaaaaaaaaa
"}
