//MAP CONVERTED BY dmm2tgm.py THIS HEADER COMMENT PREVENTS RECONVERSION, DO NOT REMOVE
"a" = (
/turf/simulated/wall/brick/red,
/area/dmm_suite/clear_area)
"b" = (
/turf/dmm_suite/clear_turf,
/area/dmm_suite/clear_area)
"c" = (
/turf/simulated/floor/colored/dirt/path,
/area/dmm_suite/clear_area)
"d" = (
/obj/marker/prefab/alley{
	icon_state = "alley";
	dir = 10
	},
/turf/dmm_suite/clear_turf,
/area/dmm_suite/clear_area)
"e" = (
/turf/simulated/floor/sidewalk,
/area/dmm_suite/clear_area)
"f" = (
/turf/simulated/floor/road,
/area/dmm_suite/clear_area)
"g" = (
/obj/marker/prefab/city/store,
/turf/dmm_suite/clear_turf,
/area/dmm_suite/clear_area)
"h" = (
/obj/marker/prefab/city/parking{
	icon_state = "parking";
	dir = 6
	},
/turf/dmm_suite/clear_turf,
/area/dmm_suite/clear_area)
"i" = (
/obj/marker/prefab/yard,
/turf/dmm_suite/clear_turf,
/area/dmm_suite/clear_area)
"j" = (
/obj/marker/prefab/city/parking,
/turf/simulated/floor/sidewalk,
/area/dmm_suite/clear_area)
"k" = (
/obj/marker/prefab/city/store{
	icon_state = "";
	dir = 1
	},
/turf/dmm_suite/clear_turf,
/area/dmm_suite/clear_area)
"l" = (
/obj/marker/prefab/alley_end{
	icon_state = "alley_end";
	dir = 4
	},
/turf/dmm_suite/clear_turf,
/area/dmm_suite/clear_area)
"m" = (
/obj/marker/prefab/house{
	icon_state = "";
	dir = 8
	},
/turf/dmm_suite/clear_turf,
/area/dmm_suite/clear_area)
"n" = (
/obj/marker/prefab/city/parking{
	icon_state = "parking";
	dir = 1
	},
/turf/dmm_suite/clear_turf,
/area/dmm_suite/clear_area)
"o" = (
/obj/marker/prefab/alley{
	icon_state = "alley";
	dir = 4
	},
/turf/dmm_suite/clear_turf,
/area/dmm_suite/clear_area)
"q" = (
/obj/decal/road_marking/solid_line,
/turf/simulated/floor/road,
/area/dmm_suite/clear_area)
"s" = (
/obj/decal/road_marking/solid_line{
	icon_state = "1";
	dir = 4
	},
/turf/simulated/floor/road,
/area/dmm_suite/clear_area)
"t" = (
/obj/decal/road_marking/solid_line,
/obj/marker/map_node/x3,
/turf/simulated/floor/road,
/area/dmm_suite/clear_area)
"u" = (
/obj/decal/road_marking/solid_line{
	icon_state = "1";
	dir = 6
	},
/turf/simulated/floor/road,
/area/dmm_suite/clear_area)
"v" = (
/obj/decal/road_marking/solid_line{
	icon_state = "1";
	dir = 8
	},
/turf/simulated/floor/road,
/area/dmm_suite/clear_area)
"w" = (
/obj/decal/road_marking/solid_line{
	icon_state = "1";
	dir = 10
	},
/turf/simulated/floor/road,
/area/dmm_suite/clear_area)
"x" = (
/obj/decal/road_marking/solid_line{
	icon_state = "1";
	dir = 9
	},
/turf/simulated/floor/road,
/area/dmm_suite/clear_area)
"y" = (
/obj/decal/road_marking/solid_cross{
	icon_state = "1";
	dir = 4
	},
/turf/simulated/floor/road,
/area/dmm_suite/clear_area)
"z" = (
/obj/decal/road_marking/solid_stop{
	icon_state = "1";
	dir = 8
	},
/turf/simulated/floor/road,
/area/dmm_suite/clear_area)
"A" = (
/obj/structure/interactive/lighting/roadlamp,
/turf/simulated/floor/sidewalk,
/area/dmm_suite/clear_area)
"B" = (
/obj/decal/road_marking/dotted_line/half,
/turf/simulated/floor/road,
/area/dmm_suite/clear_area)
"C" = (
/obj/structure/interactive/stopsign{
	icon_state = "sign";
	dir = 8
	},
/turf/simulated/floor/sidewalk,
/area/dmm_suite/clear_area)
"D" = (
/obj/structure/interactive/lighting/roadlamp{
	icon_state = "lamp";
	dir = 1
	},
/turf/simulated/floor/sidewalk,
/area/dmm_suite/clear_area)
"E" = (
/obj/decal/road_marking/solid_cross{
	icon_state = "1";
	dir = 4
	},
/obj/marker/map_node/x4,
/turf/simulated/floor/road,
/area/dmm_suite/clear_area)
"F" = (
/obj/decal/road_marking/solid_line{
	icon_state = "1";
	dir = 8
	},
/obj/marker/map_node/x3,
/turf/simulated/floor/road,
/area/dmm_suite/clear_area)
"G" = (
/obj/decal/road_marking/dotted_line/half{
	icon_state = "1";
	dir = 8
	},
/turf/simulated/floor/road,
/area/dmm_suite/clear_area)
"H" = (
/obj/decal/road_marking/dotted_line/half{
	icon_state = "1";
	dir = 4
	},
/turf/simulated/floor/road,
/area/dmm_suite/clear_area)
"I" = (
/obj/marker/map_node/x4,
/obj/decal/road_marking/dotted_line/half,
/turf/simulated/floor/road,
/area/dmm_suite/clear_area)
"J" = (
/obj/decal/road_marking/dotted_line/half{
	icon_state = "1";
	dir = 1
	},
/turf/simulated/floor/road,
/area/dmm_suite/clear_area)

(1,1,1) = {"
b
b
b
b
b
b
b
b
b
b
b
b
b
b
b
b
b
b
b
b
b
b
b
b
b
b
b
b
e
s
f
B
J
f
s
e
b
b
b
b
b
b
b
b
b
b
b
b
b
b
b
b
b
b
b
b
b
b
b
b
b
b
b
b
"}
(2,1,1) = {"
b
b
b
b
b
b
b
b
b
b
b
b
b
b
b
b
b
b
b
b
b
b
b
b
b
b
b
b
e
s
f
B
J
f
s
e
b
b
b
b
b
b
b
b
b
b
b
b
b
b
b
b
b
b
b
b
b
b
b
b
b
b
b
b
"}
(3,1,1) = {"
b
b
b
b
b
b
b
b
b
b
b
b
b
b
b
b
b
b
b
b
b
b
b
b
b
b
b
g
e
s
f
B
J
f
s
e
b
b
b
b
b
b
b
b
b
b
n
b
b
b
b
b
n
b
b
b
b
b
b
b
b
b
b
b
"}
(4,1,1) = {"
b
b
b
b
b
b
b
b
b
b
b
b
b
b
b
b
b
b
b
b
b
b
b
b
b
b
b
b
e
s
f
I
J
f
s
e
b
b
b
b
b
b
b
b
b
b
b
b
b
b
b
b
b
b
b
b
b
b
b
b
b
b
b
b
"}
(5,1,1) = {"
b
b
b
b
b
b
b
b
b
b
b
b
b
b
b
b
b
b
b
b
b
b
b
b
b
b
b
b
e
s
f
B
J
f
s
e
b
b
b
b
b
b
b
b
b
b
b
b
b
b
b
b
b
b
b
b
b
b
b
b
b
b
b
l
"}
(6,1,1) = {"
b
b
b
b
b
b
b
b
b
b
b
b
b
b
b
b
b
b
b
b
b
b
b
b
b
b
b
b
e
s
f
B
J
f
s
e
b
b
b
b
b
b
b
b
b
b
b
b
b
b
b
b
b
f
f
f
b
b
b
b
b
b
b
b
"}
(7,1,1) = {"
b
b
b
b
b
b
b
b
b
b
b
b
b
b
b
b
b
b
b
b
b
b
b
b
b
b
b
b
e
s
f
B
J
f
s
e
b
b
b
b
b
b
b
b
b
b
b
b
b
b
b
b
b
f
f
f
b
b
b
b
b
b
b
b
"}
(8,1,1) = {"
b
b
b
b
b
b
b
b
b
b
b
b
b
b
b
b
b
b
b
b
b
b
b
b
b
b
b
b
e
s
f
I
J
f
s
e
b
b
b
b
b
b
b
b
b
b
b
b
b
b
b
b
b
f
f
f
b
b
b
b
b
b
b
b
"}
(9,1,1) = {"
b
b
b
b
b
b
b
b
b
b
b
b
b
b
b
b
b
b
b
b
b
b
b
b
b
b
b
b
e
s
f
B
J
f
s
e
b
b
b
b
b
b
b
b
b
b
b
b
b
b
b
b
b
f
f
f
b
b
b
b
b
b
b
b
"}
(10,1,1) = {"
b
b
b
b
b
b
b
b
b
b
b
b
b
b
b
b
b
b
b
b
b
b
b
b
b
b
b
b
e
s
f
B
J
f
s
e
b
b
b
b
b
b
b
b
b
b
b
b
b
b
b
b
b
f
f
f
b
b
b
b
b
b
b
b
"}
(11,1,1) = {"
b
b
b
b
b
b
b
b
b
b
b
b
b
b
b
b
b
b
b
b
b
b
b
b
b
b
b
b
e
s
f
B
J
f
s
e
b
b
b
b
b
b
b
b
b
b
b
b
b
b
b
b
b
f
f
f
b
b
b
b
b
b
b
b
"}
(12,1,1) = {"
b
b
b
b
b
b
b
b
b
b
b
b
b
b
b
b
b
b
b
b
b
b
b
b
b
b
b
b
e
s
f
B
J
f
s
e
b
b
b
b
b
b
b
b
b
b
b
b
b
b
b
b
b
f
f
f
b
b
b
b
b
b
b
b
"}
(13,1,1) = {"
b
b
b
b
b
b
b
b
b
b
b
b
b
b
b
b
b
b
b
b
b
b
b
b
b
b
b
b
e
s
f
B
J
f
s
e
b
b
b
b
b
b
b
b
b
b
b
b
b
b
b
k
e
f
f
f
b
b
b
b
b
b
b
o
"}
(14,1,1) = {"
b
b
b
b
b
b
b
b
b
b
b
b
b
b
b
b
b
b
b
b
b
b
b
b
b
b
b
b
e
s
f
B
J
f
s
e
b
b
b
b
b
b
b
b
b
b
b
b
b
b
b
b
e
f
f
f
b
b
b
b
b
b
b
b
"}
(15,1,1) = {"
b
b
b
b
b
b
b
b
b
b
b
b
b
b
b
b
b
b
b
b
b
b
b
b
b
b
b
b
e
s
f
I
J
f
s
e
b
b
b
b
b
b
b
b
b
b
b
b
b
b
b
b
e
f
f
f
b
b
b
b
b
b
b
b
"}
(16,1,1) = {"
b
b
b
b
b
b
b
b
b
b
b
b
b
b
b
b
b
b
b
b
b
b
b
b
b
b
b
b
e
s
f
B
J
f
s
e
b
b
b
b
b
b
b
b
b
b
b
b
b
b
b
b
e
f
f
f
b
b
b
b
b
b
b
b
"}
(17,1,1) = {"
b
b
b
b
b
b
b
b
b
b
b
b
b
b
b
b
b
b
b
b
b
b
b
b
b
b
b
b
e
s
f
B
J
f
s
e
b
b
b
b
b
b
b
b
b
b
b
b
b
b
b
b
e
f
f
f
b
b
b
b
b
b
b
b
"}
(18,1,1) = {"
b
b
b
b
b
b
b
b
b
b
b
b
b
b
b
b
b
b
b
b
b
b
b
b
b
b
b
b
e
s
f
B
J
f
s
e
b
b
b
b
b
b
b
b
b
b
b
b
b
b
b
b
e
f
f
f
b
b
b
b
b
b
b
b
"}
(19,1,1) = {"
b
b
b
b
b
b
b
b
b
b
b
b
b
b
b
b
b
b
b
h
b
b
b
b
b
b
b
b
j
s
f
B
J
f
s
e
b
b
b
b
b
b
b
b
b
b
b
b
b
b
b
b
e
f
f
f
b
b
b
b
b
b
b
b
"}
(20,1,1) = {"
b
b
b
b
b
b
b
b
b
b
b
b
b
b
b
b
b
b
b
b
b
b
b
b
b
b
b
b
A
s
f
B
J
f
s
e
b
b
b
b
b
b
b
b
b
b
b
b
b
b
b
b
e
f
f
f
b
b
b
b
b
b
b
b
"}
(21,1,1) = {"
b
b
b
b
b
b
b
b
b
b
b
b
b
b
b
b
b
b
b
b
b
b
b
b
b
b
b
b
e
s
f
B
J
f
s
e
b
b
b
b
b
b
b
b
b
b
b
b
b
b
b
b
e
f
f
f
b
b
b
b
b
b
b
o
"}
(22,1,1) = {"
b
b
b
b
b
b
b
b
b
b
b
b
b
b
b
b
b
b
b
b
b
b
b
b
b
b
b
b
e
s
f
I
J
f
s
e
b
b
b
b
b
b
b
b
b
b
b
b
b
b
b
b
e
f
f
f
b
b
b
b
b
b
b
b
"}
(23,1,1) = {"
b
b
b
b
b
b
b
b
b
b
b
b
b
b
b
b
b
b
b
b
b
b
b
b
b
b
b
b
e
s
f
B
J
f
s
e
b
b
b
b
b
b
b
b
b
b
b
b
b
b
b
b
e
f
f
f
b
b
b
b
b
b
b
b
"}
(24,1,1) = {"
b
b
b
b
b
b
b
b
b
b
b
b
b
b
b
b
b
b
b
b
b
b
b
b
b
b
b
b
e
s
f
B
J
f
s
e
b
b
b
b
b
b
b
b
b
b
b
b
b
b
b
b
e
f
f
f
b
b
b
b
b
b
b
b
"}
(25,1,1) = {"
b
b
b
b
b
b
b
b
b
b
b
b
b
b
b
b
b
b
b
b
b
b
b
b
b
b
b
b
e
s
f
B
J
f
s
e
b
b
b
b
b
b
b
b
b
b
b
b
b
b
b
b
e
f
f
f
b
b
b
b
b
b
b
b
"}
(26,1,1) = {"
b
b
b
b
b
b
b
b
b
b
b
b
b
b
b
b
b
b
b
b
b
b
b
b
b
b
b
b
e
s
f
B
J
f
s
e
b
b
b
b
b
b
b
b
b
b
b
b
b
b
b
b
e
f
f
f
b
b
b
b
b
b
b
b
"}
(27,1,1) = {"
b
b
b
b
b
b
b
b
b
b
b
b
b
b
b
b
b
b
b
b
b
b
b
b
b
b
b
b
e
s
f
B
J
f
s
C
b
b
b
b
b
b
b
b
b
b
b
b
b
b
b
b
e
f
f
f
b
b
b
b
b
b
b
b
"}
(28,1,1) = {"
b
b
b
b
b
b
b
b
b
b
b
b
b
b
b
b
b
b
b
b
b
b
b
b
b
b
b
b
e
s
f
f
z
z
z
D
b
b
b
b
b
b
b
b
b
b
b
b
b
b
b
b
e
f
f
f
b
b
b
b
b
b
b
b
"}
(29,1,1) = {"
b
b
b
b
b
b
b
b
b
b
d
a
e
e
e
e
e
e
e
e
e
e
e
e
e
e
e
e
e
y
y
E
y
y
y
e
e
e
e
e
e
e
e
e
e
e
e
e
e
e
e
e
e
f
f
f
e
e
e
e
e
e
e
e
"}
(30,1,1) = {"
b
b
b
b
b
b
b
b
b
b
b
c
e
u
q
q
q
q
q
q
q
q
q
q
q
q
q
q
q
x
f
f
f
f
w
f
q
q
q
q
q
q
q
q
q
q
q
q
q
q
q
q
t
f
f
f
q
t
q
q
q
q
t
q
"}
(31,1,1) = {"
b
b
b
b
b
b
b
b
b
b
b
c
e
v
f
f
f
f
f
f
f
f
f
f
f
f
f
f
f
f
f
f
f
f
f
f
f
f
f
f
f
f
f
f
f
f
f
f
f
f
f
f
f
f
f
f
f
f
f
f
f
f
f
f
"}
(32,1,1) = {"
b
b
b
b
b
b
b
b
b
b
b
c
e
v
f
f
f
f
f
f
f
f
H
H
H
H
H
H
H
H
f
f
f
f
H
H
H
H
H
H
H
H
H
H
H
H
H
H
H
H
H
H
H
H
H
H
H
H
H
H
H
H
H
H
"}
(33,1,1) = {"
b
b
b
b
b
b
b
b
b
b
b
c
e
F
f
f
f
f
f
f
f
f
G
G
G
G
G
G
G
G
f
f
f
f
G
G
G
G
G
G
G
G
G
G
G
G
G
G
G
G
G
G
G
G
G
G
G
G
G
G
G
G
G
G
"}
(34,1,1) = {"
b
b
b
b
b
b
b
b
b
b
b
c
e
v
f
f
f
f
f
f
f
f
f
f
f
f
f
f
f
f
f
f
f
f
f
f
f
f
f
f
f
f
f
f
f
f
f
f
f
f
f
f
f
f
f
f
f
f
f
f
f
f
f
f
"}
(35,1,1) = {"
b
b
b
b
b
b
b
b
b
b
b
c
e
w
q
q
q
t
q
q
q
q
t
q
q
q
q
t
q
q
q
q
t
q
q
q
q
t
q
q
q
q
t
q
q
q
q
t
q
q
q
q
t
q
q
q
q
t
q
q
q
q
t
q
"}
(36,1,1) = {"
b
b
b
b
b
b
b
b
b
b
b
a
e
e
e
e
e
e
e
e
e
e
e
e
e
e
e
e
e
e
e
e
e
e
e
e
e
e
e
e
e
e
e
e
e
e
e
e
e
e
e
e
e
e
e
e
e
e
e
e
e
e
e
e
"}
(37,1,1) = {"
b
b
b
b
b
b
b
b
b
b
b
b
b
b
b
b
b
b
b
b
b
b
b
b
b
b
b
b
b
b
b
b
b
b
b
b
b
b
b
b
b
b
b
b
b
b
b
b
b
b
b
b
b
b
b
b
b
b
b
b
b
b
b
b
"}
(38,1,1) = {"
b
b
b
b
b
b
b
b
b
b
b
b
b
b
b
b
b
b
b
b
b
b
b
b
b
b
b
m
b
b
b
b
b
b
b
b
b
b
b
b
b
b
b
b
b
m
b
b
b
b
b
b
b
b
b
b
b
b
b
b
b
b
b
m
"}
(39,1,1) = {"
b
b
b
b
b
b
b
b
b
b
b
b
b
b
b
b
b
b
b
b
b
b
b
b
b
b
b
b
b
b
b
b
b
b
b
b
b
b
b
b
b
b
b
b
b
b
b
b
b
b
b
b
b
b
b
b
b
b
b
b
b
b
b
b
"}
(40,1,1) = {"
b
b
b
b
b
b
b
b
b
b
b
b
b
b
b
b
b
b
b
b
b
b
b
b
b
b
b
b
b
b
b
b
b
b
b
b
b
b
b
b
b
b
b
b
b
b
b
b
b
b
b
b
b
b
b
b
b
b
b
b
b
b
b
b
"}
(41,1,1) = {"
b
b
b
b
b
b
b
b
b
b
b
b
b
b
b
b
b
b
b
b
b
b
b
b
b
b
b
b
b
b
b
b
b
b
b
b
b
b
b
b
b
b
b
b
b
b
b
b
b
b
b
b
b
b
b
b
b
b
b
b
b
b
b
b
"}
(42,1,1) = {"
b
b
b
b
b
b
b
b
b
b
b
b
b
b
b
b
b
b
b
b
b
b
b
b
b
b
b
b
b
b
b
b
b
b
b
b
b
b
b
b
b
b
b
b
b
b
b
b
b
b
b
b
b
b
b
b
b
b
b
b
b
b
b
b
"}
(43,1,1) = {"
b
b
b
b
b
b
b
b
b
b
b
b
b
b
b
b
b
b
b
b
b
b
b
b
b
b
b
b
b
b
b
b
b
b
b
b
b
b
b
b
b
b
b
b
b
b
b
b
b
b
b
b
b
b
b
b
b
b
b
b
b
b
b
b
"}
(44,1,1) = {"
b
b
b
b
b
b
b
b
b
b
b
b
b
b
b
b
b
b
b
b
b
b
b
b
b
b
b
b
b
b
b
b
b
b
b
b
b
b
b
b
b
b
b
b
b
b
b
b
b
b
b
b
b
b
b
b
b
b
b
b
b
b
b
b
"}
(45,1,1) = {"
b
b
b
b
b
b
b
b
b
b
b
b
b
b
b
b
b
b
b
b
b
b
b
b
b
b
b
b
b
b
b
b
b
b
b
b
b
b
b
b
b
b
b
b
b
b
b
b
b
b
b
b
b
b
b
b
b
b
b
b
b
b
b
b
"}
(46,1,1) = {"
b
b
b
b
b
b
b
b
b
b
b
b
b
b
b
b
b
b
b
b
b
b
b
b
b
b
b
b
b
b
b
b
b
b
b
b
b
b
b
b
b
b
b
b
b
b
b
b
b
b
b
b
b
b
b
b
b
b
b
b
b
b
b
b
"}
(47,1,1) = {"
b
b
b
b
b
b
b
b
b
b
b
b
b
b
b
b
b
b
b
b
b
b
b
b
b
b
b
b
b
b
b
b
b
b
b
b
b
b
b
b
b
b
b
b
b
b
b
b
b
b
b
b
b
b
b
b
b
b
b
b
b
b
b
b
"}
(48,1,1) = {"
b
b
b
b
b
b
b
b
b
b
b
b
b
b
b
b
b
b
b
b
b
b
b
b
b
b
b
b
b
b
b
b
b
b
b
b
b
b
b
b
b
b
b
b
b
b
b
b
b
b
b
b
b
b
b
b
b
b
b
b
b
b
b
b
"}
(49,1,1) = {"
b
b
b
b
b
b
b
b
b
b
b
b
b
b
b
b
b
b
b
b
b
b
b
b
b
b
b
b
b
b
b
b
b
b
b
b
b
b
b
b
b
b
b
b
b
b
b
b
b
b
b
b
b
b
b
b
b
b
b
b
b
b
b
b
"}
(50,1,1) = {"
b
b
b
b
b
b
b
b
b
b
b
b
b
b
b
b
b
b
b
b
b
b
b
b
b
b
b
b
b
b
b
b
b
b
b
b
b
b
b
b
b
b
b
b
b
b
b
b
b
b
b
b
b
b
b
b
b
b
b
b
b
b
b
b
"}
(51,1,1) = {"
b
b
b
b
b
b
b
b
b
b
b
b
b
b
b
b
b
b
b
b
b
b
b
b
b
b
b
b
b
b
b
b
b
b
b
b
b
b
b
b
b
b
b
b
b
b
b
b
b
b
b
b
b
b
b
b
b
b
b
b
b
b
b
b
"}
(52,1,1) = {"
b
b
b
b
b
b
b
b
b
b
b
b
b
b
b
b
b
b
b
b
b
b
b
b
b
b
b
b
b
b
b
b
b
b
b
b
b
b
b
b
b
b
b
b
b
b
b
b
b
b
b
b
b
b
b
b
b
b
b
b
b
b
b
b
"}
(53,1,1) = {"
b
b
b
b
b
b
b
b
b
b
b
b
b
b
b
b
b
b
b
b
b
b
b
b
b
b
b
b
b
b
b
b
b
b
b
b
b
b
b
b
b
b
b
b
b
b
b
b
b
b
b
b
b
b
b
b
b
b
b
b
b
b
b
b
"}
(54,1,1) = {"
b
b
b
b
b
b
b
b
b
b
b
b
b
b
b
b
b
b
b
i
b
b
b
b
b
b
b
i
b
b
b
b
b
b
b
b
b
i
b
b
b
b
b
b
b
i
b
b
b
b
b
b
b
b
b
i
b
b
b
b
b
b
b
i
"}
(55,1,1) = {"
b
b
b
b
b
b
b
b
b
b
b
b
b
b
b
b
b
b
b
b
b
b
b
b
b
b
b
b
b
b
b
b
b
b
b
b
b
b
b
b
b
b
b
b
b
b
b
b
b
b
b
b
b
b
b
b
b
b
b
b
b
b
b
b
"}
(56,1,1) = {"
b
b
b
b
b
b
b
b
b
b
b
b
b
b
b
b
b
b
b
b
b
b
b
b
b
b
b
b
b
b
b
b
b
b
b
b
b
b
b
b
b
b
b
b
b
b
b
b
b
b
b
b
b
b
b
b
b
b
b
b
b
b
b
b
"}
(57,1,1) = {"
b
b
b
b
b
b
b
b
b
b
b
b
b
b
b
b
b
b
b
b
b
b
b
b
b
b
b
b
b
b
b
b
b
b
b
b
b
b
b
b
b
b
b
b
b
b
b
b
b
b
b
b
b
b
b
b
b
b
b
b
b
b
b
b
"}
(58,1,1) = {"
b
b
b
b
b
b
b
b
b
b
b
b
b
b
b
b
b
b
b
b
b
b
b
b
b
b
b
b
b
b
b
b
b
b
b
b
b
b
b
b
b
b
b
b
b
b
b
b
b
b
b
b
b
b
b
b
b
b
b
b
b
b
b
b
"}
(59,1,1) = {"
b
b
b
b
b
b
b
b
b
b
b
b
b
b
b
b
b
b
b
b
b
b
b
b
b
b
b
b
b
b
b
b
b
b
b
b
b
b
b
b
b
b
b
b
b
b
b
b
b
b
b
b
b
b
b
b
b
b
b
b
b
b
b
b
"}
(60,1,1) = {"
b
b
b
b
b
b
b
b
b
b
b
b
b
b
b
b
b
b
b
b
b
b
b
b
b
b
b
b
b
b
b
b
b
b
b
b
b
b
b
b
b
b
b
b
b
b
b
b
b
b
b
b
b
b
b
b
b
b
b
b
b
b
b
b
"}
(61,1,1) = {"
b
b
b
b
b
b
b
b
b
b
b
b
b
b
b
b
b
b
b
b
b
b
b
b
b
b
b
b
b
b
b
b
b
b
b
b
b
b
b
b
b
b
b
b
b
b
b
b
b
b
b
b
b
b
b
b
b
b
b
b
b
b
b
b
"}
(62,1,1) = {"
b
b
b
b
b
b
b
b
b
b
b
b
b
b
b
b
b
b
b
b
b
b
b
b
b
b
b
b
b
b
b
b
b
b
b
b
b
b
b
b
b
b
b
b
b
b
b
b
b
b
b
b
b
b
b
b
b
b
b
b
b
b
b
b
"}
(63,1,1) = {"
b
b
b
b
b
b
b
b
b
b
b
b
b
b
b
b
b
b
b
b
b
b
b
b
b
b
b
b
b
b
b
b
b
b
b
b
b
b
b
b
b
b
b
b
b
b
b
b
b
b
b
b
b
b
b
b
b
b
b
b
b
b
b
b
"}
(64,1,1) = {"
b
b
b
b
b
b
b
b
b
b
b
b
b
b
b
b
b
b
b
b
b
b
b
b
b
b
b
b
b
b
b
b
b
b
b
b
b
b
b
b
b
b
b
b
b
b
b
b
b
b
b
b
b
b
b
b
b
b
b
b
b
b
b
b
"}
