//MAP CONVERTED BY dmm2tgm.py THIS HEADER COMMENT PREVENTS RECONVERSION, DO NOT REMOVE
"a" = (
/turf/dmm_suite/clear_turf,
/area/dmm_suite/clear_area)
"b" = (
/obj/marker/prefab/yard,
/turf/dmm_suite/clear_turf,
/area/dmm_suite/clear_area)
"c" = (
/obj/marker/prefab/house,
/turf/simulated/wall/brick/city,
/area/dmm_suite/clear_area)
"d" = (
/obj/decal/road_marking/solid_line{
	icon_state = "1";
	dir = 6
	},
/turf/simulated/floor/road,
/area/dmm_suite/clear_area)
"e" = (
/turf/simulated/floor/sidewalk,
/area/dmm_suite/clear_area)
"f" = (
/obj/decal/road_marking/solid_line{
	icon_state = "1";
	dir = 9
	},
/turf/simulated/floor/road,
/area/dmm_suite/clear_area)
"g" = (
/obj/decal/road_marking/dotted_line/half{
	icon_state = "1";
	dir = 4
	},
/obj/decal/road_marking/dotted_line/half,
/turf/simulated/floor/road,
/area/dmm_suite/clear_area)
"h" = (
/obj/decal/road_marking/solid_line{
	icon_state = "1";
	dir = 10
	},
/turf/simulated/floor/road,
/area/dmm_suite/clear_area)
"i" = (
/obj/decal/road_marking/solid_line,
/turf/simulated/floor/road,
/area/dmm_suite/clear_area)
"j" = (
/turf/simulated/floor/road,
/area/dmm_suite/clear_area)
"k" = (
/obj/marker/prefab/city/parking,
/turf/simulated/floor/sidewalk,
/area/dmm_suite/clear_area)
"l" = (
/obj/decal/road_marking/dotted_line,
/turf/simulated/floor/road,
/area/dmm_suite/clear_area)
"m" = (
/obj/marker/prefab/house{
	icon_state = "";
	dir = 8
	},
/turf/dmm_suite/clear_turf,
/area/dmm_suite/clear_area)
"n" = (
/obj/decal/road_marking/dotted_line/half{
	icon_state = "1";
	dir = 8
	},
/obj/decal/road_marking/dotted_line/half{
	icon_state = "1";
	dir = 1
	},
/turf/simulated/floor/road,
/area/dmm_suite/clear_area)
"p" = (
/turf/simulated/wall/brick/city,
/area/dmm_suite/clear_area)
"q" = (
/obj/marker/prefab/city/parking{
	icon_state = "parking";
	dir = 4
	},
/turf/dmm_suite/clear_turf,
/area/dmm_suite/clear_area)
"r" = (
/obj/decal/road_marking/solid_line,
/obj/marker/map_node/x3,
/turf/simulated/floor/road,
/area/dmm_suite/clear_area)
"s" = (
/obj/structure/interactive/lighting/roadlamp,
/turf/simulated/floor/sidewalk,
/area/dmm_suite/clear_area)
"t" = (
/obj/decal/road_marking/solid_line{
	icon_state = "1";
	dir = 4
	},
/turf/simulated/floor/road,
/area/dmm_suite/clear_area)
"u" = (
/obj/marker/map_node/x3,
/turf/simulated/floor/road,
/area/dmm_suite/clear_area)
"v" = (
/obj/decal/road_marking/dotted_line/half{
	icon_state = "1";
	dir = 4
	},
/turf/simulated/floor/road,
/area/dmm_suite/clear_area)
"w" = (
/obj/decal/road_marking/dotted_line/half{
	icon_state = "1";
	dir = 8
	},
/turf/simulated/floor/road,
/area/dmm_suite/clear_area)
"x" = (
/obj/decal/road_marking/dotted_line/half,
/turf/simulated/floor/road,
/area/dmm_suite/clear_area)
"y" = (
/obj/decal/road_marking/dotted_line/half{
	icon_state = "1";
	dir = 1
	},
/turf/simulated/floor/road,
/area/dmm_suite/clear_area)
"z" = (
/obj/decal/road_marking/dotted_line/half{
	icon_state = "1";
	dir = 4
	},
/obj/decal/road_marking/dotted_line/half{
	icon_state = "1";
	dir = 1
	},
/turf/simulated/floor/road,
/area/dmm_suite/clear_area)
"A" = (
/obj/structure/interactive/lighting/roadlamp{
	icon_state = "lamp";
	dir = 1
	},
/turf/simulated/floor/sidewalk,
/area/dmm_suite/clear_area)
"B" = (
/obj/decal/road_marking/dotted_line/half{
	icon_state = "1";
	dir = 4
	},
/obj/marker/map_node/x3,
/turf/simulated/floor/road,
/area/dmm_suite/clear_area)
"E" = (
/obj/marker/prefab/city/store,
/turf/dmm_suite/clear_turf,
/area/dmm_suite/clear_area)
"F" = (
/obj/marker/prefab/city/parking{
	icon_state = "parking";
	dir = 4
	},
/turf/simulated/floor/sidewalk,
/area/dmm_suite/clear_area)
"G" = (
/obj/marker/prefab/city/parking{
	icon_state = "parking";
	dir = 10
	},
/turf/dmm_suite/clear_turf,
/area/dmm_suite/clear_area)
"I" = (
/obj/decal/road_marking/dotted_line/half{
	icon_state = "1";
	dir = 1
	},
/obj/marker/map_node/x3,
/turf/simulated/floor/road,
/area/dmm_suite/clear_area)
"J" = (
/obj/marker/prefab/city/parking{
	icon_state = "parking";
	dir = 5
	},
/turf/dmm_suite/clear_turf,
/area/dmm_suite/clear_area)
"K" = (
/obj/decal/road_marking/solid_cross,
/turf/simulated/floor/road,
/area/dmm_suite/clear_area)
"L" = (
/obj/decal/road_marking/dotted_line{
	icon_state = "1";
	dir = 4
	},
/turf/simulated/floor/road,
/area/dmm_suite/clear_area)
"M" = (
/obj/decal/road_marking/hazard/yellow,
/turf/simulated/floor/road,
/area/dmm_suite/clear_area)
"Y" = (
/obj/decal/road_marking/hazard/yellow,
/turf/dmm_suite/clear_turf,
/area/dmm_suite/clear_area)

(1,1,1) = {"
a
a
a
a
a
a
a
a
a
a
a
a
a
a
a
c
e
e
e
e
e
e
e
e
e
e
e
e
e
t
j
x
y
j
t
e
p
p
p
p
p
p
p
p
p
p
p
p
p
p
p
p
p
a
a
a
a
a
a
a
a
a
a
a
"}
(2,1,1) = {"
a
a
a
a
a
a
a
a
a
a
a
a
a
a
a
a
e
d
i
i
i
i
i
i
i
i
i
i
i
f
j
x
y
j
t
e
e
e
e
e
e
e
a
a
a
a
a
a
a
a
a
J
p
a
a
a
a
a
a
a
a
a
a
a
"}
(3,1,1) = {"
a
a
a
a
a
a
a
a
a
a
a
a
a
a
a
a
e
t
j
j
j
j
j
j
j
j
j
j
j
j
j
x
I
j
t
e
M
M
M
M
M
M
a
a
a
a
a
a
a
a
a
a
p
a
a
a
a
a
a
a
a
a
a
a
"}
(4,1,1) = {"
a
a
a
a
a
a
a
a
a
a
a
a
a
a
a
a
e
t
u
j
v
v
v
B
v
v
v
v
B
v
v
g
y
j
L
K
j
j
j
j
j
j
a
a
a
a
a
a
a
a
a
a
p
a
a
a
a
a
a
a
a
a
a
a
"}
(5,1,1) = {"
a
a
a
a
a
a
a
a
a
a
a
a
a
a
a
a
e
t
j
x
n
w
w
w
w
w
w
w
w
w
w
w
j
j
L
K
j
j
j
j
j
j
a
a
a
a
a
a
a
a
a
a
p
a
a
a
a
a
a
a
a
a
a
a
"}
(6,1,1) = {"
a
a
a
a
a
a
a
a
a
a
a
a
a
a
a
a
e
t
j
x
y
j
j
j
j
j
j
j
j
j
j
j
j
j
L
K
j
j
j
j
j
j
a
a
a
a
a
a
a
a
a
a
p
a
a
a
a
a
a
a
a
a
a
a
"}
(7,1,1) = {"
a
a
a
a
a
a
a
a
a
a
a
a
a
a
a
a
e
t
j
x
y
j
d
i
i
i
i
i
i
j
j
j
j
j
L
K
j
j
j
j
j
j
a
a
a
a
a
a
a
a
a
a
p
a
a
a
a
a
a
a
a
a
a
a
"}
(8,1,1) = {"
a
a
a
a
a
a
a
a
a
a
a
a
a
a
a
a
e
t
j
x
y
j
t
e
e
e
e
e
e
M
M
M
M
M
M
e
M
M
M
M
M
M
a
a
a
a
a
a
a
a
a
a
p
a
a
a
a
a
a
a
a
a
a
a
"}
(9,1,1) = {"
a
a
a
a
a
a
a
a
a
a
a
a
a
a
a
a
e
t
u
x
y
j
t
e
p
p
p
p
e
e
e
e
e
e
e
e
e
e
e
e
e
e
a
a
a
a
a
a
a
a
a
a
p
a
a
a
a
a
a
a
a
a
a
a
"}
(10,1,1) = {"
a
a
a
a
a
a
a
a
a
a
a
a
a
a
a
a
e
t
j
x
y
j
t
e
p
a
a
a
a
a
a
a
a
a
a
a
a
a
a
a
a
a
a
a
a
a
a
a
a
a
a
a
p
a
a
a
a
a
a
a
a
a
a
a
"}
(11,1,1) = {"
a
a
a
a
a
a
a
a
a
a
a
a
a
a
a
a
e
t
j
x
y
j
t
e
p
a
a
a
a
a
a
a
a
a
a
a
a
a
a
a
a
a
a
a
a
a
a
a
a
a
a
q
p
a
a
a
a
a
a
a
a
a
a
a
"}
(12,1,1) = {"
a
a
a
a
a
a
a
a
a
a
a
a
a
a
a
a
e
t
j
x
y
j
t
e
p
a
a
a
a
a
a
a
a
a
a
a
a
a
a
a
a
E
a
a
a
a
a
a
a
a
a
a
p
a
a
a
a
a
a
a
a
a
a
a
"}
(13,1,1) = {"
a
a
a
a
a
a
a
a
a
a
a
a
a
a
a
a
e
t
j
x
y
j
t
e
p
a
a
a
a
a
a
a
a
a
a
a
a
a
a
a
a
a
a
a
a
a
a
a
a
a
a
a
p
a
a
a
a
a
a
a
a
a
a
a
"}
(14,1,1) = {"
a
a
a
a
a
a
a
a
a
a
a
a
a
a
a
a
e
t
u
x
y
j
t
e
p
a
a
a
a
a
a
a
a
a
a
a
a
a
a
a
a
a
a
a
a
a
a
a
a
a
a
a
p
a
a
a
a
a
a
a
a
a
a
a
"}
(15,1,1) = {"
a
a
a
a
a
a
a
a
a
a
a
a
a
a
a
a
e
t
j
x
y
j
t
e
p
a
a
a
a
a
a
a
a
a
a
a
a
a
a
a
a
a
a
a
a
a
a
a
a
a
a
a
p
a
a
a
a
a
a
a
a
a
a
a
"}
(16,1,1) = {"
a
a
a
a
a
a
a
a
a
a
a
a
a
a
a
a
e
t
j
x
y
j
t
e
p
a
a
a
a
a
a
a
a
a
a
a
a
a
a
a
a
a
a
a
a
a
a
a
a
a
a
a
p
a
a
a
a
a
a
a
a
a
a
a
"}
(17,1,1) = {"
a
a
a
a
a
a
a
a
a
a
a
a
a
a
a
a
e
t
j
x
y
j
t
e
p
a
a
a
a
a
a
a
a
a
a
a
a
a
a
a
a
a
a
a
a
a
a
a
a
a
a
a
p
a
a
a
a
a
a
a
a
a
a
a
"}
(18,1,1) = {"
a
a
a
a
a
a
a
a
a
a
a
a
a
a
a
a
e
t
j
x
y
j
t
e
p
a
a
a
a
a
a
a
a
a
a
a
a
a
a
a
a
a
a
a
a
a
a
a
a
a
a
a
p
a
a
a
a
a
a
a
a
a
a
a
"}
(19,1,1) = {"
a
a
a
a
a
a
a
a
a
a
a
a
a
a
a
a
e
t
u
x
y
j
t
e
p
a
a
a
a
a
a
a
a
a
a
a
a
a
a
a
a
a
a
a
a
a
a
a
a
a
a
a
p
a
a
a
a
a
a
a
a
a
a
a
"}
(20,1,1) = {"
a
a
a
a
a
a
a
a
a
a
a
a
a
a
a
a
s
t
j
x
y
j
t
e
p
a
a
a
a
a
a
a
a
a
a
a
a
a
a
a
a
a
a
a
a
a
a
a
a
a
a
q
p
a
a
a
a
a
a
a
a
a
a
a
"}
(21,1,1) = {"
a
a
a
a
p
p
p
p
p
p
p
p
p
p
p
p
e
t
j
x
y
j
t
e
p
a
a
a
a
a
a
a
a
a
a
a
a
a
a
a
a
a
a
a
a
a
a
a
a
a
a
a
p
a
a
a
a
a
a
a
a
a
a
a
"}
(22,1,1) = {"
a
a
a
a
p
a
a
a
a
a
a
a
a
a
a
a
k
t
j
x
y
j
t
e
p
a
a
a
a
a
a
a
a
a
a
a
a
a
a
a
a
a
a
a
a
a
a
a
a
a
a
a
p
a
a
a
a
a
a
a
a
a
a
a
"}
(23,1,1) = {"
a
a
a
a
p
a
a
a
a
a
a
a
a
a
a
a
e
t
j
x
y
j
t
e
p
a
a
a
a
a
a
a
a
a
a
a
a
a
a
a
a
a
a
a
a
a
a
a
a
a
a
a
p
a
a
a
a
a
a
a
a
a
a
a
"}
(24,1,1) = {"
a
a
a
a
p
a
e
a
a
a
a
a
a
a
a
a
e
t
u
x
y
j
t
e
p
a
a
a
a
a
a
a
a
a
a
a
a
a
a
a
a
a
a
a
a
a
a
a
a
a
a
a
p
a
a
a
a
a
a
a
a
a
a
a
"}
(25,1,1) = {"
a
a
a
a
p
a
e
a
a
a
a
a
a
a
a
a
e
t
j
x
y
j
t
e
p
a
a
a
a
a
a
a
a
a
a
a
a
a
a
a
a
a
a
a
a
a
a
a
a
a
a
a
p
a
a
a
a
a
a
a
a
a
a
a
"}
(26,1,1) = {"
a
a
a
a
p
a
e
a
a
a
a
a
a
a
a
a
e
t
j
x
y
j
t
e
p
a
a
a
a
a
a
a
a
a
a
a
a
a
a
a
a
a
a
a
a
a
a
a
a
a
a
a
p
a
a
a
a
a
a
a
a
a
a
a
"}
(27,1,1) = {"
a
a
a
a
p
a
e
a
a
a
a
a
a
a
a
a
e
t
j
x
y
j
t
e
p
a
a
a
a
a
a
a
a
a
a
a
a
a
a
a
a
a
a
a
a
a
a
a
a
a
a
a
p
a
a
a
a
a
a
a
a
a
a
a
"}
(28,1,1) = {"
a
a
a
a
p
a
e
a
a
a
a
a
a
a
a
a
e
t
j
x
y
j
t
A
p
a
a
a
a
a
a
a
a
a
a
a
a
a
a
a
a
a
a
a
a
a
a
a
a
a
a
a
p
p
p
p
p
p
p
p
p
p
p
p
"}
(29,1,1) = {"
p
p
p
p
p
a
e
a
a
a
a
a
a
a
a
a
e
t
u
x
y
j
t
e
e
e
e
e
e
e
e
e
e
e
e
e
e
e
e
e
e
e
e
e
e
e
e
e
e
e
e
e
e
e
e
e
e
e
e
e
e
e
e
e
"}
(30,1,1) = {"
a
a
a
a
a
a
a
a
a
a
a
a
a
a
a
a
e
t
j
x
y
j
h
i
i
i
i
i
i
i
i
i
i
i
i
i
i
i
i
i
i
i
i
i
i
l
l
l
l
i
i
i
i
i
i
i
i
i
i
i
i
i
i
i
"}
(31,1,1) = {"
a
a
a
a
a
a
a
a
a
a
a
a
a
a
a
a
e
t
j
x
y
j
j
j
j
v
u
j
j
j
j
u
j
j
j
j
u
j
j
j
j
u
j
j
j
j
u
j
j
j
j
u
j
j
j
j
j
j
j
j
j
j
j
j
"}
(32,1,1) = {"
a
a
a
a
a
a
a
a
a
a
a
a
a
a
a
E
e
t
j
x
z
v
v
v
v
v
v
v
v
v
v
v
v
v
v
v
v
v
v
v
v
v
v
v
v
v
v
v
v
v
v
v
v
v
v
v
v
v
v
v
v
v
v
v
"}
(33,1,1) = {"
a
a
a
a
a
a
a
a
a
a
a
a
a
a
a
a
e
t
j
j
w
w
w
w
w
w
w
w
w
w
w
w
w
w
w
w
w
w
w
w
w
w
w
w
w
w
w
w
w
w
w
w
w
w
w
w
w
w
w
w
w
w
w
w
"}
(34,1,1) = {"
a
a
a
a
a
a
a
a
a
a
a
a
a
a
a
a
e
t
u
j
j
j
j
u
j
j
j
j
j
j
j
j
j
j
j
j
j
j
j
j
j
j
j
j
j
j
j
j
j
j
j
j
j
j
j
j
j
j
j
j
j
j
j
j
"}
(35,1,1) = {"
a
a
a
a
a
a
a
a
a
a
a
a
a
a
a
a
e
h
i
l
l
l
l
i
i
i
i
i
r
i
i
i
i
r
i
i
i
i
r
i
i
i
i
r
i
i
i
i
i
i
r
i
i
i
i
r
i
i
i
i
r
i
i
i
"}
(36,1,1) = {"
a
a
a
a
a
a
a
a
a
a
a
a
a
a
a
a
e
e
e
e
e
e
e
e
e
F
e
e
e
e
e
e
e
e
e
e
e
e
e
e
e
e
e
e
e
e
e
e
e
e
e
e
e
e
e
e
e
e
e
e
e
e
e
e
"}
(37,1,1) = {"
a
a
a
a
a
a
a
a
a
a
a
a
a
a
a
a
a
a
a
a
a
a
a
a
a
a
p
a
a
a
a
a
a
a
a
a
a
a
a
a
a
a
a
a
a
a
a
a
a
a
a
a
a
a
a
a
a
a
a
a
a
a
a
p
"}
(38,1,1) = {"
a
a
a
a
a
a
a
a
a
a
a
a
a
a
a
a
a
a
a
a
a
a
a
a
a
a
p
a
a
a
a
a
a
a
a
a
a
a
a
a
a
a
a
a
a
m
a
a
a
a
a
a
a
a
a
a
a
a
a
a
a
a
m
p
"}
(39,1,1) = {"
a
a
a
a
a
a
a
a
a
a
a
a
a
a
a
a
a
a
a
a
a
a
a
a
a
a
p
a
a
a
a
a
a
a
a
a
a
a
a
a
a
a
a
a
a
a
a
a
a
a
a
a
a
a
a
a
a
a
a
a
a
a
a
p
"}
(40,1,1) = {"
a
a
a
a
a
a
a
a
a
a
a
a
a
a
a
a
a
a
a
a
a
a
a
a
a
a
p
a
a
a
a
a
a
a
a
a
a
a
a
a
a
a
a
a
a
a
a
a
a
a
a
a
a
a
a
a
a
a
a
a
a
a
a
p
"}
(41,1,1) = {"
a
a
a
a
a
a
a
a
a
a
a
a
a
a
a
a
a
a
a
a
a
a
a
a
a
a
p
a
a
a
a
a
a
a
a
a
a
a
a
a
a
a
a
a
a
a
a
a
a
a
a
a
a
a
a
a
a
a
a
a
a
a
a
p
"}
(42,1,1) = {"
a
a
a
a
a
a
a
a
a
a
a
a
a
a
a
a
a
a
a
a
a
a
a
a
a
a
p
a
a
a
a
a
a
a
a
a
a
a
a
a
a
a
a
a
a
a
a
a
a
a
a
a
a
a
a
a
a
a
a
a
a
a
a
p
"}
(43,1,1) = {"
a
a
a
a
a
a
a
a
a
a
a
a
a
a
a
a
a
a
a
a
a
a
a
a
a
a
p
a
a
a
a
a
a
a
a
a
a
a
a
a
a
a
a
a
a
a
a
a
a
a
a
a
a
a
a
a
a
a
a
a
a
a
a
p
"}
(44,1,1) = {"
a
a
a
a
a
a
a
a
a
a
a
a
a
a
a
a
a
a
a
a
a
a
a
a
a
a
p
a
a
a
a
a
a
a
a
a
a
a
a
a
a
a
a
a
a
a
a
a
a
a
a
a
a
a
a
a
a
a
a
a
a
a
a
p
"}
(45,1,1) = {"
a
a
a
a
a
a
a
a
a
a
a
a
a
a
a
a
a
a
a
a
a
a
a
a
a
q
p
a
a
a
a
a
a
a
a
a
a
a
a
a
a
a
a
a
a
a
a
a
a
a
a
a
a
a
a
a
a
a
a
a
a
a
a
p
"}
(46,1,1) = {"
a
a
a
a
a
a
a
a
a
a
a
a
a
a
a
a
a
a
a
a
a
a
a
a
a
a
p
a
a
a
a
a
a
a
a
a
a
a
a
a
a
a
a
a
a
a
a
a
a
a
a
a
a
a
a
a
a
a
a
a
a
a
a
p
"}
(47,1,1) = {"
a
a
a
a
a
a
a
a
a
a
a
a
a
a
a
a
a
a
a
a
a
a
a
a
a
a
p
a
a
a
a
a
a
a
a
a
a
a
a
a
a
a
a
a
a
a
a
a
a
a
a
a
a
a
a
a
a
a
a
a
a
a
a
p
"}
(48,1,1) = {"
a
a
a
a
a
a
a
a
a
a
a
a
a
a
a
a
a
a
a
a
a
a
a
a
a
a
p
a
a
a
a
a
a
a
a
a
a
a
a
a
a
a
a
a
a
a
a
a
a
a
a
a
a
a
a
a
a
a
a
a
a
a
a
p
"}
(49,1,1) = {"
a
a
a
a
a
a
a
a
a
a
a
a
a
a
a
E
a
a
a
a
a
a
a
a
a
a
p
a
a
a
a
a
a
a
a
a
a
a
a
a
a
a
a
a
a
a
a
a
a
a
a
a
a
a
a
a
a
a
a
a
a
a
a
p
"}
(50,1,1) = {"
a
a
a
a
a
a
a
a
a
a
a
a
a
a
a
a
a
a
a
a
a
a
a
a
a
a
p
a
a
a
a
a
a
a
a
a
a
a
a
a
a
a
a
a
a
a
a
a
a
a
a
a
a
a
a
a
a
a
a
a
a
a
a
p
"}
(51,1,1) = {"
a
a
a
a
a
a
a
a
a
a
a
a
a
a
a
a
a
a
a
a
a
a
a
a
a
a
p
a
a
a
a
a
a
a
a
a
a
a
a
a
a
a
a
a
a
a
a
a
a
a
a
a
a
a
a
a
a
a
a
a
a
a
a
p
"}
(52,1,1) = {"
a
a
a
a
a
a
a
a
a
a
a
a
a
a
a
a
a
a
a
a
a
a
a
a
a
a
p
a
a
a
a
a
a
a
a
a
a
a
a
a
a
a
a
a
a
a
a
a
a
a
a
a
a
a
a
a
a
a
a
a
a
a
a
p
"}
(53,1,1) = {"
a
a
a
a
a
a
a
a
a
a
a
a
a
a
a
a
a
a
a
a
a
a
a
a
a
a
p
a
a
a
a
a
a
a
a
a
a
a
a
a
a
a
a
a
a
a
a
a
a
a
a
a
a
a
a
a
a
a
a
a
a
a
a
p
"}
(54,1,1) = {"
a
a
a
a
a
a
a
a
a
a
a
a
a
a
a
a
a
a
a
a
a
a
a
a
a
G
p
a
a
a
a
a
a
a
a
a
a
b
a
a
a
a
a
a
a
b
a
a
a
a
a
a
a
a
b
a
a
a
a
a
a
a
b
p
"}
(55,1,1) = {"
a
a
a
a
a
a
a
a
a
a
a
a
a
a
a
a
a
a
a
a
a
a
a
a
a
a
p
p
a
a
a
a
a
a
a
a
a
a
a
a
a
a
a
a
a
a
a
a
a
a
a
a
a
a
a
a
a
a
a
a
a
a
a
p
"}
(56,1,1) = {"
a
a
a
a
a
a
a
a
a
a
a
a
a
a
a
a
a
a
a
a
a
a
a
a
a
a
e
p
a
a
a
a
a
a
a
a
a
a
a
a
a
a
a
a
a
a
a
a
a
a
a
a
a
a
a
a
a
a
a
a
a
a
a
p
"}
(57,1,1) = {"
a
a
a
a
a
a
a
a
a
a
a
a
a
a
a
a
a
a
a
a
a
a
a
a
a
Y
e
p
a
a
a
a
a
a
a
a
a
a
a
a
a
a
a
a
a
a
a
a
a
a
a
a
a
a
a
a
a
a
a
a
a
a
a
p
"}
(58,1,1) = {"
a
a
a
a
a
a
a
a
a
a
a
a
a
a
a
a
a
a
a
a
a
a
a
a
a
Y
e
p
a
a
a
a
a
a
a
a
a
a
a
a
a
a
a
a
a
a
a
a
a
a
a
a
a
a
a
a
a
a
a
a
a
a
a
p
"}
(59,1,1) = {"
a
a
a
a
a
a
a
a
a
a
a
a
a
a
a
a
a
a
a
a
a
a
a
a
a
Y
e
p
a
a
a
a
a
a
a
a
a
a
a
a
a
a
a
a
a
a
a
a
a
a
a
a
a
a
a
a
a
a
a
a
a
a
a
p
"}
(60,1,1) = {"
a
a
a
a
a
a
a
a
a
a
a
a
a
a
a
a
a
a
a
a
a
a
a
a
a
Y
e
p
a
a
a
a
a
a
a
a
a
a
a
a
a
a
a
a
a
a
a
a
a
a
a
a
a
a
a
a
a
a
a
a
a
a
a
p
"}
(61,1,1) = {"
a
a
a
a
a
a
a
a
a
a
a
a
a
a
a
a
a
a
a
a
a
a
a
a
a
a
e
p
a
a
a
a
a
a
a
a
a
a
a
a
a
a
a
a
a
a
a
a
a
a
a
a
a
a
a
a
a
a
a
a
a
a
a
p
"}
(62,1,1) = {"
a
a
a
a
a
a
a
a
a
a
a
a
a
a
a
a
a
a
a
a
a
a
a
a
a
a
p
p
p
p
p
p
p
p
p
p
p
p
p
p
p
p
p
p
p
p
p
p
p
p
p
p
p
p
p
p
p
p
p
p
p
p
p
p
"}
(63,1,1) = {"
a
a
a
a
a
a
a
a
a
a
a
a
a
a
a
a
a
a
a
a
a
a
a
a
a
a
p
a
a
a
a
a
a
a
a
a
a
a
a
a
a
a
a
a
a
a
a
a
a
a
a
a
a
a
a
a
a
a
a
a
a
a
a
a
"}
(64,1,1) = {"
a
a
a
a
a
a
a
a
a
a
a
a
a
a
a
a
p
p
p
p
p
p
p
p
p
p
p
a
a
a
a
a
a
a
a
a
a
a
a
a
a
a
a
a
a
a
a
a
a
a
a
a
a
a
a
a
a
a
a
a
a
a
a
a
"}
