"a" = (/turf/dmm_suite/clear_turf,/area/dmm_suite/clear_area)
"b" = (/obj/marker/prefab/yard,/turf/dmm_suite/clear_turf,/area/dmm_suite/clear_area)
"c" = (/obj/marker/prefab/house,/turf/dmm_suite/clear_turf,/area/dmm_suite/clear_area)
"d" = (/obj/decal/road_marking/solid_line{icon_state = "1";dir = 6},/turf/simulated/floor/road,/area/dmm_suite/clear_area)
"e" = (/turf/simulated/floor/sidewalk,/area/dmm_suite/clear_area)
"f" = (/obj/decal/road_marking/solid_line{icon_state = "1";dir = 9},/turf/simulated/floor/road,/area/dmm_suite/clear_area)
"g" = (/obj/decal/road_marking/dotted_line/half{icon_state = "1";dir = 4},/obj/decal/road_marking/dotted_line/half,/turf/simulated/floor/road,/area/dmm_suite/clear_area)
"h" = (/obj/decal/road_marking/solid_line{icon_state = "1";dir = 10},/turf/simulated/floor/road,/area/dmm_suite/clear_area)
"i" = (/obj/decal/road_marking/solid_line,/turf/simulated/floor/road,/area/dmm_suite/clear_area)
"j" = (/turf/simulated/floor/road,/area/dmm_suite/clear_area)
"k" = (/turf/simulated/wall/brick/red,/area/dmm_suite/clear_area)
"l" = (/turf/simulated/floor/colored/dirt/path,/area/dmm_suite/clear_area)
"m" = (/obj/marker/prefab/house{icon_state = "";dir = 8},/turf/dmm_suite/clear_turf,/area/dmm_suite/clear_area)
"n" = (/obj/decal/road_marking/dotted_line/half{icon_state = "1";dir = 8},/obj/decal/road_marking/dotted_line/half{icon_state = "1";dir = 1},/turf/simulated/floor/road,/area/dmm_suite/clear_area)
"o" = (/obj/marker/prefab/city/store{icon_state = "";dir = 1},/turf/dmm_suite/clear_turf,/area/dmm_suite/clear_area)
"p" = (/obj/marker/prefab/alley,/turf/dmm_suite/clear_turf,/area/dmm_suite/clear_area)
"q" = (/obj/marker/prefab/city/parking{icon_state = "parking";dir = 4},/turf/dmm_suite/clear_turf,/area/dmm_suite/clear_area)
"r" = (/obj/decal/road_marking/solid_line,/obj/marker/map_node/x3,/turf/simulated/floor/road,/area/dmm_suite/clear_area)
"s" = (/obj/structure/interactive/lighting/roadlamp,/turf/simulated/floor/sidewalk,/area/dmm_suite/clear_area)
"t" = (/obj/decal/road_marking/solid_line{icon_state = "1";dir = 4},/turf/simulated/floor/road,/area/dmm_suite/clear_area)
"u" = (/obj/marker/map_node/x3,/turf/simulated/floor/road,/area/dmm_suite/clear_area)
"v" = (/obj/decal/road_marking/dotted_line/half{icon_state = "1";dir = 4},/turf/simulated/floor/road,/area/dmm_suite/clear_area)
"w" = (/obj/decal/road_marking/dotted_line/half{icon_state = "1";dir = 8},/turf/simulated/floor/road,/area/dmm_suite/clear_area)
"x" = (/obj/decal/road_marking/dotted_line/half,/turf/simulated/floor/road,/area/dmm_suite/clear_area)
"y" = (/obj/decal/road_marking/dotted_line/half{icon_state = "1";dir = 1},/turf/simulated/floor/road,/area/dmm_suite/clear_area)
"z" = (/obj/decal/road_marking/dotted_line/half{icon_state = "1";dir = 4},/obj/decal/road_marking/dotted_line/half{icon_state = "1";dir = 1},/turf/simulated/floor/road,/area/dmm_suite/clear_area)
"A" = (/obj/structure/interactive/lighting/roadlamp{icon_state = "lamp";dir = 1},/turf/simulated/floor/sidewalk,/area/dmm_suite/clear_area)
"C" = (/obj/marker/prefab/alley_end{icon_state = "alley_end";dir = 4},/turf/dmm_suite/clear_turf,/area/dmm_suite/clear_area)
"D" = (/obj/marker/prefab/alley{icon_state = "alley";dir = 4},/turf/dmm_suite/clear_turf,/area/dmm_suite/clear_area)
"E" = (/obj/marker/prefab/city/store,/turf/dmm_suite/clear_turf,/area/dmm_suite/clear_area)
"F" = (/obj/marker/prefab/city/parking{icon_state = "parking";dir = 4},/turf/simulated/floor/sidewalk,/area/dmm_suite/clear_area)
"G" = (/obj/marker/prefab/city/parking{icon_state = "parking";dir = 10},/turf/dmm_suite/clear_turf,/area/dmm_suite/clear_area)
"H" = (/obj/marker/prefab/alley_end,/turf/dmm_suite/clear_turf,/area/dmm_suite/clear_area)

(1,1,1) = {"
aaaaaaaaaaaaaaaaaaaaaaaaaaaaaaaaaaaaaaaaaaaaaaaaaaaaaaaaaaaaaaaa
aaaaaaaaaaaaaaaaaaaaaaaaaaaaaaaaaaaaaaaaaaaaaaaaaaaaaaaaaaaaaaaa
aaaaaaaaaaaaaaaaaaaaaaaaaaaaaaaaaaaaaaaaaaaaaaaaaaaaaaaaaaaaaaaa
aaaaaaaaaaaaaaaaaaaaaaaaaaaaaaaaaaaaaaaaaaaaaaaaaaaaaaaaaaaaaaaa
aaaaaaaaaaaaaaaaaaaaaaaaaaaaaaaaaaaaaaaaaaaaaaaaaaaaaaaaaaaaaaaa
aaaaaaaaaaaaaaaaaaaaaaaaaaaaaaaaaaaaaaaaaaaaaaaaaaaaaaaaaaaaaaaa
aaaaaaaaaaaaaaaaaaaaaaaaaaaaaaaaaaaaaaaaaaaaaaaaaaaaaaaaaaaaaaaa
aaaaaaaaaaaaaaaaaaaaHaaaaaaaaaaaaaaaaaaaaaaaaaaaaaaaaaaaaaaaaaaa
aaaaaaaaaaaaaaaaaaaaaaaaaaaaaaaaaaaaaaaaaaaaaaaaaaaaaaaaaaaaaaaa
aaaaaaaaaaaaaaaaaaaaaaaaaaaaaaaaaaaaaaaaaaaaaaaaaaaaaaaaaaaaaaaa
aaaaaaaaaaaaaaaaaaaaaaaaaaaaaaaaaaaaaaaaaaaaaaaaaaaaaaaaaaaaaaaa
aaaaaaaaaaaaaaaaaaaaaaaaaaaaaaaaaaaaaaaaaaaaaaaaaaaaaaaaaaaaaaaa
aaaaaaaaaaaaaaaaaaaaaaaaaaaaaaaaaaaaaaaaaaaaaaaaaaaaaaaaaaaaaaaa
aaaaaaaaaaaaaaaaaaaaaaaaaaaaaaaaaaaaaaaaaaaaaaaaaaaaaaaaaaaaaaaa
aaaaaaaaaaaaaaaaaaaaaaaaaaaaaaaaaaaaaaaaaaaaaaaaaaaaaaaaaaaaaaaa
aacaaaaaaaaaaaaaaaaapaaaaaaaaaEaaaaaaaaaaaaaaaaaaaaaaaaaaaaaaaaa
eeeeeeeeeeeeeeeeeeeseeeeeeeeeeeeeeeeaaaaaaaaaaaaaaaaaaaaaaaaaaaa
edttttttttttttttttttttttttttttttttheaaaaaaaaaaaaEaaaaaaaaaaaaaaa
eijujjjjujjjjujjjjujjjjujjjjujjjjuieaaaaaaaaaaaaaaaaaaaaaaaaaaaa
eijjxxxxxxxxxxxxxxxxxxxxxxxxxxxxjjieaaaaaaaaaaaaaaaaaaaaaaaaaaaa
eijvnyyyyyyyyyyyyyyyyyyyyyyyyyyzwjieaaaaaaaaaaaaaaaaaaaaaaaaaaaa
eijvwjjjjjjjjjjjjjjjjjjjjjjjjjjvwjreaaaaaaaaaaaaaaaaaaaaaaaaaaaa
eijvwjdtttttttttttttttttttttthjvwjieaaaaaaaaaaaaaaaaaaaaaaaaaaaa
eijvwjieeeeeeeeeeeeeeeeeeeeAeijvwjieaaaaaaaaaaaaaaaaaaaaaaaaaaaa
eijvwjieaaaaaaaaaaaaaaaaaaaaeijvwjieaaaaaaaaaaaaaaaaaaaaaaaaaaaa
eijvwjieaaaaaaaaaaaaaaaaaaaaeivvwjieaaaaaaaaaaaaaaaaaaaaaaaaaaaa
eijvwjieaaaaaaaaaaaaaaaaaaaaeiuvwjieaaaaaaaaaaaaaaaaaaaaaaaaaaaa
eijvwjieaaaaaaaaaaaaaaaaaaaaeijvwjiFaaaaaaaaqaaaaaaaaGaaaaaaaaaa
eijvwjieaaaaaaaaaaaaaaaaaaaaeijvwjreallllllllllllllllkaeeeeeeaaa
tfjvwjieaaaaaaaaaaaaaaaaaaaaeijvwjieallllllllllllllllkkkkkkkkkaa
jjjvwjieaaaaaaaaaaaaaaaaaaaaeijvwjieaaaaaaaaaaaaaaaaaaaaaaaaakaa
xxxgwjieaaaaaaaaaaaaaaaaaaaaeiuvwjieaaaaaaaaaaaaaaaaaaaaaaaaakaa
yyyyjjieaaaaaaaaaaaaaaaaaaaaeijvwjieaaaaaaaaaaaaaaaaaaaaaaaaakaa
jjjjjjieaaaaaaaaaaaaaaaaaaaaeijvwjreaaaaaaaaaaaaaaaaaaaaaaaaakaa
ttttttfeaaaaaaaaaaaaaaaaaaaaeijvwjieaaaaaaaaaaaaaaaaaaaaaaaaakaa
eeeeeeeeaaaaaaaaaaaaaaaaaaaaeijvwjieaaaaaaaaaaaaaaaaaaaaaaaaakaa
aaaaaaaaaaaaaaaaaaaaaaaaaaaaeiuvwjieaaaaaaaaaaaaaaaaaaaaaaaaakaa
aaaaaaaaaaaaaaaaaaaaaaaaaaaaeijvwjieaaaaaaaaaaaaaaaaabaaaaaaakaa
aaaaaaaaaaaaaaaaaaaaaaaaaaaaeijvwjreaaaaaaaaaaaaaaaaaaaaaaaaakaa
aaaaaaaaaaaaaaaaaaaaaaaaaaaaeijvwjieaaaaaaaaaaaaaaaaaaaaaaaaakaa
aaaaaaaaaaaoaaaaaaaaaaaaaaaaeijvwjieaaaaaaaaaaaaaaaaaaaaaaaaakaa
aaaaaaaaaaaaaaaaaaaaaaaaaaaaeiuvwjieaaaaaaaaaaaaaaaaaaaaaaaaakaa
aaaaaaaaaaaaaaaaaaaaaaaaaaaaeijvwjieaaaaaaaaaaaaaaaaaaaaaaaaakaa
aaaaaaaaaaaaaaaaaaaaaaaaaaaaeijvwjreaaaaaaaaaaaaaaaaaaaaaaaaakaa
aaaaaaaaaaaaaaaaaaaaaaaaaaaaeijvwjieaaaaaaaaaaaaaaaaaaaaaaaaakaa
aaaaaaaaaaaaaaaaaaaaaaaaaaaaeijvwjieamaaaaaaaaaaaaaaabaaaaaaakaa
aaaaaaaaaaaaaaaaaaaaaaaaaaaaeiuvwjieaaaaaaaaaaaaaaaaaaaaaaaaaaaa
aaaaaaaaaaaaaaaaaaaaaaaaaaaaeijvwjieaaaaaaaaaaaaaaaaaaaaaaaaakaa
aaaaaaaaaaaaaaaaaaaaaaaaaaaaeijvwjieaaaaaaaaaaaaaaaaaaaaaaaaakaa
aaaaaaaaaaaaaaaaaaaaaaaaaaaaeijvwjieaaaaaaaaaaaaaaaaaaaaaaaaakaa
aaaaaaaaaaqaaaaaaaaqaaaaaaaaeijvwjreaaaaaaaaaaaaaaaaaaaaaaaaakaa
aaaaaaaaaakkkkkkkkkkkkkkkkkkeiuvwjieaaaaaaaaaaaaaaaaaaaaaaaaakaa
aaaaaaaaaaaaaaaaaaaaaaaaaaaaeijvwjieaaaaaaaaaaaaaaaaaaaaaaaaakaa
aaaaaaaaaaaaaaaaaaaaaaaaaaaaeijvwjieaaaaaaaaaaaaaaaaaaaaaaaaakaa
aaaaaaaaaaaaaaaaaaaaaaaaaaaaeijvwjieaaaaaaaaaaaaaaaaabaaaaaaakaa
aaaaaaaaaaaaaaaaaaaaaaaaaaaaeijvwjreaaaaaaaaaaaaaaaaaaaaaaaaakaa
aaaaaaaaaaaaaaaaaaaaaaaaaaaaeijvwjieaaaaaaaaaaaaaaaaaaaaaaaaakaa
aaaaaaaaaaaaaaaaaaaaaaaaaaaaeijvwjieaaaaaaaaaaaaaaaaaaaaaaaaakaa
aaaaCaaaaaaaDaaaaaaaDaaaaaaaeijvwjieaaaaaaaaaaaaaaaaaaaaaaaaakaa
aaaaaaaaaaaaaaaaaaaaaaaaaaaaeijvwjieaaaaaaaaaaaaaaaaaaaaaaaaakaa
aaaaaaaaaaaaaaaaaaaaaaaaaaaaeijvwjreaaaaaaaaaaaaaaaaaaaaaaaaakaa
aaaaaaaaaaaaaaaaaaaaaaaaaaaaeijvwjieaaaaaaaaaaaaaaaaaaaaaaaaakaa
aaaaaaaaaaaaaaaaaaaaaaaaaaaaeijvwjieamaaaaaaaaaaaaaaabaaaaaaakaa
aaaaaaaaaaaaaaaaaaaaaaaaaaaaeijvwjieaaaaaaaaaaaaaaaaakkkkkkkkkaa
"}
