"a" = (/turf/dmm_suite/clear_turf,/area/dmm_suite/clear_area)
"b" = (/turf/simulated/wall/brick/red,/area/dmm_suite/clear_area)
"c" = (/turf/simulated/wall/bananium,/area/dmm_suite/clear_area)
"d" = (/obj/marker/prefab/alley_end,/turf/dmm_suite/clear_turf,/area/dmm_suite/clear_area)
"e" = (/obj/marker/prefab/yard,/turf/dmm_suite/clear_turf,/area/dmm_suite/clear_area)
"f" = (/obj/marker/prefab/house,/turf/dmm_suite/clear_turf,/area/dmm_suite/clear_area)
"g" = (/turf/simulated/floor/sidewalk,/area/dmm_suite/clear_area)
"h" = (/turf/simulated/floor/colored/dirt/path,/area/dmm_suite/clear_area)
"i" = (/obj/decal/road_marking/solid_line{icon_state = "1"; dir = 4},/turf/simulated/floor/road,/area/dmm_suite/clear_area)
"j" = (/obj/decal/road_marking/solid_line{icon_state = "1"; dir = 10},/turf/simulated/floor/road,/area/dmm_suite/clear_area)
"k" = (/turf/simulated/floor/road,/area/dmm_suite/clear_area)
"l" = (/obj/decal/road_marking/solid_line,/turf/simulated/floor/road,/area/dmm_suite/clear_area)
"m" = (/obj/structure/interactive/fence/end{icon_state = "end"; dir = 1},/turf/simulated/floor/colored/dirt/path,/area/dmm_suite/clear_area)
"n" = (/obj/structure/interactive/fence/door{icon_state = "door_opened"; dir = 8},/turf/simulated/floor/colored/dirt/path,/area/dmm_suite/clear_area)
"o" = (/obj/decal/road_marking/dotted_line{icon_state = "1"; dir = 4},/turf/simulated/floor/road,/area/dmm_suite/clear_area)
"p" = (/obj/structure/interactive/fence{icon_state = "straight"; dir = 1},/turf/simulated/floor/colored/dirt/path,/area/dmm_suite/clear_area)
"q" = (/obj/decal/road_marking/dotted_line,/turf/simulated/floor/road,/area/dmm_suite/clear_area)
"r" = (/obj/structure/interactive/fence/end,/turf/dmm_suite/clear_turf,/area/dmm_suite/clear_area)
"s" = (/obj/marker/prefab/alley{icon_state = "alley"; dir = 6},/turf/dmm_suite/clear_turf,/area/dmm_suite/clear_area)
"t" = (/obj/marker/prefab/alley{icon_state = "alley"; dir = 10},/turf/dmm_suite/clear_turf,/area/dmm_suite/clear_area)
"u" = (/obj/marker/prefab/alley{icon_state = "alley"; dir = 1},/turf/dmm_suite/clear_turf,/area/dmm_suite/clear_area)
"v" = (/obj/marker/prefab/alley_end{icon_state = "alley_end"; dir = 1},/turf/dmm_suite/clear_turf,/area/dmm_suite/clear_area)
"w" = (/obj/structure/interactive/fence/end{icon_state = "end"; dir = 4},/turf/simulated/floor/colored/dirt/path,/area/dmm_suite/clear_area)
"x" = (/obj/structure/interactive/fence{icon_state = "straight"; dir = 4},/turf/simulated/floor/colored/dirt/path,/area/dmm_suite/clear_area)
"y" = (/obj/structure/interactive/fence/door,/turf/simulated/floor/colored/dirt/path,/area/dmm_suite/clear_area)
"z" = (/obj/structure/interactive/fence/end{icon_state = "end"; dir = 8},/turf/simulated/floor/colored/dirt/path,/area/dmm_suite/clear_area)
"B" = (/obj/decal/road_marking/solid_line{icon_state = "1"; dir = 5},/turf/simulated/floor/road,/area/dmm_suite/clear_area)
"C" = (/obj/decal/road_marking/solid_line{icon_state = "1"; dir = 8},/turf/simulated/floor/road,/area/dmm_suite/clear_area)
"D" = (/obj/marker/prefab/house{icon_state = ""; dir = 8},/turf/dmm_suite/clear_turf,/area/dmm_suite/clear_area)

(1,1,1) = {"
caaaaaaaaaaaaaaaaaaaaaaaaaaaaaaaaaaaaaaaaaaaaaaaaaaaaaaaaaaaaaac
aaaaaaaaaaaaaaaaaaaaaaaaaaaaabbbbbbbbbbbbbbbbbbbbbbbbbbbbbbbbbba
abbbbbbbbbbbbbbbbaaaaaaaaaaaabaaaaaaaaaaaaaaaaaaaaaaaaaaaaaaaaba
aaaaaaaaaaaaaaaaaaaaaaaaaaaaabaaaaaaaaaaaaaaaaaaaaaaaaaaaaaaaaba
aaaaaaaaaaaaaaaaaaaaaaaaaaaaabaaaaaaaaaaaaaaaaaaaaaaaaaaaaaaaaba
aaaaaaaaaaaaaaaaaaaaaaaaaaaaabaaaaaaaaaaaaaaaaaaaaaaaaaaaaaaaaba
aaaaaaaaaaaaaaaaaaaaaaaaaaaaabaaaaaaaaaaaaaaaaaaaaaaaaaaaaaaaaba
aaaaaaaaaaaaaaaaaaaaaaaaaaaaabaaaaaaaaaaaaaaaaaaaaaaaaaaaaaaaaba
aaaaaaaaaaaaaaaaaaaaaadaaaaaabaaaaaaaaaaaaaaaaaaaaaaaaaaaaaaaaba
aaaaaaaaaaaaaaaaaaaaaaaaaaaaabeaaaaaaaeaaaaaaaeaaaaaaaeaaaaaaaba
aeaaaaaaaeaaaaaaaaaaaaaaaaaaabaaaaaaaaaaaaaaaaaaaaaaaaaaaaaaaaba
aaaaaaaaaaaaaaaaaaaaaaaaaaaaabaaaaaaaaaaaaaaaaaaaaaaaaaaaaaaaaba
aaaaaaaaaaaaaaaaaaaaaaaaaaaaabaaaaaaaaaaaaaaaaaaaaaaaaaaaaaaaaba
aaaaaaaaaaaaaaaaaaaaaaaaaaaaabaaaaaaaaaaaaaaaaaaaaaaaaaaaaaaaaba
aaaaaaaaaaaaaaaaaaaaaaaaaaaaabaaaaaaaaaaaaaaaaaaaaaaaaaaaaaaaaba
aaaaaaaaaaaaaaaaaaaaaaaaaaaaabaaaaaaaaaaaaaaaaaaaaaaaaaaaaaaaaba
aaaaaaaaaaaaaaaaaaaaaaaaaaaaabaaaaaaaaaaaaaaaaaaaaaaaaaaaaaaaaba
aaaaaaaaaaaaaaaaaaaaaaaaaaaaabeaaaaaaaaaaaaaaaaaaaaaaaeaaaaaaaba
aaaaaaaaaaaaaaaaaaaaaaaaaaaaabaaaaaaaaaaaaaaaaaaaaaaaaaaaaaaaaba
aaaaaaaaaaaaaaaaaaaaaaaaaaaaabaaaaaaaaaaaaaaaaaaaaaaaaaaaaaaaaba
aaaaaaaaaaaaaaaaaaaaaaaaaaaaabaaaaaaaaaaaaaaaaaaaaaaaaaaaaaaaaba
aaaaaaaaaaaaaaaaaaaaaaaaaaaaabaaaaaaaaaaaaaaaaaaaaaaaaaaaaaaaaba
aaaaaaaaaaaaaaaaaaaaaaaaaaaaabaaaaaaaaaaaaaaaaaaaaaaaaaaaaaaaaba
aaaaaaaaaaaaaaaaaaaaaaaaaaaaabaaaaaaaaaaaaaaaaaaaaaaaaaaaaaaaaba
aaaaaaaaaaaaaaaaaaaaaaaaaaaaabaaaaaaaaaaaaaaaaaaaaaaaaaaaaaaaaba
aaaaaaaaaaaaaaaaaaaaaaaaaaaaabeaaaaaaafaaaaaaaaaaaaaaaeaaaaaaaba
afaaaaaaaaaaaaaaaaaaaaaaaaaaabaaaaaaaaaaaaaaaaaaaaaaaaaaaaaaaaba
aaaaaaaaaaaaaaaaaaaaaaaaaaaaabaaaaaaaaaaaaaaaaaaaaaaaaaaaaaaaaba
ggggggggggaaaaaaaaaaaaaaaaaaabaaaaaaaaaaahhhhhaaaaaaaaaaaaaaaaba
iiiiiiiijgaaaaaaaaaaaaaaaaaabbbaahhhhhhhhhhhhhaaaaaaaaaaaaaaaaba
kkkkkkkklghhhhhhhhhaaaaahhhhhmhhhhhhhhhhhhhhhhaaaaaaaaaaaaaaaaba
kkkkkkkklghhhhhhhhhhhhhhhhhhhnhhhhhhhhhhhhaaaaaaaaaaaaaaaaaaaaba
oooookkklghhhhhhhhhhhhhhhhhhhphhhhaaaaaaaaaaaaaaaaaaaaaaaaaaaaba
kkkkkqkklgaaaaaaaahhhhhhhaaahnhaaaaaaaaaaaaaaaeaaaaaaaeaaaaaaaba
kkkkkqkklgaaaaaaaaaaaaaaaaaaaraaaaaaaaaaaaaaaaaaaaaaaaaaaaaaaaba
iijkkqkklgaaaaaaaabbbbaaaaaaaaaaaaaaabbbbbbbbbbbbbbbbbbbbbbbbbba
gglkkqkklgaaaaaaaahhhhaaaaaaaaaaaaaaaaaaaaaaaaaaaaaaaaaaaaaaaaba
aglkkqkklgaaaaaaaahhhhaaaaaaaaaaaaaaaaaaaaaaaaaaaaaaaaaaaaaaaaba
aglkkqkklgaaaaaaaahhhhaaaaaaaaaaaaaaaaaaaaaaaaaaaaaaaaaaaaaaaaba
aglkkqkklgaaaaaaaahhhhaaaaaaaaaaaaaaaaaaaaaaaaaaaaaaaaaaaaaaaaba
aglkkqkklgaaaaaaaahhhhaaaaaaaaaaaaaaaaaaaaaaaaaaaaaaaaaaaaaaaaba
aglkkqkklgaaaaaaaahhhhaaaaaaaaaaaaaaaaaaaaaaaaaaaaaaaaaaaaaaaaba
aglkkqkklgsaaaaaaahhhhtaaaaaadaaaaaaaaaaaaaaaaaaaaaaaaaaaaaaaaba
aglkkqkklgaaaaaaaahhhhaaaaaaaaaaaaaaaaeaaaaaaaeaaaaaaaeaaaaaaaba
aglkkqkklgaaaaaaaahhhhaaaaaaaaaaaaaaaaaaaaaaaaaaaaaaaaaaaaaaaaba
aglkkqkklgaaaaaaaahhhhaaaaaaaaaaaaaaaaaaaaaaaaaaaaaaaaaaaaaaaaba
aglkkqkklgaaaaaaaahhhhaaaaaaaaaaaaaaaaaaaaaaaaaaaaaaaaaaaaaaaaba
aglkkqkklgaaaaaaaahhhhaaaaaaaaaaaaaaaaaaaaaaaaaaaaaaaaaaaaaaaaba
aglkkqkklgaaaaaaaahhhhaaaaaaaaaaaaaaaaaaaaaaaaaaaaaaaaaaaaaaaaba
aglkkqkklgaaaaaaaahhhhaaaaaaaaaaaaaaaaaaaaaaaaaaaaaaaaaaaaaaaaba
aglkkqkklgvaaaaaaawxyzvaaaaaauaaaaaaaaaaaaaaaaaaaaaaaaaaaaaaaaba
aglkkqkklggggggggggggggggggggggggggggaaaaaaaaaaaaaaaaaeaaaaaaaba
aglkkqkkBCCCCCCCCCCCCCCCCCCCCiiiiiijgaaaaaaaaaaaaaaaaaaaaaaaaaba
aglkkqkkkkkkkkkkkkkkkkkkkkkkkkkkkkklgaaaaaaaaaaaaaaaaaaaaaaaaaba
aglkkqkkkkkkkkkkkkkkkkkkkkkkkkkkkkklgaaaaaaaaaaaaaaaaaaaaaaaaaba
aglkkkooooooooooooooooooooooooookkklgaaaaaaaaaaaaaaaaaaaaaaaaaba
aglkkkkkkkkkkkkkkkkkkkkkkkkkkkkkqkklgaaaaaaaaaaaaaaaaaaaaaaaaaba
aglkkkkkkkkkkkkkkkkkkkkkkkkkkkkkqkklgaaaaaaaaaaaaaaaaaaaaaaaaaba
agBCCCCCCCCCCCCCCCCCCCCCCCCCCjkkqkklgaaaaaaaaaaaaaaaaaaaaaaaaaba
agggggggggggggggggggggggggggglkkqkklgaDaaaaaaaaaaaaaaaeaaaaaaaba
aaaaaaaaaaaaaaaaaaaaaaaaaaaaglkkqkklgabbbbbbbbbbbbbbbbbbbbbbbbba
aaaaaaaaaaaaaaaaaaaaaaaaaaaaglkkqkklgaaaaaaaaaaaaaaaaaaaaaaaaaaa
aaaaaaaaaaaaaaaaaaaaaaaaaaaaglkkqkklgaaaaaaaaaaaaaaaaaaaaaaaaaaa
caaaaaaaaaaaaaaaaaaaaaaaaaaaglkkqkklgaaaaaaaaaaaaaaaaaaaaaaaaaac
"}
