//MAP CONVERTED BY dmm2tgm.py THIS HEADER COMMENT PREVENTS RECONVERSION, DO NOT REMOVE
"a" = (
/turf/simulated/wall/brick/red,
/area/dmm_suite/clear_area)
"b" = (
/obj/structure/interactive/storage/trash_pile/low_chance,
/turf/simulated/floor/colored/dirt/path,
/area/dmm_suite/clear_area)
"c" = (
/turf/simulated/floor/colored/dirt/path,
/area/dmm_suite/clear_area)
"d" = (
/obj/item/trash/random,
/turf/simulated/floor/colored/dirt/path,
/area/dmm_suite/clear_area)
"e" = (
/obj/structure/interactive/fence/end{
	icon_state = "end";
	dir = 4
	},
/turf/simulated/floor/colored/dirt/path,
/area/dmm_suite/clear_area)
"f" = (
/obj/structure/interactive/fence{
	icon_state = "straight";
	dir = 4
	},
/turf/simulated/floor/colored/dirt/path,
/area/dmm_suite/clear_area)
"g" = (
/obj/structure/interactive/fence/door,
/turf/simulated/floor/colored/dirt/path,
/area/dmm_suite/clear_area)
"h" = (
/obj/structure/interactive/fence/end{
	icon_state = "end";
	dir = 8
	},
/turf/simulated/floor/colored/dirt/path,
/area/dmm_suite/clear_area)

(1,1,1) = {"
a
b
c
c
a
a
a
a
"}
(2,1,1) = {"
a
b
c
c
b
e
b
b
"}
(3,1,1) = {"
a
b
c
d
c
g
c
c
"}
(4,1,1) = {"
a
b
c
c
b
f
b
c
"}
(5,1,1) = {"
a
b
c
d
b
h
b
b
"}
(6,1,1) = {"
a
b
c
b
a
a
a
a
"}
(7,1,1) = {"
a
c
d
c
c
c
b
a
"}
(8,1,1) = {"
a
a
a
a
a
a
a
a
"}
