//MAP CONVERTED BY dmm2tgm.py THIS HEADER COMMENT PREVENTS RECONVERSION, DO NOT REMOVE
"a" = (
/turf/dmm_suite/clear_turf,
/area/dmm_suite/clear_area)
"b" = (
/turf/dmm_suite/no_wall,
/area/dmm_suite/clear_area)
"c" = (
/obj/marker/map_node/x2,
/turf/simulated/floor/xeno,
/area/mission/prefab/misc/xenomorph_hive)
"d" = (
/turf/simulated/floor/xeno,
/area/mission/prefab/misc/xenomorph_hive)
"e" = (
/obj/marker/smart_clear_turf,
/turf/dmm_suite/no_wall,
/area/dmm_suite/clear_area)
"f" = (
/turf/simulated/wall/xeno,
/area/mission/prefab/misc/xenomorph_hive)
"g" = (
/obj/structure/interactive/crate/chest/filled,
/turf/simulated/floor/xeno,
/area/mission/prefab/misc/xenomorph_hive)
"h" = (
/mob/living/simple/xeno/drone,
/turf/simulated/floor/xeno,
/area/mission/prefab/misc/xenomorph_hive)
"i" = (
/mob/living/simple/xeno/hunter,
/turf/simulated/floor/xeno,
/area/mission/prefab/misc/xenomorph_hive)
"j" = (
/mob/living/simple/xeno/sentinel,
/turf/simulated/floor/xeno,
/area/mission/prefab/misc/xenomorph_hive)
"k" = (
/obj/marker/map_node,
/turf/simulated/floor/xeno,
/area/mission/prefab/misc/xenomorph_hive)
"l" = (
/obj/marker/map_node/x3,
/turf/simulated/floor/xeno,
/area/mission/prefab/misc/xenomorph_hive)
"m" = (
/obj/marker/map_node/x4,
/turf/simulated/floor/xeno,
/area/mission/prefab/misc/xenomorph_hive)
"n" = (
/obj/marker/objective_spawn,
/turf/simulated/floor/xeno,
/area/mission/prefab/misc/xenomorph_hive)
"o" = (
/mob/living/simple/xeno/queen,
/turf/simulated/floor/xeno,
/area/mission/prefab/misc/xenomorph_hive)
"p" = (
/obj/marker/lobby,
/turf/simulated/floor/xeno,
/area/mission/prefab/misc/xenomorph_hive)
"q" = (
/turf/dmm_suite/clear_turf,
/area/mission/prefab/misc/xenomorph_hive)
"r" = (
/obj/marker/map_node,
/mob/living/simple/xeno/hunter,
/turf/simulated/floor/xeno,
/area/mission/prefab/misc/xenomorph_hive)
"s" = (
/turf/simulated/wall/xeno,
/area/dmm_suite/clear_area)
"t" = (
/turf/simulated/floor/xeno,
/area/dmm_suite/clear_area)
"u" = (
/obj/item/weapon/melee/tool/welder,
/turf/simulated/floor/xeno,
/area/dmm_suite/clear_area)
"v" = (
/mob/living/simple/xeno/drone,
/turf/simulated/floor/xeno,
/area/dmm_suite/clear_area)
"w" = (
/obj/item/clothing/back/flamethrower{
	contraband = 1;
	desc_extended = "A bulky back-mounted canister with a flamethrower attached. The attached flamethrower spews flames that ignite anything they hit and the ground they pass. This one is caked in Xenomorph resin.";
	name = "resin-coated flamethrower canister"
	},
/obj/item/weapon/ranged/energy/flamethrower{
	contraband = 1;
	name = "resin-coated flamethrower"
	},
/turf/simulated/floor/xeno,
/area/dmm_suite/clear_area)
"x" = (
/obj/marker/map_node/x2,
/turf/dmm_suite/no_wall,
/area/dmm_suite/clear_area)
"y" = (
/obj/structure/interactive/crate/chest/filled,
/turf/simulated/floor/xeno,
/area/dmm_suite/clear_area)
"z" = (
/obj/marker/map_node/x3,
/turf/dmm_suite/no_wall,
/area/dmm_suite/clear_area)
"A" = (
/mob/living/simple/xeno/hunter,
/turf/simulated/floor/xeno,
/area/dmm_suite/clear_area)

(1,1,1) = {"
a
a
a
a
a
a
a
a
a
a
a
a
a
a
a
a
a
a
a
a
a
a
a
a
a
a
a
a
a
a
a
a
a
a
a
a
a
a
a
a
a
a
a
a
a
a
a
a
a
a
a
a
a
a
a
a
a
a
a
a
a
a
a
a
"}
(2,1,1) = {"
a
a
a
a
a
a
a
a
a
a
a
a
a
a
a
a
a
a
a
a
a
a
a
a
a
a
a
a
a
a
a
a
a
a
a
a
a
a
a
a
a
a
a
a
a
a
a
a
a
a
a
a
a
a
a
a
a
a
a
a
a
a
a
a
"}
(3,1,1) = {"
a
a
a
a
a
a
a
a
a
a
a
a
a
a
a
a
a
a
a
a
a
a
a
a
a
a
a
a
a
a
a
a
a
a
a
a
a
a
a
a
a
a
a
a
a
a
a
a
a
a
a
a
a
a
a
a
a
a
a
a
a
a
a
a
"}
(4,1,1) = {"
a
a
a
a
a
a
a
a
a
a
a
a
a
a
a
a
a
a
a
a
a
a
a
a
a
a
a
a
a
a
a
a
a
a
a
a
a
a
a
a
a
a
a
a
a
a
a
a
a
a
a
a
b
b
b
b
b
b
b
a
a
a
a
a
"}
(5,1,1) = {"
a
a
a
a
a
a
a
a
a
b
b
b
b
b
b
b
b
a
a
a
a
a
a
a
a
a
a
a
a
a
a
a
a
a
a
a
a
a
a
a
a
a
a
a
a
a
a
a
a
a
b
b
b
b
b
b
b
b
b
b
b
a
a
a
"}
(6,1,1) = {"
a
a
a
a
a
a
a
a
b
b
b
b
b
b
b
b
b
a
a
a
a
a
a
a
a
a
a
a
a
a
a
a
a
a
a
a
a
a
a
a
a
a
a
a
a
a
a
a
a
b
b
b
s
s
s
s
s
s
b
b
b
a
a
a
"}
(7,1,1) = {"
a
a
a
a
a
a
a
b
b
b
d
d
d
d
d
b
b
b
a
a
a
a
f
f
f
f
f
f
f
a
a
a
a
a
a
a
a
a
a
a
a
a
a
a
a
a
a
a
b
b
b
b
s
s
s
y
t
s
s
b
b
a
a
a
"}
(8,1,1) = {"
a
a
a
a
a
a
a
b
e
d
d
d
c
d
d
d
e
b
b
b
a
a
f
g
d
d
d
i
f
a
a
a
a
a
b
b
b
b
b
b
a
a
a
a
a
a
a
a
b
b
b
s
s
u
t
t
t
s
s
b
b
a
a
a
"}
(9,1,1) = {"
a
a
a
a
a
a
a
f
f
f
d
d
d
d
d
d
f
f
b
b
a
a
f
d
d
d
d
d
f
a
a
a
b
b
b
b
d
d
d
e
b
b
a
a
a
a
a
a
b
b
b
s
s
v
t
t
s
s
b
b
b
b
a
a
"}
(10,1,1) = {"
a
a
a
a
a
a
a
f
d
d
d
d
d
d
d
d
d
f
b
b
a
a
f
d
d
d
d
d
f
a
a
b
e
d
d
d
l
d
d
d
b
b
a
a
a
a
a
a
b
b
s
s
t
t
t
t
s
s
b
b
b
b
a
a
"}
(11,1,1) = {"
a
a
a
a
a
a
a
f
d
d
d
d
i
d
d
d
d
f
b
b
a
a
f
d
d
c
d
d
f
a
a
b
d
d
d
d
d
d
d
d
d
b
a
a
a
a
a
a
b
b
s
s
t
t
t
v
s
s
s
s
s
b
b
a
"}
(12,1,1) = {"
a
a
a
a
a
a
a
f
d
d
d
d
d
d
d
d
d
f
b
b
a
a
f
d
h
d
d
d
f
a
a
b
f
f
d
d
d
d
d
f
f
b
a
a
a
a
a
a
b
b
s
s
s
v
t
t
t
t
t
A
s
b
b
a
"}
(13,1,1) = {"
a
a
a
a
a
a
a
f
d
d
d
h
d
c
d
d
d
f
f
f
f
f
f
d
d
d
d
d
f
a
a
b
f
d
d
d
d
d
d
d
f
b
a
a
a
a
a
a
b
b
b
s
s
w
t
t
t
t
t
t
s
s
b
a
"}
(14,1,1) = {"
a
a
a
a
a
a
a
f
d
d
d
d
d
d
j
d
d
d
f
d
d
d
f
d
d
k
d
d
f
a
a
b
f
d
d
d
h
d
d
d
f
b
a
a
a
a
a
a
b
b
b
s
s
s
s
t
t
t
t
t
t
s
b
a
"}
(15,1,1) = {"
a
a
a
a
a
a
a
f
d
d
d
d
d
d
d
d
d
d
f
d
d
d
f
f
f
d
f
f
f
f
f
f
f
d
d
d
l
d
d
d
f
b
a
a
a
a
a
a
b
b
b
b
b
b
b
b
b
b
b
t
t
s
b
a
"}
(16,1,1) = {"
a
a
a
a
a
a
a
f
d
d
d
d
d
d
d
c
d
d
f
d
d
d
f
d
d
k
d
f
d
d
d
d
f
d
d
d
d
d
d
d
f
b
a
a
a
a
a
a
a
a
a
b
b
b
b
b
b
b
b
b
b
b
b
a
"}
(17,1,1) = {"
a
a
a
a
a
a
a
f
f
f
f
f
f
d
d
h
d
d
f
d
d
d
d
d
d
j
d
f
d
d
d
d
f
d
d
d
d
d
d
d
f
a
a
a
a
a
a
a
a
a
a
a
a
a
a
a
t
a
a
a
a
a
a
a
"}
(18,1,1) = {"
a
a
a
a
a
a
a
a
a
a
a
a
f
d
d
d
d
d
f
d
i
d
d
d
d
d
k
d
k
i
k
d
f
d
d
d
d
d
d
d
f
a
a
a
a
a
a
a
a
a
a
a
a
a
a
b
b
b
t
b
a
a
a
a
"}
(19,1,1) = {"
a
a
a
a
a
a
a
a
a
a
a
a
f
d
d
d
d
k
d
k
d
d
l
d
d
k
d
f
d
d
d
d
f
d
d
h
k
d
d
d
f
a
a
a
a
a
a
a
a
a
a
a
a
a
b
b
b
b
b
b
b
a
a
a
"}
(20,1,1) = {"
a
a
a
a
a
a
a
a
a
a
a
a
f
d
d
d
d
d
f
d
d
h
d
d
d
d
d
f
g
d
d
d
f
f
f
f
d
f
f
f
f
a
a
a
a
a
a
a
a
a
a
b
b
b
b
b
b
b
b
b
b
b
a
a
"}
(21,1,1) = {"
a
a
a
a
a
a
a
a
a
a
a
a
f
d
d
d
d
d
f
d
d
d
d
d
d
d
d
f
f
d
d
d
d
d
d
d
k
d
d
d
f
a
a
a
a
a
a
a
a
a
b
b
b
b
b
b
e
b
b
b
b
b
a
a
"}
(22,1,1) = {"
a
a
a
a
a
a
a
a
a
a
a
a
f
g
d
d
d
d
f
d
d
d
d
d
d
d
d
f
f
d
d
j
d
d
j
d
d
d
d
d
f
a
a
a
a
a
a
a
a
a
b
b
b
x
b
b
d
d
x
b
b
b
b
a
"}
(23,1,1) = {"
a
a
a
a
a
a
a
a
a
a
a
a
f
f
f
f
f
f
f
d
d
d
d
d
d
d
d
f
f
d
d
d
d
d
d
d
d
d
d
d
f
a
a
a
a
a
a
a
a
b
b
b
b
b
b
d
d
d
d
d
b
b
b
a
"}
(24,1,1) = {"
a
a
a
a
a
a
a
a
a
a
a
a
a
a
a
a
a
a
f
d
d
d
d
d
d
d
d
f
f
d
d
c
d
d
d
d
d
f
f
f
f
a
a
a
a
a
a
a
a
b
b
b
b
b
d
d
d
d
d
d
d
b
b
a
"}
(25,1,1) = {"
a
a
a
a
a
a
a
a
a
a
a
a
a
a
a
a
a
a
f
f
f
f
f
f
f
f
f
f
f
d
d
d
d
d
d
d
d
f
a
a
a
a
a
a
a
a
a
a
a
b
b
b
b
f
f
f
f
f
d
d
f
f
b
a
"}
(26,1,1) = {"
a
a
a
a
a
a
b
a
a
a
a
a
a
a
a
a
a
a
a
a
a
a
a
a
a
a
a
a
f
f
d
d
d
d
d
f
f
f
f
f
f
f
f
f
f
f
f
f
f
f
f
f
f
f
d
d
f
d
d
d
d
f
b
a
"}
(27,1,1) = {"
a
a
a
a
a
a
b
f
f
f
f
f
f
f
f
f
a
a
a
a
a
a
a
a
a
a
a
a
a
f
d
d
i
d
d
f
q
f
d
d
d
d
d
d
d
d
d
f
d
d
d
d
d
f
d
d
f
d
c
d
d
f
b
a
"}
(28,1,1) = {"
a
a
a
a
a
a
b
f
d
d
d
f
d
d
d
f
a
a
a
a
a
a
a
a
a
a
a
a
a
f
d
d
d
d
d
f
q
f
d
d
d
d
d
d
d
d
d
f
d
d
d
d
d
f
d
d
f
d
d
d
d
f
b
a
"}
(29,1,1) = {"
a
a
a
a
a
a
b
d
d
d
d
f
d
d
d
f
f
f
f
f
f
f
f
f
f
a
a
a
a
f
d
d
k
d
d
f
q
f
d
d
d
h
d
d
d
d
d
f
d
d
d
d
d
f
d
d
f
f
h
d
d
f
b
a
"}
(30,1,1) = {"
a
a
a
a
a
b
b
d
d
d
d
d
i
d
d
d
d
f
d
d
d
d
d
d
f
a
a
a
a
f
f
f
d
f
f
f
q
f
d
d
d
d
d
d
d
i
d
f
d
h
d
d
d
f
f
d
d
f
d
d
d
f
b
a
"}
(31,1,1) = {"
a
a
a
a
b
b
c
d
f
h
d
c
d
d
d
d
d
f
d
d
d
d
d
d
f
a
a
a
a
f
d
d
k
d
d
f
q
f
d
d
d
d
d
d
d
d
k
d
k
d
d
d
k
d
k
d
d
f
d
d
d
f
a
a
"}
(32,1,1) = {"
a
a
a
b
b
d
d
d
f
d
d
d
d
d
d
d
d
f
d
d
d
d
d
d
f
f
f
f
f
f
d
d
d
d
d
f
q
f
d
d
d
m
d
d
d
d
d
f
g
d
d
d
d
f
d
i
d
d
d
d
d
f
a
a
"}
(33,1,1) = {"
a
a
b
b
d
d
d
d
f
d
d
d
d
d
d
h
k
d
k
d
c
d
d
d
f
d
d
d
d
n
d
d
d
d
d
f
q
f
d
d
d
j
d
d
d
d
d
f
f
d
d
d
d
f
d
d
d
d
d
f
f
f
a
a
"}
(34,1,1) = {"
a
a
b
c
d
d
d
f
g
d
d
d
d
d
d
d
d
f
d
d
h
d
d
k
d
k
d
j
d
d
d
j
c
d
d
f
f
f
d
d
d
d
d
d
d
h
d
f
f
d
d
d
d
f
d
d
d
d
d
d
f
a
a
a
"}
(35,1,1) = {"
a
a
b
d
d
d
d
f
f
f
f
f
f
d
d
d
d
f
d
d
d
d
d
d
f
d
d
d
d
d
d
d
d
d
d
d
f
g
d
h
d
d
d
d
d
d
d
f
f
d
d
d
d
f
g
d
h
d
d
d
f
a
a
a
"}
(36,1,1) = {"
a
a
b
b
d
d
d
d
d
b
a
a
f
d
c
d
d
f
d
d
d
d
k
d
f
g
d
d
d
d
d
d
i
d
d
d
f
d
d
d
d
d
d
d
d
d
d
f
f
f
f
f
f
f
f
f
f
f
f
f
f
a
a
a
"}
(37,1,1) = {"
a
a
a
b
e
d
d
d
b
b
a
a
f
d
d
d
d
f
f
f
f
f
d
f
f
h
d
d
d
d
d
d
d
d
d
d
f
d
d
d
d
d
d
d
d
d
d
f
a
a
a
a
a
a
a
a
a
a
a
a
a
a
a
a
"}
(38,1,1) = {"
a
a
a
b
b
b
b
b
b
a
a
b
f
d
d
d
d
d
f
a
f
d
k
d
d
d
d
d
d
o
d
d
d
d
d
d
f
d
d
d
d
d
d
d
d
d
d
f
a
a
a
a
a
a
a
a
a
a
a
a
a
a
a
a
"}
(39,1,1) = {"
a
a
a
a
a
a
a
a
a
a
a
b
f
d
d
i
d
d
f
a
f
d
d
d
d
d
d
d
d
p
d
d
m
d
d
k
d
k
d
d
d
k
d
d
d
d
d
f
a
a
a
a
a
a
a
a
a
a
a
a
a
a
a
a
"}
(40,1,1) = {"
a
a
a
a
a
a
a
a
a
a
a
b
f
d
d
k
d
d
f
a
f
f
d
d
d
c
d
d
d
d
d
d
d
d
d
d
f
d
d
f
f
d
f
f
f
f
f
f
a
b
b
b
b
b
b
b
a
a
a
a
a
a
a
a
"}
(41,1,1) = {"
a
a
a
a
a
a
a
a
a
a
a
b
f
f
f
d
f
f
f
b
b
f
d
d
d
d
j
d
d
d
d
d
d
j
d
d
f
f
f
f
d
k
d
d
d
d
f
a
b
b
b
b
b
b
b
b
b
a
a
a
a
a
a
a
"}
(42,1,1) = {"
a
a
a
a
a
a
a
a
a
a
a
b
f
d
d
k
d
d
f
b
b
f
d
d
d
d
d
d
d
d
d
d
d
d
d
d
f
d
d
d
d
d
d
d
d
d
f
f
f
f
f
f
f
f
b
b
b
b
b
a
a
a
a
a
"}
(43,1,1) = {"
a
a
a
a
a
a
a
a
a
a
a
b
f
d
d
h
d
d
f
b
b
f
d
h
d
d
d
d
d
d
d
d
d
d
d
d
f
d
d
d
d
d
d
d
d
d
f
g
d
f
d
d
d
f
d
b
b
b
b
b
a
a
a
a
"}
(44,1,1) = {"
a
a
a
a
a
a
a
a
a
a
a
b
f
d
d
d
d
d
f
b
b
f
d
d
d
d
d
d
d
h
d
d
d
f
f
f
f
d
d
d
d
d
d
h
d
d
f
d
d
d
d
d
d
f
d
d
e
b
b
b
b
a
a
a
"}
(45,1,1) = {"
a
a
a
a
a
a
a
a
a
a
a
b
f
d
d
c
d
d
f
d
b
f
d
d
d
d
d
m
d
d
d
d
d
f
b
b
f
d
d
d
d
d
d
d
d
d
f
d
d
c
d
d
d
d
d
d
d
b
b
b
b
a
a
a
"}
(46,1,1) = {"
a
a
a
a
a
a
a
a
a
a
a
b
f
d
d
d
d
d
f
d
b
f
d
d
d
d
d
d
d
d
d
d
d
f
b
b
f
d
d
d
d
d
d
d
d
k
d
r
d
d
d
h
d
d
d
d
d
b
b
b
b
a
a
a
"}
(47,1,1) = {"
a
a
a
a
a
a
a
a
a
a
a
b
f
d
d
f
d
d
f
d
b
f
d
d
d
d
h
h
d
d
d
f
f
f
b
a
f
d
d
d
j
m
d
d
d
d
f
d
d
f
f
f
d
c
d
d
d
b
z
b
b
a
a
a
"}
(48,1,1) = {"
a
a
a
a
a
a
a
a
a
a
a
b
f
f
d
d
d
f
f
d
b
f
d
d
d
d
d
d
d
d
d
f
b
b
b
a
f
d
d
d
d
d
d
d
d
d
f
d
d
f
d
d
d
d
d
d
d
b
b
b
b
a
a
a
"}
(49,1,1) = {"
a
a
a
a
a
a
a
a
a
a
a
b
b
d
d
d
d
d
d
d
b
f
g
d
d
d
d
d
d
d
d
f
b
b
b
a
f
d
d
d
d
d
d
d
d
d
f
f
f
f
f
f
f
f
d
d
b
b
b
b
b
a
a
a
"}
(50,1,1) = {"
a
a
a
a
a
a
a
a
a
a
a
b
b
b
d
d
d
d
d
b
b
f
f
f
d
d
d
d
d
d
d
f
b
b
a
a
f
d
d
d
d
d
d
d
d
d
f
b
b
b
d
d
d
d
d
e
b
b
b
a
b
a
a
a
"}
(51,1,1) = {"
a
a
a
a
a
a
a
a
a
a
a
a
a
b
b
c
d
d
e
b
b
b
b
f
d
d
l
d
d
d
d
f
b
a
a
a
f
d
d
d
d
h
d
d
d
d
f
a
a
b
b
b
b
b
b
b
b
a
b
a
b
a
a
a
"}
(52,1,1) = {"
a
a
a
a
a
a
a
a
a
a
a
a
a
b
b
b
b
b
b
b
b
b
a
f
d
d
d
d
d
d
d
f
b
a
a
a
f
d
d
d
d
k
d
d
d
d
f
b
a
a
b
b
b
b
b
b
a
a
a
a
a
a
a
a
"}
(53,1,1) = {"
a
a
a
a
a
a
a
a
a
a
a
a
a
a
a
a
a
a
a
a
a
a
a
f
d
d
d
d
d
d
d
f
b
a
a
a
f
f
f
f
f
d
f
f
f
f
f
b
a
a
a
a
a
a
a
a
a
a
a
a
a
a
a
a
"}
(54,1,1) = {"
a
a
a
a
a
a
a
a
a
a
a
a
a
a
a
a
a
a
a
a
a
a
a
f
f
f
f
f
f
f
f
f
b
a
a
a
a
b
f
d
d
k
d
d
f
b
b
b
a
a
a
a
a
a
a
a
a
a
a
a
a
a
a
a
"}
(55,1,1) = {"
a
a
a
a
a
a
a
a
a
a
a
a
a
a
a
a
a
a
a
a
a
a
a
a
a
a
a
a
a
a
a
a
b
a
a
a
b
b
f
d
f
f
f
d
f
b
b
b
a
a
a
a
a
a
a
a
a
a
a
a
a
a
a
a
"}
(56,1,1) = {"
a
a
a
a
a
a
a
a
a
a
a
a
a
a
a
a
a
a
a
a
a
a
a
a
a
a
a
a
a
a
a
a
a
a
a
a
b
b
f
d
d
d
d
d
f
b
b
b
b
a
a
a
a
a
a
a
a
a
a
a
a
a
a
a
"}
(57,1,1) = {"
a
a
a
a
a
a
a
a
a
a
a
a
a
a
a
a
a
a
a
a
a
a
a
a
a
a
a
a
a
a
a
a
a
a
a
b
b
d
f
d
d
c
d
d
f
b
b
b
b
b
a
a
a
a
a
a
a
a
a
a
a
a
a
a
"}
(58,1,1) = {"
a
a
a
a
a
a
a
a
a
a
a
a
a
a
a
a
a
a
a
a
a
a
a
a
a
a
a
a
a
a
a
a
a
a
a
b
d
d
f
d
i
d
d
d
f
b
b
b
b
b
a
a
a
a
a
a
a
a
a
a
a
a
a
a
"}
(59,1,1) = {"
a
a
a
a
a
a
a
a
a
a
a
a
a
a
a
a
a
a
a
a
a
a
a
a
a
a
a
a
a
a
a
a
a
a
a
b
d
d
f
d
d
d
d
d
f
b
b
b
b
b
a
a
a
a
a
a
a
a
a
a
a
a
a
a
"}
(60,1,1) = {"
a
a
a
a
a
a
a
a
a
a
a
a
a
a
a
a
a
a
a
a
a
a
a
a
a
a
a
a
a
a
a
a
a
a
a
b
d
d
f
f
d
c
d
f
f
b
b
b
b
b
a
a
a
a
a
a
a
a
a
a
a
a
a
a
"}
(61,1,1) = {"
a
a
a
a
a
a
a
a
a
a
a
a
a
a
a
a
a
a
a
a
a
a
a
a
a
a
a
a
a
a
a
a
a
a
a
b
b
d
d
d
d
d
d
d
b
b
b
b
b
a
a
a
a
a
a
a
a
a
a
a
a
a
a
a
"}
(62,1,1) = {"
a
a
a
a
a
a
a
a
a
a
a
a
a
a
a
a
a
a
a
a
a
a
a
a
a
a
a
a
a
a
a
a
a
a
a
a
b
e
d
d
d
d
d
b
b
b
b
a
a
a
a
a
a
a
a
a
a
a
a
a
a
a
a
a
"}
(63,1,1) = {"
a
a
a
a
a
a
a
a
a
a
a
a
a
a
a
a
a
a
a
a
a
a
a
a
a
a
a
a
a
a
a
a
a
a
a
b
b
b
b
d
d
c
b
b
b
b
b
a
a
a
a
a
a
a
a
a
a
a
a
a
a
a
a
a
"}
(64,1,1) = {"
a
a
a
a
a
a
a
a
a
a
a
a
a
a
a
a
a
a
a
a
a
a
a
a
a
a
a
a
a
a
a
a
a
a
a
a
a
b
b
b
b
b
b
a
a
b
a
a
a
a
a
a
a
a
a
a
a
a
a
a
a
a
a
a
"}
