//MAP CONVERTED BY dmm2tgm.py THIS HEADER COMMENT PREVENTS RECONVERSION, DO NOT REMOVE
"a" = (
/turf/simulated/wall/metal,
/area/interior/ship/dorm)
"b" = (
/obj/structure/interactive/bed/sleeper/cryo,
/turf/simulated/floor/tile/grey,
/area/interior/ship/dorm)
"c" = (
/turf/simulated/floor/tile/grey,
/area/interior/ship/dorm)
"d" = (
/obj/structure/smooth/table/reinforced,
/obj/structure/interactive/computer/console/old/station_job,
/turf/simulated/floor/tile/grey,
/area/interior/ship/dorm)
"e" = (
/obj/structure/interactive/lighting/tube{
	icon_state = "tube_light";
	dir = 8
	},
/turf/simulated/floor/tile/grey,
/area/interior/ship/dorm)
"f" = (
/obj/structure/interactive/chair{
	icon_state = "chair";
	dir = 1
	},
/turf/simulated/floor/tile/grey,
/area/interior/ship/dorm)
"g" = (
/obj/structure/interactive/vendor/autolocker,
/turf/simulated/floor/tile/grey,
/area/interior/ship/dorm)
"h" = (
/obj/structure/interactive/disposals/pipe{
	icon_state = "pipe";
	dir = 6
	},
/turf/simulated/floor/tile/grey,
/area/interior/ship/dorm)
"i" = (
/obj/structure/interactive/computer/wall/dorms,
/turf/simulated/wall/metal,
/area/interior/ship/dorm)
"j" = (
/obj/structure/interactive/disposals/chute,
/obj/structure/interactive/disposals/pipe/ending{
	icon_state = "pipe-t";
	dir = 8
	},
/turf/simulated/floor/tile/grey,
/area/interior/ship/dorm)
"k" = (
/obj/structure/interactive/door/airlock/station/private,
/obj/structure/interactive/disposals/pipe,
/turf/simulated/floor/tile/grey,
/area/interior/ship/dorm)
"m" = (
/obj/structure/interactive/intercom{
	icon_state = "intercom";
	dir = 8
	},
/turf/simulated/wall/metal,
/area/interior/ship/dorm)

(1,1,1) = {"
a
a
a
a
a
"}
(2,1,1) = {"
a
b
e
g
a
"}
(3,1,1) = {"
a
c
c
h
k
"}
(4,1,1) = {"
a
d
f
j
i
"}
(5,1,1) = {"
a
a
m
a
a
"}
