//MAP CONVERTED BY dmm2tgm.py THIS HEADER COMMENT PREVENTS RECONVERSION, DO NOT REMOVE
"a" = (
/turf/simulated/wall/metal,
/area/interior/ship/dorm)
"b" = (
/obj/structure/interactive/computer/wall/dorms{
	icon_state = "dorm_available";
	dir = 1
	},
/turf/simulated/wall/metal,
/area/interior/ship/dorm)
"c" = (
/obj/structure/interactive/door/airlock/station/private,
/obj/structure/interactive/disposals/pipe,
/turf/simulated/floor/tile/grey,
/area/interior/ship/dorm)
"d" = (
/obj/structure/interactive/disposals/chute,
/obj/structure/interactive/disposals/pipe/ending{
	icon_state = "pipe-t";
	dir = 4
	},
/turf/simulated/floor/tile/grey,
/area/interior/ship/dorm)
"e" = (
/obj/structure/interactive/disposals/pipe{
	icon_state = "pipe";
	dir = 9
	},
/turf/simulated/floor/tile/grey,
/area/interior/ship/dorm)
"f" = (
/obj/structure/smooth/table/reinforced,
/obj/structure/interactive/computer/console/old/station_job,
/turf/simulated/floor/tile/grey,
/area/interior/ship/dorm)
"g" = (
/obj/structure/interactive/lighting/tube{
	icon_state = "tube_light";
	dir = 8
	},
/turf/simulated/floor/tile/grey,
/area/interior/ship/dorm)
"h" = (
/turf/simulated/floor/tile/grey,
/area/interior/ship/dorm)
"i" = (
/obj/structure/interactive/chair{
	icon_state = "chair";
	dir = 1
	},
/turf/simulated/floor/tile/grey,
/area/interior/ship/dorm)
"j" = (
/obj/structure/interactive/bed/sleeper/cryo,
/turf/simulated/floor/tile/grey,
/area/interior/ship/dorm)
"k" = (
/obj/structure/interactive/vendor/autolocker,
/turf/simulated/floor/tile/grey,
/area/interior/ship/dorm)
"l" = (
/obj/structure/interactive/intercom{
	icon_state = "intercom";
	dir = 8
	},
/turf/simulated/wall/metal,
/area/interior/ship/dorm)

(1,1,1) = {"
a
a
a
a
a
"}
(2,1,1) = {"
b
d
g
j
a
"}
(3,1,1) = {"
c
e
h
h
a
"}
(4,1,1) = {"
a
f
i
k
a
"}
(5,1,1) = {"
a
a
l
a
a
"}
