//MAP CONVERTED BY dmm2tgm.py THIS HEADER COMMENT PREVENTS RECONVERSION, DO NOT REMOVE
"aa" = (
/obj/structure/carpet/brown,
/obj/structure/interactive/crate/closet,
/turf/simulated/floor/wood/brown,
/area/mission/prefab/house_01/hallway)
"ab" = (
/turf/simulated/wall/wood/brown,
/area/mission/prefab/house_01/hallway)
"ac" = (
/turf/simulated/wall/wood/brown,
/area/mission/prefab/house_01/master_bedroom)
"ad" = (
/turf/simulated/wall/wood/brown,
/area/mission/prefab/house_01/girls_bedroom)
"ae" = (
/turf/simulated/wall/wood/brown,
/area/mission/prefab/house_01/bathroom_01)
"af" = (
/obj/structure/interactive/light_switch,
/turf/simulated/wall/wood/brown,
/area/mission/prefab/house_01/bathroom_01)
"ag" = (
/turf/simulated/wall/wood/brown,
/area/mission/prefab/house_01/boys_bedroom)
"ah" = (
/turf/simulated/wall/wood/brown,
/area/mission/prefab/house_01/bathroom_02)
"ai" = (
/obj/marker/spawning/random/dangerous,
/obj/structure/interactive/crate/closet,
/obj/structure/interactive/storage/safe,
/turf/simulated/floor/wood/brown,
/area/mission/prefab/house_01/girls_bedroom)
"aj" = (
/obj/structure/interactive/light_switch,
/turf/simulated/wall/wood/brown,
/area/mission/prefab/house_01/bathroom_02)
"ak" = (
/obj/structure/interactive/misc/shower{
	icon_state = "shower";
	dir = 4
	},
/obj/structure/interactive/misc/curtain_open,
/turf/simulated/floor/tile/coldroom,
/area/mission/prefab/house_01/bathroom_01)
"al" = (
/obj/structure/interactive/crate/trash,
/obj/marker/spawning/random/trash,
/turf/simulated/floor/tile/coldroom,
/area/mission/prefab/house_01/bathroom_01)
"am" = (
/obj/structure/interactive/door/airlock/station/bathroom/toilet,
/turf/simulated/floor/tile/coldroom,
/area/mission/prefab/house_01/bathroom_01)
"an" = (
/obj/marker/spawning/random/valuable,
/obj/structure/interactive/crate/closet,
/obj/structure/interactive/storage/safe,
/turf/simulated/floor/wood/brown,
/area/mission/prefab/house_01/master_bedroom)
"ao" = (
/obj/structure/interactive/misc/shower{
	icon_state = "shower";
	dir = 4
	},
/obj/structure/interactive/misc/curtain_open,
/turf/simulated/floor/tile/coldroom,
/area/mission/prefab/house_01/bathroom_02)
"ap" = (
/obj/structure/interactive/wire/yellow,
/turf/simulated/floor/plating,
/area/mission/prefab/house_01)
"aq" = (
/obj/marker/spawning/window,
/turf/simulated/floor/wood/brown,
/area/mission/prefab/house_01/boys_bedroom)
"ar" = (
/obj/marker/spawning/random/misc,
/obj/marker/spawning/random/misc,
/obj/structure/interactive/crate/closet,
/turf/simulated/floor/wood/brown,
/area/mission/prefab/house_01)
"as" = (
/obj/structure/interactive/misc/dresser,
/obj/structure/carpet/blue,
/turf/simulated/floor/wood/brown,
/area/mission/prefab/house_01/boys_bedroom)
"at" = (
/obj/marker/spawning/random/misc,
/obj/structure/interactive/crate/closet,
/obj/structure/interactive/storage/safe,
/turf/simulated/floor/wood/brown,
/area/mission/prefab/house_01/boys_bedroom)
"au" = (
/obj/structure/interactive/crate/trash,
/obj/marker/spawning/random/trash,
/turf/simulated/floor/tile/coldroom,
/area/mission/prefab/house_01/bathroom_02)
"av" = (
/obj/marker/spawning/window,
/turf/simulated/floor/wood/brown,
/area/mission/prefab/house_01/girls_bedroom)
"aw" = (
/obj/structure/interactive/bed/sheet,
/obj/structure/carpet/red,
/turf/simulated/floor/wood/brown,
/area/mission/prefab/house_01/girls_bedroom)
"ax" = (
/obj/structure/table/wood,
/obj/structure/carpet/brown,
/obj/marker/spawning/random/misc,
/turf/simulated/floor/wood/brown,
/area/mission/prefab/house_01/master_bedroom)
"ay" = (
/obj/structure/interactive/power/smes{
	icon_state = "smes_map";
	dir = 8
	},
/obj/structure/interactive/wire/red,
/turf/simulated/floor/plating,
/area/mission/prefab/house_01)
"az" = (
/obj/structure/carpet/brown,
/obj/marker/map_node,
/turf/simulated/floor/wood/brown,
/area/mission/prefab/house_01/master_bedroom)
"aA" = (
/obj/structure/carpet/red,
/obj/marker/map_node,
/turf/simulated/floor/wood/brown,
/area/mission/prefab/house_01)
"aB" = (
/obj/structure/carpet/red,
/obj/structure/interactive/bookcase,
/turf/simulated/floor/wood/brown,
/area/mission/prefab/house_01/girls_bedroom)
"aC" = (
/obj/structure/interactive/misc/dresser,
/obj/structure/carpet/brown,
/turf/simulated/floor/wood/brown,
/area/mission/prefab/house_01/master_bedroom)
"aD" = (
/obj/marker/map_node,
/turf/simulated/floor/tile/coldroom,
/area/mission/prefab/house_01/bathroom_02)
"aE" = (
/obj/structure/interactive/bed/double/sheet,
/obj/structure/carpet/brown,
/turf/simulated/floor/wood/brown,
/area/mission/prefab/house_01/master_bedroom)
"aF" = (
/obj/structure/interactive/door/airlock/station/bathroom/toilet,
/turf/simulated/floor/tile/coldroom,
/area/mission/prefab/house_01/bathroom_02)
"aG" = (
/obj/structure/interactive/misc/toilet{
	icon_state = "toilet";
	dir = 4
	},
/turf/simulated/floor/tile/coldroom,
/area/mission/prefab/house_01/bathroom_01)
"aH" = (
/obj/structure/interactive/bed/sheet,
/obj/structure/carpet/blue,
/turf/simulated/floor/wood/brown,
/area/mission/prefab/house_01/boys_bedroom)
"aI" = (
/obj/structure/carpet/blue,
/turf/simulated/floor/wood/brown,
/area/mission/prefab/house_01/boys_bedroom)
"aJ" = (
/obj/structure/carpet/brown,
/turf/simulated/floor/wood/brown,
/area/mission/prefab/house_01/master_bedroom)
"aK" = (
/obj/structure/interactive/lighting/fixture/bulb{
	icon_state = "preview";
	dir = 1
	},
/turf/simulated/floor/tile/coldroom,
/area/mission/prefab/house_01/bathroom_01)
"aL" = (
/obj/structure/interactive/misc/sink{
	icon_state = "sink";
	dir = 4
	},
/turf/simulated/floor/tile/coldroom,
/area/mission/prefab/house_01/bathroom_01)
"aM" = (
/obj/structure/interactive/misc/toilet{
	icon_state = "toilet";
	dir = 4
	},
/turf/simulated/floor/tile/coldroom,
/area/mission/prefab/house_01/bathroom_02)
"aN" = (
/obj/structure/interactive/lighting/fixture/bulb{
	icon_state = "preview";
	dir = 1
	},
/turf/simulated/floor/tile/coldroom,
/area/mission/prefab/house_01/bathroom_02)
"aO" = (
/obj/structure/interactive/misc/sink{
	icon_state = "sink";
	dir = 4
	},
/turf/simulated/floor/tile/coldroom,
/area/mission/prefab/house_01/bathroom_02)
"aP" = (
/obj/marker/map_node,
/turf/dmm_suite/no_wall,
/area/dmm_suite/allow_generate)
"aQ" = (
/obj/structure/carpet/red,
/obj/structure/interactive/lighting/fixture/bulb{
	icon_state = "preview";
	dir = 4
	},
/turf/simulated/floor/wood/brown,
/area/mission/prefab/house_01/girls_bedroom)
"aR" = (
/obj/structure/carpet/brown,
/obj/structure/interactive/potted_plant/office,
/obj/structure/interactive/lighting/fixture/bulb{
	icon_state = "preview";
	dir = 8
	},
/turf/simulated/floor/wood/brown,
/area/mission/prefab/house_01/master_bedroom)
"aS" = (
/turf/simulated/floor/wood/brown,
/area/mission/prefab/house_01/kitchen)
"aT" = (
/obj/structure/carpet/red,
/obj/structure/interactive/chair/wood{
	icon_state = "wooden_chair";
	dir = 4
	},
/turf/simulated/floor/wood/brown,
/area/mission/prefab/house_01/girls_bedroom)
"aU" = (
/obj/structure/interactive/lighting/fixture/bulb{
	icon_state = "preview";
	dir = 4
	},
/turf/simulated/floor/wood/brown,
/area/mission/prefab/house_01/hallway)
"aV" = (
/turf/simulated/floor/wood/brown,
/area/mission/prefab/house_01/hallway)
"aW" = (
/turf/simulated/wall/wood/brown,
/area/mission/prefab/house_01/kitchen)
"aX" = (
/obj/structure/carpet/brown,
/obj/structure/interactive/chair/wood{
	icon_state = "wooden_chair";
	dir = 4
	},
/turf/simulated/floor/wood/brown,
/area/mission/prefab/house_01/master_bedroom)
"aY" = (
/obj/marker/spawning/window,
/turf/simulated/floor/wood/brown,
/area/mission/prefab/house_01/master_bedroom)
"aZ" = (
/obj/structure/carpet/red,
/obj/structure/table/wood,
/obj/marker/spawning/random/misc,
/turf/simulated/floor/wood/brown,
/area/mission/prefab/house_01/girls_bedroom)
"ba" = (
/turf/dmm_suite/no_wall,
/area/dmm_suite/allow_generate)
"bb" = (
/obj/structure/interactive/light_switch{
	icon_state = "setup";
	dir = 8
	},
/turf/simulated/wall/wood/brown,
/area/mission/prefab/house_01/girls_bedroom)
"bc" = (
/obj/structure/interactive/light_switch{
	icon_state = "setup";
	dir = 4
	},
/turf/simulated/wall/wood/brown,
/area/mission/prefab/house_01/boys_bedroom)
"bd" = (
/obj/structure/table/wood,
/obj/marker/spawning/random/kitchen,
/turf/simulated/floor/wood/brown,
/area/mission/prefab/house_01/kitchen)
"be" = (
/obj/structure/table/cooking/grill,
/obj/item/storage/heavy/cupboard,
/turf/simulated/floor/wood/brown,
/area/mission/prefab/house_01/kitchen)
"bf" = (
/obj/structure/table/wood,
/obj/marker/spawning/random/misc,
/obj/structure/interactive/lighting/fixture/bulb,
/turf/simulated/floor/wood/brown,
/area/mission/prefab/house_01/kitchen)
"bg" = (
/turf/simulated/floor/wood/brown,
/area/mission/prefab/house_01)
"bh" = (
/obj/structure/interactive/lighting/fireplace/fire03,
/turf/simulated/floor/wood/brown,
/area/mission/prefab/house_01)
"bi" = (
/obj/structure/interactive/potted_plant/office,
/turf/simulated/floor/wood/brown,
/area/mission/prefab/house_01)
"bj" = (
/obj/structure/interactive/misc/tv,
/turf/simulated/floor/wood/brown,
/area/mission/prefab/house_01)
"bk" = (
/obj/marker/spawning/window,
/turf/simulated/floor/wood/brown,
/area/mission/prefab/house_01)
"bl" = (
/obj/structure/interactive/light_switch{
	icon_state = "setup";
	dir = 4
	},
/turf/simulated/wall/wood/brown,
/area/mission/prefab/house_01/kitchen)
"bm" = (
/obj/structure/table/wood,
/obj/marker/spawning/random/misc,
/turf/simulated/floor/wood/brown,
/area/mission/prefab/house_01)
"bn" = (
/obj/structure/carpet/red,
/turf/simulated/floor/wood/brown,
/area/mission/prefab/house_01)
"bo" = (
/obj/structure/carpet/brown,
/obj/structure/table/wood,
/obj/marker/spawning/random/misc,
/turf/simulated/floor/wood/brown,
/area/mission/prefab/house_01/master_bedroom)
"bp" = (
/obj/structure/carpet/red,
/obj/structure/interactive/chair/wood{
	icon_state = "wooden_chair";
	dir = 8
	},
/turf/simulated/floor/wood/brown,
/area/mission/prefab/house_01)
"bq" = (
/turf/simulated/wall/wood/brown,
/area/mission/prefab/house_01)
"br" = (
/obj/structure/interactive/fire_closet{
	icon_state = "extinguisher";
	dir = 4
	},
/turf/simulated/wall/wood/brown,
/area/mission/prefab/house_01/kitchen)
"bs" = (
/obj/structure/table/reinforced/steel,
/obj/marker/spawning/random/kitchen,
/turf/simulated/floor/wood/brown,
/area/mission/prefab/house_01/kitchen)
"bt" = (
/obj/structure/interactive/crate/trash,
/obj/marker/spawning/random/trash,
/turf/simulated/floor/wood/brown,
/area/mission/prefab/house_01/kitchen)
"bu" = (
/obj/structure/carpet/red,
/obj/structure/interactive/chair/wood{
	icon_state = "wooden_chair";
	dir = 4
	},
/turf/simulated/floor/wood/brown,
/area/mission/prefab/house_01)
"bv" = (
/obj/structure/carpet/red,
/obj/structure/table/glass,
/turf/simulated/floor/wood/brown,
/area/mission/prefab/house_01)
"bw" = (
/obj/structure/interactive/door/airlock/station,
/turf/simulated/floor/wood/brown,
/area/mission/prefab/house_01)
"bx" = (
/turf/dmm_suite/clear_turf,
/area/dmm_suite/clear_area)
"by" = (
/obj/structure/interactive/chair/wood{
	icon_state = "wooden_chair";
	dir = 4
	},
/turf/simulated/floor/wood/brown,
/area/mission/prefab/house_01/kitchen)
"bz" = (
/obj/structure/table/wood,
/obj/marker/spawning/random/food,
/turf/simulated/floor/wood/brown,
/area/mission/prefab/house_01/kitchen)
"bA" = (
/obj/structure/interactive/chair/wood{
	icon_state = "wooden_chair";
	dir = 8
	},
/turf/simulated/floor/wood/brown,
/area/mission/prefab/house_01/kitchen)
"bB" = (
/obj/structure/interactive/wire/red,
/turf/simulated/floor/wood/brown,
/area/mission/prefab/house_01)
"bC" = (
/obj/structure/interactive/chair/comfy{
	icon_state = "comfychair";
	dir = 1
	},
/turf/simulated/floor/wood/brown,
/area/mission/prefab/house_01)
"bD" = (
/obj/marker/map_node,
/mob/living/advanced/npc/survivor{
	icon_state = "directional";
	dir = 4
	},
/turf/simulated/floor/tile/coldroom,
/area/mission/prefab/house_01/bathroom_01)
"bE" = (
/obj/structure/interactive/power/apc{
	dir = 1
	},
/turf/simulated/wall/wood/brown,
/area/mission/prefab/house_01)
"bF" = (
/obj/structure/interactive/wire/red,
/turf/simulated/wall/wood/brown,
/area/mission/prefab/house_01)
"bG" = (
/obj/marker/map_node,
/turf/simulated/floor/wood/brown,
/area/mission/prefab/house_01/hallway)
"bH" = (
/obj/marker/spawning/window,
/turf/simulated/floor/wood/brown,
/area/mission/prefab/house_01/kitchen)
"bI" = (
/obj/structure/interactive/solar_panel,
/obj/structure/interactive/wire/yellow,
/turf/simulated/floor/plating,
/area/mission/prefab/house_01)
"bJ" = (
/obj/marker/map_node,
/turf/simulated/floor/wood/brown,
/area/mission/prefab/house_01/kitchen)
"bK" = (
/obj/structure/carpet/blue,
/obj/structure/interactive/chair/wood,
/obj/structure/interactive/lighting/fixture/bulb{
	icon_state = "preview";
	dir = 8
	},
/turf/simulated/floor/wood/brown,
/area/mission/prefab/house_01/boys_bedroom)
"bL" = (
/obj/structure/interactive/misc/dresser,
/obj/structure/carpet/red,
/turf/simulated/floor/wood/brown,
/area/mission/prefab/house_01/girls_bedroom)
"bM" = (
/obj/structure/carpet/red,
/turf/simulated/floor/wood/brown,
/area/mission/prefab/house_01/girls_bedroom)
"bN" = (
/obj/structure/interactive/door/airlock/wood,
/turf/simulated/floor/wood/brown,
/area/mission/prefab/house_01/girls_bedroom)
"bO" = (
/obj/structure/interactive/door/airlock/wood,
/turf/simulated/floor/wood/brown,
/area/mission/prefab/house_01/boys_bedroom)
"bP" = (
/obj/structure/table/wood,
/obj/structure/carpet/blue,
/obj/marker/spawning/random/misc,
/turf/simulated/floor/wood/brown,
/area/mission/prefab/house_01/boys_bedroom)
"bQ" = (
/obj/structure/interactive/door/airlock/wood,
/turf/simulated/floor/wood/brown,
/area/mission/prefab/house_01/master_bedroom)
"bR" = (
/obj/structure/interactive/light_switch{
	icon_state = "setup";
	dir = 1
	},
/turf/simulated/wall/wood/brown,
/area/mission/prefab/house_01/master_bedroom)
"bS" = (
/obj/structure/interactive/lighting/fixture/bulb{
	icon_state = "preview";
	dir = 8
	},
/turf/simulated/floor/wood/brown,
/area/mission/prefab/house_01/hallway)
"bT" = (
/obj/item/storage/heavy/fridge,
/obj/marker/spawning/random/food,
/obj/marker/spawning/random/food,
/obj/marker/spawning/random/food,
/turf/simulated/floor/wood/brown,
/area/mission/prefab/house_01/kitchen)
"bU" = (
/obj/structure/table/reinforced/steel,
/obj/marker/spawning/random/kitchen,
/obj/item/storage/heavy/cupboard,
/turf/simulated/floor/wood/brown,
/area/mission/prefab/house_01/kitchen)
"bV" = (
/obj/structure/interactive/light_switch{
	icon_state = "setup";
	dir = 8
	},
/turf/simulated/wall/wood/brown,
/area/mission/prefab/house_01)
"bW" = (
/obj/structure/interactive/lighting/fixture/bulb{
	icon_state = "preview";
	dir = 4
	},
/turf/simulated/floor/wood/brown,
/area/mission/prefab/house_01/kitchen)
"bX" = (
/obj/structure/interactive/lighting/fixture/bulb{
	icon_state = "preview";
	dir = 1
	},
/obj/marker/map_node,
/turf/simulated/floor/wood/brown,
/area/mission/prefab/house_01)
"bY" = (
/obj/structure/interactive/lighting/fixture/bulb,
/turf/simulated/floor/wood/brown,
/area/mission/prefab/house_01)
"bZ" = (
/obj/structure/carpet/red,
/obj/structure/interactive/lighting/fixture/bulb{
	icon_state = "preview";
	dir = 8
	},
/turf/simulated/floor/wood/brown,
/area/mission/prefab/house_01)
"ca" = (
/obj/structure/carpet/brown,
/obj/structure/interactive/lighting/fixture/bulb{
	icon_state = "preview";
	dir = 4
	},
/turf/simulated/floor/wood/brown,
/area/mission/prefab/house_01/master_bedroom)
"cb" = (
/obj/structure/carpet/red,
/obj/marker/map_node,
/turf/simulated/floor/wood/brown,
/area/mission/prefab/house_01/girls_bedroom)
"cc" = (
/obj/structure/carpet/blue,
/obj/marker/map_node,
/mob/living/advanced/npc/survivor{
	icon_state = "directional";
	dir = 8
	},
/turf/simulated/floor/wood/brown,
/area/mission/prefab/house_01/boys_bedroom)
"cd" = (
/mob/living/advanced/npc/survivor{
	icon_state = "directional";
	dir = 4
	},
/turf/simulated/floor/wood/brown,
/area/mission/prefab/house_01)

(1,1,1) = {"
bx
ad
av
ad
ad
ae
ae
ae
ae
aW
bl
br
aW
bx
bx
bx
"}
(2,1,1) = {"
ad
ad
aw
aQ
bL
ae
ak
aG
ae
bd
aS
bT
aW
aW
aW
aW
"}
(3,1,1) = {"
ad
ai
bM
aT
cb
ae
al
aK
ae
be
aS
aS
bW
by
by
aW
"}
(4,1,1) = {"
ad
ad
aB
aZ
bM
af
bD
aL
ae
bU
aS
bs
aS
bz
bz
bH
"}
(5,1,1) = {"
ad
ad
ad
bb
bN
ae
am
ae
ae
bf
aS
bs
aS
bz
bz
bH
"}
(6,1,1) = {"
ab
aa
aV
aU
bG
aV
bG
aU
aV
aS
bJ
bt
aS
bA
bA
aW
"}
(7,1,1) = {"
ab
aa
aV
aV
aV
bS
aV
aV
aV
bg
bg
cd
bg
bg
bq
bq
"}
(8,1,1) = {"
ag
ag
ag
bc
bO
ah
ah
ah
ah
bh
bm
bm
bm
bX
bq
bI
"}
(9,1,1) = {"
aq
as
aH
aI
cc
ah
ao
aM
ah
bg
bn
bu
bn
bB
bE
bI
"}
(10,1,1) = {"
ag
ag
aI
aI
bP
ah
au
aN
ah
bi
bn
bn
bn
bB
bF
ap
"}
(11,1,1) = {"
ag
at
aI
bK
bP
aj
aD
aO
ah
bj
bn
bv
bn
bB
bF
ay
"}
(12,1,1) = {"
ag
ag
ag
ag
ag
ah
aF
ah
ah
bY
bn
bn
bn
bC
bq
bq
"}
(13,1,1) = {"
ac
ac
ax
aE
aX
ca
az
aJ
bQ
bg
bp
aA
bZ
bg
ar
bq
"}
(14,1,1) = {"
ac
an
aJ
aJ
aJ
aJ
aJ
bo
bR
bk
bq
bw
bq
bV
bq
bq
"}
(15,1,1) = {"
ac
ac
aC
aR
aJ
aJ
aJ
bo
ac
ba
ba
aP
ba
ba
ba
ba
"}
(16,1,1) = {"
bx
ac
ac
ac
aY
aY
ac
ac
ac
ba
ba
ba
ba
ba
ba
ba
"}
