"aa" = (/turf/space,/area)
"ab" = (/turf/dmm_suite/clear_turf,/area)
"ac" = (/turf/simulated/wall/wood/brown,/area/mission/prefab/house_07/master_bedroom)
"ad" = (/obj/marker/spawning/window,/turf/simulated/floor/wood/brown,/area/mission/prefab/house_07/master_bedroom)
"ae" = (/turf/simulated/wall/wood/brown,/area/mission/prefab/house_07/bathroom_01)
"af" = (/obj/structure/carpet/red,/obj/structure/table/wood,/obj/marker/spawning/random/misc,/turf/simulated/floor/wood/brown,/area/mission/prefab/house_07/master_bedroom)
"ag" = (/obj/structure/carpet/red,/obj/structure/interactive/lighting/fixture/bulb,/obj/structure/interactive/crate/closet,/obj/marker/spawning/random/valuable,/turf/simulated/floor/wood/brown,/area/mission/prefab/house_07/master_bedroom)
"ah" = (/obj/structure/carpet/red,/obj/structure/interactive/misc/dresser,/turf/simulated/floor/wood/brown,/area/mission/prefab/house_07/master_bedroom)
"ai" = (/obj/structure/interactive/misc/toilet{icon_state = "toilet"; dir = 4},/turf/simulated/floor/tile,/area/mission/prefab/house_07/bathroom_01)
"aj" = (/obj/structure/interactive/misc/shower{icon_state = "shower"; dir = 8},/obj/structure/interactive/misc/curtain_open,/turf/simulated/floor/tile,/area/mission/prefab/house_07/bathroom_01)
"ak" = (/obj/structure/carpet/red,/turf/simulated/floor/wood/brown,/area/mission/prefab/house_07/master_bedroom)
"al" = (/obj/structure/carpet/red,/obj/structure/interactive/chair/wood{icon_state = "wooden_chair"; dir = 8},/turf/simulated/floor/wood/brown,/area/mission/prefab/house_07/master_bedroom)
"am" = (/obj/structure/interactive/lighting/fixture/bulb{icon_state = "preview"; dir = 4},/turf/simulated/floor/tile,/area/mission/prefab/house_07/bathroom_01)
"an" = (/turf/simulated/floor/tile,/area/mission/prefab/house_07/bathroom_01)
"ao" = (/obj/structure/interactive/fire_closet,/turf/simulated/wall/wood/brown,/area/mission/prefab/house_07/entrance)
"ap" = (/turf/simulated/wall/wood/brown,/area/mission/prefab/house_07/entrance)
"aq" = (/obj/structure/carpet/red,/obj/structure/interactive/bed/double/sheet,/turf/simulated/floor/wood/brown,/area/mission/prefab/house_07/master_bedroom)
"ar" = (/obj/structure/carpet/red,/obj/structure/interactive/storage/safe,/turf/simulated/floor/wood/brown,/area/mission/prefab/house_07/master_bedroom)
"as" = (/obj/structure/carpet/red,/obj/structure/interactive/lighting/fixture/bulb{icon_state = "preview"; dir = 8},/turf/simulated/floor/wood/brown,/area/mission/prefab/house_07/master_bedroom)
"at" = (/obj/structure/interactive/misc/sink{icon_state = "sink"; dir = 8},/turf/simulated/floor/tile,/area/mission/prefab/house_07/bathroom_01)
"au" = (/obj/structure/table/wood,/obj/marker/spawning/random/misc,/turf/simulated/floor/wood/brown,/area/mission/prefab/house_07/entrance)
"av" = (/obj/structure/table/wood,/obj/structure/interactive/lighting/fixture/bulb,/turf/simulated/floor/wood/brown,/area/mission/prefab/house_07/entrance)
"aw" = (/obj/structure/interactive/potted_plant/bin,/turf/simulated/floor/wood/brown,/area/mission/prefab/house_07/master_bedroom)
"ax" = (/turf/simulated/floor/wood/brown,/area/mission/prefab/house_07/master_bedroom)
"ay" = (/obj/structure/interactive/light_switch{icon_state = "setup"; dir = 1},/turf/simulated/wall/wood/brown,/area/mission/prefab/house_07/bathroom_01)
"az" = (/obj/structure/interactive/door/airlock,/turf/simulated/floor/tile,/area/mission/prefab/house_07/bathroom_01)
"aA" = (/turf/simulated/floor/wood/brown,/area/mission/prefab/house_07/entrance)
"aB" = (/obj/structure/interactive/misc/tv,/turf/simulated/floor/wood/brown,/area/mission/prefab/house_07/entrance)
"aC" = (/obj/structure/interactive/potted_plant/bin,/turf/simulated/floor/wood/brown,/area/mission/prefab/house_07/entrance)
"aD" = (/obj/marker/spawning/window,/turf/simulated/floor/wood/brown,/area/mission/prefab/house_07/entrance)
"aE" = (/obj/structure/interactive/light_switch{icon_state = "setup"; dir = 1},/turf/simulated/wall/wood/brown,/area/mission/prefab/house_07/master_bedroom)
"aF" = (/obj/structure/interactive/door/airlock/wood,/turf/simulated/floor/wood/brown,/area/mission/prefab/house_07/master_bedroom)
"aG" = (/obj/structure/interactive/wire/red,/turf/simulated/wall/wood/brown,/area/mission/prefab/house_07)
"aH" = (/obj/structure/table/reinforced/steel,/obj/structure/interactive/wire/red,/obj/marker/spawning/random/kitchen,/turf/simulated/floor/wood/brown,/area/mission/prefab/house_07)
"aI" = (/obj/structure/interactive/wire/red,/turf/simulated/floor/wood/brown,/area/mission/prefab/house_07)
"aJ" = (/obj/structure/interactive/power/smes,/obj/structure/interactive/wire/red,/turf/simulated/floor/plating,/area)
"aK" = (/obj/structure/interactive/wire/yellow,/turf/simulated/floor/plating,/area)
"aL" = (/turf/simulated/floor/wood/brown,/area/mission/prefab/house_07)
"aM" = (/obj/structure/carpet/brown,/turf/simulated/floor/wood/brown,/area/mission/prefab/house_07/entrance)
"aN" = (/obj/structure/interactive/solar_panel,/obj/structure/interactive/wire/yellow,/turf/simulated/floor/plating,/area)
"aO" = (/obj/structure/carpet/brown,/obj/structure/interactive/chair/comfy{icon_state = "comfychair"; dir = 1},/turf/simulated/floor/wood/brown,/area/mission/prefab/house_07/entrance)
"aP" = (/turf/simulated/wall/wood/brown,/area/mission/prefab/house_07)
"aQ" = (/obj/structure/table/cooking/grill,/turf/simulated/floor/wood/brown,/area/mission/prefab/house_07)
"aR" = (/obj/structure/interactive/chair/wood,/turf/simulated/floor/wood/brown,/area/mission/prefab/house_07)
"aS" = (/obj/structure/carpet/brown,/obj/structure/interactive/chair/wood,/turf/simulated/floor/wood/brown,/area/mission/prefab/house_07/entrance)
"aT" = (/obj/structure/interactive/light_switch{icon_state = "setup"; dir = 8},/turf/simulated/wall/wood/brown,/area/mission/prefab/house_07/entrance)
"aU" = (/obj/structure/table/reinforced/steel,/obj/marker/spawning/random/kitchen,/turf/simulated/floor/wood/brown,/area/mission/prefab/house_07)
"aV" = (/obj/structure/table/wood,/obj/marker/spawning/random/food,/turf/simulated/floor/wood/brown,/area/mission/prefab/house_07)
"aW" = (/obj/structure/carpet/brown,/obj/structure/table/wood,/obj/marker/spawning/random/misc,/turf/simulated/floor/wood/brown,/area/mission/prefab/house_07/entrance)
"aX" = (/obj/structure/interactive/door/airlock,/turf/simulated/floor/wood/brown,/area/mission/prefab/house_07/entrance)
"aY" = (/obj/structure/table/reinforced/steel,/obj/structure/interactive/lighting/fixture/bulb{icon_state = "preview"; dir = 4},/obj/marker/spawning/random/kitchen,/turf/simulated/floor/wood/brown,/area/mission/prefab/house_07)
"aZ" = (/obj/structure/interactive/chair/wood{icon_state = "wooden_chair"; dir = 1},/turf/simulated/floor/wood/brown,/area/mission/prefab/house_07)
"ba" = (/obj/structure/interactive/lighting/fixture/bulb,/turf/simulated/floor/wood/brown,/area/mission/prefab/house_07/entrance)
"bb" = (/obj/structure/carpet/brown,/obj/structure/interactive/chair/wood{icon_state = "wooden_chair"; dir = 1},/turf/simulated/floor/wood/brown,/area/mission/prefab/house_07/entrance)
"bc" = (/obj/structure/table/reinforced/steel,/obj/marker/spawning/random/misc,/turf/simulated/floor/wood/brown,/area/mission/prefab/house_07)
"bd" = (/turf/simulated/wall/wood/brown,/area/mission/prefab/house_07/guest_bedroom)
"be" = (/obj/structure/interactive/power/apc{icon_state = "apc"; dir = 1},/turf/simulated/wall/wood/brown,/area/mission/prefab/house_07/guest_bedroom)
"bf" = (/obj/structure/interactive/crate/trash,/obj/marker/spawning/random/trash,/turf/simulated/floor/wood/brown,/area/mission/prefab/house_07/entrance)
"bg" = (/obj/structure/interactive/light_switch{icon_state = "setup"; dir = 1},/turf/simulated/wall/wood/brown,/area/mission/prefab/house_07/guest_bedroom)
"bh" = (/turf/simulated/wall/wood/brown,/area/mission/prefab/house_07/bathroom_02)
"bi" = (/obj/structure/interactive/light_switch,/turf/simulated/wall/wood/brown,/area/mission/prefab/house_07/bathroom_02)
"bj" = (/obj/structure/interactive/door/airlock,/turf/simulated/floor/tile,/area/mission/prefab/house_07/bathroom_02)
"bk" = (/obj/structure/carpet/blue,/obj/structure/interactive/bed/sheet,/turf/simulated/floor/wood/brown,/area/mission/prefab/house_07/guest_bedroom)
"bl" = (/obj/structure/carpet/blue,/obj/structure/table/wood,/obj/marker/spawning/random/misc,/turf/simulated/floor/wood/brown,/area/mission/prefab/house_07/guest_bedroom)
"bm" = (/obj/structure/table/wood,/obj/marker/spawning/random/dangerous,/turf/simulated/floor/wood/brown,/area/mission/prefab/house_07/guest_bedroom)
"bn" = (/obj/structure/interactive/misc/sink{icon_state = "sink"; dir = 8},/turf/simulated/floor/tile,/area/mission/prefab/house_07/bathroom_02)
"bo" = (/turf/simulated/floor/tile,/area/mission/prefab/house_07/bathroom_02)
"bp" = (/obj/structure/carpet/blue,/turf/simulated/floor/wood/brown,/area/mission/prefab/house_07/guest_bedroom)
"bq" = (/obj/structure/carpet/blue,/obj/structure/interactive/storage/safe,/turf/simulated/floor/wood/brown,/area/mission/prefab/house_07/guest_bedroom)
"br" = (/turf/simulated/floor/wood/brown,/area/mission/prefab/house_07/guest_bedroom)
"bs" = (/obj/structure/interactive/door/airlock/wood,/turf/simulated/floor/wood/brown,/area/mission/prefab/house_07/guest_bedroom)
"bt" = (/obj/structure/interactive/lighting/fixture/bulb{icon_state = "preview"; dir = 8},/turf/simulated/floor/tile,/area/mission/prefab/house_07/bathroom_02)
"bu" = (/obj/structure/carpet/blue,/obj/structure/interactive/misc/dresser,/turf/simulated/floor/wood/brown,/area/mission/prefab/house_07/guest_bedroom)
"bv" = (/obj/structure/carpet/blue,/obj/structure/interactive/lighting/fixture/bulb{icon_state = "preview"; dir = 1},/turf/simulated/floor/wood/brown,/area/mission/prefab/house_07/guest_bedroom)
"bw" = (/obj/structure/interactive/chair/wood{icon_state = "wooden_chair"; dir = 8},/turf/simulated/floor/wood/brown,/area/mission/prefab/house_07/guest_bedroom)
"bx" = (/obj/structure/interactive/light_switch{icon_state = "setup"; dir = 8},/turf/simulated/wall/wood/brown,/area/mission/prefab/house_07/guest_bedroom)
"by" = (/obj/structure/interactive/crate/closet,/obj/marker/spawning/random/valuable,/turf/simulated/floor/wood/brown,/area/mission/prefab/house_07)
"bz" = (/obj/structure/interactive/crate/closet,/obj/marker/spawning/random/dangerous,/turf/simulated/floor/wood/brown,/area/mission/prefab/house_07)
"bA" = (/obj/structure/interactive/misc/toilet{icon_state = "toilet"; dir = 4},/turf/simulated/floor/tile,/area/mission/prefab/house_07/bathroom_02)
"bB" = (/obj/structure/interactive/misc/shower{icon_state = "shower"; dir = 8},/obj/structure/interactive/misc/curtain_open,/turf/simulated/floor/tile,/area/mission/prefab/house_07/bathroom_02)
"bC" = (/obj/marker/spawning/window,/turf/simulated/floor/wood/brown,/area/mission/prefab/house_07/guest_bedroom)
"bD" = (/obj/marker/spawning/window,/turf/simulated/floor/wood/brown,/area/mission/prefab/house_07)
"bE" = (/obj/marker/spawning/random/maintenance,/turf/simulated/floor/plating,/area)
"bF" = (/turf/simulated/floor/plating,/area)
"bG" = (/obj/structure/carpet/brown,/obj/structure/interactive/lighting/fixture/bulb{icon_state = "preview"; dir = 8},/turf/simulated/floor/wood/brown,/area/mission/prefab/house_07/entrance)
"bH" = (/obj/structure/interactive/lighting/fixture/bulb{icon_state = "preview"; dir = 8},/turf/simulated/floor/wood/brown,/area/mission/prefab/house_07)
"bI" = (/obj/structure/interactive/chair/wood,/turf/simulated/floor/wood/brown,/area/mission/prefab/house_07/entrance)
"bJ" = (/obj/structure/table/wood,/obj/marker/spawning/random/food,/turf/simulated/floor/wood/brown,/area/mission/prefab/house_07/entrance)
"bK" = (/obj/structure/interactive/chair/wood{icon_state = "wooden_chair"; dir = 1},/turf/simulated/floor/wood/brown,/area/mission/prefab/house_07/entrance)

(1,1,1) = {"
abacacadadacaeaeaeaeabababababab
abacafagafahaeaiajaebEbEbFababab
abacakakakalaeamanaeapapapapabab
abacaqakarasaeatanaeauavauapabab
abacawaxaxaxaeayazaeaAaBaCaDabab
abacacacaEaFaobfaAbaaAaAaAaDabab
abaJaGaHaIaLaLaAaMaMaMaOaMaDabab
abaKaPaQaIaLaRbIaSaMaMaMaMaTabab
abaNaPaUaIaLaVbJaWaMaMaMaMaXabab
abaNaPaYaIaLaZbKbbaMaMaMbGapabab
abaNaPbcaIaLaLaAaAaAaAaAaCapabab
abbdbdbdbebgaLaLbhbibjbhauapabab
abbdbkblbmbdaLbHbhbnbobhapapabab
abbdbpbqbrbsaLaLbhbobtbhbEababab
abbdbubvbwbxbybzbhbAbBbhabababab
abbdbdbCbdbdbDbDbhbhbhbhabababab
"}

(1,1,2) = {"
aaaaaaaaaaaaaaaaaaaaaaaaaaaaaaaa
aaaaaaaaaaaaaaaaaaaaaaaaaaaaaaaa
aaaaaaaaaaaaaaaaaaaaaaaaaaaaaaaa
aaaaaaaaaaaaaaaaaaaaaaaaaaaaaaaa
aaaaaaaaaaaaaaaaaaaaaaaaaaaaaaaa
aaaaaaaaaaaaaaaaaaaaaaaaaaaaaaaa
aaaaaaaaaaaaaaaaaaaaaaaaaaaaaaaa
aaaaaaaaaaaaaaaaaaaaaaaaaaaaaaaa
aaaaaaaaaaaaaaaaaaaaaaaaaaaaaaaa
aaaaaaaaaaaaaaaaaaaaaaaaaaaaaaaa
aaaaaaaaaaaaaaaaaaaaaaaaaaaaaaaa
aaaaaaaaaaaaaaaaaaaaaaaaaaaaaaaa
aaaaaaaaaaaaaaaaaaaaaaaaaaaaaaaa
aaaaaaaaaaaaaaaaaaaaaaaaaaaaaaaa
aaaaaaaaaaaaaaaaaaaaaaaaaaaaaaaa
aaaaaaaaaaaaaaaaaaaaaaaaaaaaaaaa
"}

(1,1,3) = {"
aaaaaaaaaaaaaaaaaaaaaaaaaaaaaaaa
aaaaaaaaaaaaaaaaaaaaaaaaaaaaaaaa
aaaaaaaaaaaaaaaaaaaaaaaaaaaaaaaa
aaaaaaaaaaaaaaaaaaaaaaaaaaaaaaaa
aaaaaaaaaaaaaaaaaaaaaaaaaaaaaaaa
aaaaaaaaaaaaaaaaaaaaaaaaaaaaaaaa
aaaaaaaaaaaaaaaaaaaaaaaaaaaaaaaa
aaaaaaaaaaaaaaaaaaaaaaaaaaaaaaaa
aaaaaaaaaaaaaaaaaaaaaaaaaaaaaaaa
aaaaaaaaaaaaaaaaaaaaaaaaaaaaaaaa
aaaaaaaaaaaaaaaaaaaaaaaaaaaaaaaa
aaaaaaaaaaaaaaaaaaaaaaaaaaaaaaaa
aaaaaaaaaaaaaaaaaaaaaaaaaaaaaaaa
aaaaaaaaaaaaaaaaaaaaaaaaaaaaaaaa
aaaaaaaaaaaaaaaaaaaaaaaaaaaaaaaa
aaaaaaaaaaaaaaaaaaaaaaaaaaaaaaaa
"}

(1,1,4) = {"
aaaaaaaaaaaaaaaaaaaaaaaaaaaaaaaa
aaaaaaaaaaaaaaaaaaaaaaaaaaaaaaaa
aaaaaaaaaaaaaaaaaaaaaaaaaaaaaaaa
aaaaaaaaaaaaaaaaaaaaaaaaaaaaaaaa
aaaaaaaaaaaaaaaaaaaaaaaaaaaaaaaa
aaaaaaaaaaaaaaaaaaaaaaaaaaaaaaaa
aaaaaaaaaaaaaaaaaaaaaaaaaaaaaaaa
aaaaaaaaaaaaaaaaaaaaaaaaaaaaaaaa
aaaaaaaaaaaaaaaaaaaaaaaaaaaaaaaa
aaaaaaaaaaaaaaaaaaaaaaaaaaaaaaaa
aaaaaaaaaaaaaaaaaaaaaaaaaaaaaaaa
aaaaaaaaaaaaaaaaaaaaaaaaaaaaaaaa
aaaaaaaaaaaaaaaaaaaaaaaaaaaaaaaa
aaaaaaaaaaaaaaaaaaaaaaaaaaaaaaaa
aaaaaaaaaaaaaaaaaaaaaaaaaaaaaaaa
aaaaaaaaaaaaaaaaaaaaaaaaaaaaaaaa
"}

(1,1,5) = {"
aaaaaaaaaaaaaaaaaaaaaaaaaaaaaaaa
aaaaaaaaaaaaaaaaaaaaaaaaaaaaaaaa
aaaaaaaaaaaaaaaaaaaaaaaaaaaaaaaa
aaaaaaaaaaaaaaaaaaaaaaaaaaaaaaaa
aaaaaaaaaaaaaaaaaaaaaaaaaaaaaaaa
aaaaaaaaaaaaaaaaaaaaaaaaaaaaaaaa
aaaaaaaaaaaaaaaaaaaaaaaaaaaaaaaa
aaaaaaaaaaaaaaaaaaaaaaaaaaaaaaaa
aaaaaaaaaaaaaaaaaaaaaaaaaaaaaaaa
aaaaaaaaaaaaaaaaaaaaaaaaaaaaaaaa
aaaaaaaaaaaaaaaaaaaaaaaaaaaaaaaa
aaaaaaaaaaaaaaaaaaaaaaaaaaaaaaaa
aaaaaaaaaaaaaaaaaaaaaaaaaaaaaaaa
aaaaaaaaaaaaaaaaaaaaaaaaaaaaaaaa
aaaaaaaaaaaaaaaaaaaaaaaaaaaaaaaa
aaaaaaaaaaaaaaaaaaaaaaaaaaaaaaaa
"}

(1,1,6) = {"
aaaaaaaaaaaaaaaaaaaaaaaaaaaaaaaa
aaaaaaaaaaaaaaaaaaaaaaaaaaaaaaaa
aaaaaaaaaaaaaaaaaaaaaaaaaaaaaaaa
aaaaaaaaaaaaaaaaaaaaaaaaaaaaaaaa
aaaaaaaaaaaaaaaaaaaaaaaaaaaaaaaa
aaaaaaaaaaaaaaaaaaaaaaaaaaaaaaaa
aaaaaaaaaaaaaaaaaaaaaaaaaaaaaaaa
aaaaaaaaaaaaaaaaaaaaaaaaaaaaaaaa
aaaaaaaaaaaaaaaaaaaaaaaaaaaaaaaa
aaaaaaaaaaaaaaaaaaaaaaaaaaaaaaaa
aaaaaaaaaaaaaaaaaaaaaaaaaaaaaaaa
aaaaaaaaaaaaaaaaaaaaaaaaaaaaaaaa
aaaaaaaaaaaaaaaaaaaaaaaaaaaaaaaa
aaaaaaaaaaaaaaaaaaaaaaaaaaaaaaaa
aaaaaaaaaaaaaaaaaaaaaaaaaaaaaaaa
aaaaaaaaaaaaaaaaaaaaaaaaaaaaaaaa
"}

(1,1,7) = {"
aaaaaaaaaaaaaaaaaaaaaaaaaaaaaaaa
aaaaaaaaaaaaaaaaaaaaaaaaaaaaaaaa
aaaaaaaaaaaaaaaaaaaaaaaaaaaaaaaa
aaaaaaaaaaaaaaaaaaaaaaaaaaaaaaaa
aaaaaaaaaaaaaaaaaaaaaaaaaaaaaaaa
aaaaaaaaaaaaaaaaaaaaaaaaaaaaaaaa
aaaaaaaaaaaaaaaaaaaaaaaaaaaaaaaa
aaaaaaaaaaaaaaaaaaaaaaaaaaaaaaaa
aaaaaaaaaaaaaaaaaaaaaaaaaaaaaaaa
aaaaaaaaaaaaaaaaaaaaaaaaaaaaaaaa
aaaaaaaaaaaaaaaaaaaaaaaaaaaaaaaa
aaaaaaaaaaaaaaaaaaaaaaaaaaaaaaaa
aaaaaaaaaaaaaaaaaaaaaaaaaaaaaaaa
aaaaaaaaaaaaaaaaaaaaaaaaaaaaaaaa
aaaaaaaaaaaaaaaaaaaaaaaaaaaaaaaa
aaaaaaaaaaaaaaaaaaaaaaaaaaaaaaaa
"}

(1,1,8) = {"
aaaaaaaaaaaaaaaaaaaaaaaaaaaaaaaa
aaaaaaaaaaaaaaaaaaaaaaaaaaaaaaaa
aaaaaaaaaaaaaaaaaaaaaaaaaaaaaaaa
aaaaaaaaaaaaaaaaaaaaaaaaaaaaaaaa
aaaaaaaaaaaaaaaaaaaaaaaaaaaaaaaa
aaaaaaaaaaaaaaaaaaaaaaaaaaaaaaaa
aaaaaaaaaaaaaaaaaaaaaaaaaaaaaaaa
aaaaaaaaaaaaaaaaaaaaaaaaaaaaaaaa
aaaaaaaaaaaaaaaaaaaaaaaaaaaaaaaa
aaaaaaaaaaaaaaaaaaaaaaaaaaaaaaaa
aaaaaaaaaaaaaaaaaaaaaaaaaaaaaaaa
aaaaaaaaaaaaaaaaaaaaaaaaaaaaaaaa
aaaaaaaaaaaaaaaaaaaaaaaaaaaaaaaa
aaaaaaaaaaaaaaaaaaaaaaaaaaaaaaaa
aaaaaaaaaaaaaaaaaaaaaaaaaaaaaaaa
aaaaaaaaaaaaaaaaaaaaaaaaaaaaaaaa
"}

(1,1,9) = {"
aaaaaaaaaaaaaaaaaaaaaaaaaaaaaaaa
aaaaaaaaaaaaaaaaaaaaaaaaaaaaaaaa
aaaaaaaaaaaaaaaaaaaaaaaaaaaaaaaa
aaaaaaaaaaaaaaaaaaaaaaaaaaaaaaaa
aaaaaaaaaaaaaaaaaaaaaaaaaaaaaaaa
aaaaaaaaaaaaaaaaaaaaaaaaaaaaaaaa
aaaaaaaaaaaaaaaaaaaaaaaaaaaaaaaa
aaaaaaaaaaaaaaaaaaaaaaaaaaaaaaaa
aaaaaaaaaaaaaaaaaaaaaaaaaaaaaaaa
aaaaaaaaaaaaaaaaaaaaaaaaaaaaaaaa
aaaaaaaaaaaaaaaaaaaaaaaaaaaaaaaa
aaaaaaaaaaaaaaaaaaaaaaaaaaaaaaaa
aaaaaaaaaaaaaaaaaaaaaaaaaaaaaaaa
aaaaaaaaaaaaaaaaaaaaaaaaaaaaaaaa
aaaaaaaaaaaaaaaaaaaaaaaaaaaaaaaa
aaaaaaaaaaaaaaaaaaaaaaaaaaaaaaaa
"}

(1,1,10) = {"
aaaaaaaaaaaaaaaaaaaaaaaaaaaaaaaa
aaaaaaaaaaaaaaaaaaaaaaaaaaaaaaaa
aaaaaaaaaaaaaaaaaaaaaaaaaaaaaaaa
aaaaaaaaaaaaaaaaaaaaaaaaaaaaaaaa
aaaaaaaaaaaaaaaaaaaaaaaaaaaaaaaa
aaaaaaaaaaaaaaaaaaaaaaaaaaaaaaaa
aaaaaaaaaaaaaaaaaaaaaaaaaaaaaaaa
aaaaaaaaaaaaaaaaaaaaaaaaaaaaaaaa
aaaaaaaaaaaaaaaaaaaaaaaaaaaaaaaa
aaaaaaaaaaaaaaaaaaaaaaaaaaaaaaaa
aaaaaaaaaaaaaaaaaaaaaaaaaaaaaaaa
aaaaaaaaaaaaaaaaaaaaaaaaaaaaaaaa
aaaaaaaaaaaaaaaaaaaaaaaaaaaaaaaa
aaaaaaaaaaaaaaaaaaaaaaaaaaaaaaaa
aaaaaaaaaaaaaaaaaaaaaaaaaaaaaaaa
aaaaaaaaaaaaaaaaaaaaaaaaaaaaaaaa
"}

(1,1,11) = {"
aaaaaaaaaaaaaaaaaaaaaaaaaaaaaaaa
aaaaaaaaaaaaaaaaaaaaaaaaaaaaaaaa
aaaaaaaaaaaaaaaaaaaaaaaaaaaaaaaa
aaaaaaaaaaaaaaaaaaaaaaaaaaaaaaaa
aaaaaaaaaaaaaaaaaaaaaaaaaaaaaaaa
aaaaaaaaaaaaaaaaaaaaaaaaaaaaaaaa
aaaaaaaaaaaaaaaaaaaaaaaaaaaaaaaa
aaaaaaaaaaaaaaaaaaaaaaaaaaaaaaaa
aaaaaaaaaaaaaaaaaaaaaaaaaaaaaaaa
aaaaaaaaaaaaaaaaaaaaaaaaaaaaaaaa
aaaaaaaaaaaaaaaaaaaaaaaaaaaaaaaa
aaaaaaaaaaaaaaaaaaaaaaaaaaaaaaaa
aaaaaaaaaaaaaaaaaaaaaaaaaaaaaaaa
aaaaaaaaaaaaaaaaaaaaaaaaaaaaaaaa
aaaaaaaaaaaaaaaaaaaaaaaaaaaaaaaa
aaaaaaaaaaaaaaaaaaaaaaaaaaaaaaaa
"}

(1,1,12) = {"
aaaaaaaaaaaaaaaaaaaaaaaaaaaaaaaa
aaaaaaaaaaaaaaaaaaaaaaaaaaaaaaaa
aaaaaaaaaaaaaaaaaaaaaaaaaaaaaaaa
aaaaaaaaaaaaaaaaaaaaaaaaaaaaaaaa
aaaaaaaaaaaaaaaaaaaaaaaaaaaaaaaa
aaaaaaaaaaaaaaaaaaaaaaaaaaaaaaaa
aaaaaaaaaaaaaaaaaaaaaaaaaaaaaaaa
aaaaaaaaaaaaaaaaaaaaaaaaaaaaaaaa
aaaaaaaaaaaaaaaaaaaaaaaaaaaaaaaa
aaaaaaaaaaaaaaaaaaaaaaaaaaaaaaaa
aaaaaaaaaaaaaaaaaaaaaaaaaaaaaaaa
aaaaaaaaaaaaaaaaaaaaaaaaaaaaaaaa
aaaaaaaaaaaaaaaaaaaaaaaaaaaaaaaa
aaaaaaaaaaaaaaaaaaaaaaaaaaaaaaaa
aaaaaaaaaaaaaaaaaaaaaaaaaaaaaaaa
aaaaaaaaaaaaaaaaaaaaaaaaaaaaaaaa
"}

(1,1,13) = {"
aaaaaaaaaaaaaaaaaaaaaaaaaaaaaaaa
aaaaaaaaaaaaaaaaaaaaaaaaaaaaaaaa
aaaaaaaaaaaaaaaaaaaaaaaaaaaaaaaa
aaaaaaaaaaaaaaaaaaaaaaaaaaaaaaaa
aaaaaaaaaaaaaaaaaaaaaaaaaaaaaaaa
aaaaaaaaaaaaaaaaaaaaaaaaaaaaaaaa
aaaaaaaaaaaaaaaaaaaaaaaaaaaaaaaa
aaaaaaaaaaaaaaaaaaaaaaaaaaaaaaaa
aaaaaaaaaaaaaaaaaaaaaaaaaaaaaaaa
aaaaaaaaaaaaaaaaaaaaaaaaaaaaaaaa
aaaaaaaaaaaaaaaaaaaaaaaaaaaaaaaa
aaaaaaaaaaaaaaaaaaaaaaaaaaaaaaaa
aaaaaaaaaaaaaaaaaaaaaaaaaaaaaaaa
aaaaaaaaaaaaaaaaaaaaaaaaaaaaaaaa
aaaaaaaaaaaaaaaaaaaaaaaaaaaaaaaa
aaaaaaaaaaaaaaaaaaaaaaaaaaaaaaaa
"}

(1,1,14) = {"
aaaaaaaaaaaaaaaaaaaaaaaaaaaaaaaa
aaaaaaaaaaaaaaaaaaaaaaaaaaaaaaaa
aaaaaaaaaaaaaaaaaaaaaaaaaaaaaaaa
aaaaaaaaaaaaaaaaaaaaaaaaaaaaaaaa
aaaaaaaaaaaaaaaaaaaaaaaaaaaaaaaa
aaaaaaaaaaaaaaaaaaaaaaaaaaaaaaaa
aaaaaaaaaaaaaaaaaaaaaaaaaaaaaaaa
aaaaaaaaaaaaaaaaaaaaaaaaaaaaaaaa
aaaaaaaaaaaaaaaaaaaaaaaaaaaaaaaa
aaaaaaaaaaaaaaaaaaaaaaaaaaaaaaaa
aaaaaaaaaaaaaaaaaaaaaaaaaaaaaaaa
aaaaaaaaaaaaaaaaaaaaaaaaaaaaaaaa
aaaaaaaaaaaaaaaaaaaaaaaaaaaaaaaa
aaaaaaaaaaaaaaaaaaaaaaaaaaaaaaaa
aaaaaaaaaaaaaaaaaaaaaaaaaaaaaaaa
aaaaaaaaaaaaaaaaaaaaaaaaaaaaaaaa
"}

(1,1,15) = {"
aaaaaaaaaaaaaaaaaaaaaaaaaaaaaaaa
aaaaaaaaaaaaaaaaaaaaaaaaaaaaaaaa
aaaaaaaaaaaaaaaaaaaaaaaaaaaaaaaa
aaaaaaaaaaaaaaaaaaaaaaaaaaaaaaaa
aaaaaaaaaaaaaaaaaaaaaaaaaaaaaaaa
aaaaaaaaaaaaaaaaaaaaaaaaaaaaaaaa
aaaaaaaaaaaaaaaaaaaaaaaaaaaaaaaa
aaaaaaaaaaaaaaaaaaaaaaaaaaaaaaaa
aaaaaaaaaaaaaaaaaaaaaaaaaaaaaaaa
aaaaaaaaaaaaaaaaaaaaaaaaaaaaaaaa
aaaaaaaaaaaaaaaaaaaaaaaaaaaaaaaa
aaaaaaaaaaaaaaaaaaaaaaaaaaaaaaaa
aaaaaaaaaaaaaaaaaaaaaaaaaaaaaaaa
aaaaaaaaaaaaaaaaaaaaaaaaaaaaaaaa
aaaaaaaaaaaaaaaaaaaaaaaaaaaaaaaa
aaaaaaaaaaaaaaaaaaaaaaaaaaaaaaaa
"}

(1,1,16) = {"
aaaaaaaaaaaaaaaaaaaaaaaaaaaaaaaa
aaaaaaaaaaaaaaaaaaaaaaaaaaaaaaaa
aaaaaaaaaaaaaaaaaaaaaaaaaaaaaaaa
aaaaaaaaaaaaaaaaaaaaaaaaaaaaaaaa
aaaaaaaaaaaaaaaaaaaaaaaaaaaaaaaa
aaaaaaaaaaaaaaaaaaaaaaaaaaaaaaaa
aaaaaaaaaaaaaaaaaaaaaaaaaaaaaaaa
aaaaaaaaaaaaaaaaaaaaaaaaaaaaaaaa
aaaaaaaaaaaaaaaaaaaaaaaaaaaaaaaa
aaaaaaaaaaaaaaaaaaaaaaaaaaaaaaaa
aaaaaaaaaaaaaaaaaaaaaaaaaaaaaaaa
aaaaaaaaaaaaaaaaaaaaaaaaaaaaaaaa
aaaaaaaaaaaaaaaaaaaaaaaaaaaaaaaa
aaaaaaaaaaaaaaaaaaaaaaaaaaaaaaaa
aaaaaaaaaaaaaaaaaaaaaaaaaaaaaaaa
aaaaaaaaaaaaaaaaaaaaaaaaaaaaaaaa
"}
