"aa" = (/obj/structure/interactive/wire/red,/obj/marker/map_node,/turf/simulated/floor/plating,/area/mission/prefab/house/house_D03/hallway)
"ab" = (/obj/marker/map_node,/turf/simulated/floor/plating,/area/mission/prefab/house/house_D03/hallway)
"ac" = (/obj/structure/interactive/chair/wood{dir = 8},/obj/marker/map_node,/turf/simulated/floor/tile/chapel,/area/mission/prefab/house/house_D03/chapple)
"ad" = (/obj/marker/map_node,/turf/simulated/floor/tile/grey/ish,/area/mission/prefab/house/house_D03/command)
"ae" = (/obj/marker/map_node,/turf/simulated/floor/tile/grey,/area/mission/prefab/house/house_D03/command)
"af" = (/obj/structure/interactive/wire/red,/obj/marker/map_node,/turf/simulated/floor/wood/brown,/area/mission/prefab/house/house_D03)
"ag" = (/obj/marker/map_node,/turf/simulated/floor/tile/grey/ish,/area/mission/prefab/house/house_D03)
"ah" = (/obj/structure/interactive/chair/wood{icon_state = "wooden_chair"; dir = 4},/turf/simulated/floor/tile/grey,/area/mission/prefab/house/house_D03/command)
"ai" = (/obj/marker/hostage_spawn,/turf/simulated/floor/wood/brown,/area/mission/prefab/house/house_D03/science)
"aj" = (/obj/structure/interactive/chair/wood{dir = 4},/obj/marker/hostage_spawn,/turf/simulated/floor/tile/chapel/decor{dir = 1},/area/mission/prefab/house/house_D03/chapple)
"ak" = (/obj/structure/interactive/chair/wood{dir = 8},/obj/marker/hostage_spawn,/turf/simulated/floor/tile/chapel,/area/mission/prefab/house/house_D03/chapple)
"al" = (/obj/structure/interactive/door/airlock/station/glass,/obj/marker/smart_clear_turf,/turf/simulated/floor/wood/brown,/area/mission/prefab/house/house_D03/hallway)
"am" = (/obj/marker/spawning/window,/obj/marker/smart_clear_turf,/turf/simulated/floor/plating,/area/mission/prefab/house/house_D03/hallway)
"an" = (/obj/structure/interactive/door/airlock/station/maintenance,/obj/marker/smart_clear_turf,/turf/simulated/floor/plating,/area/mission/prefab/house/house_D03/hallway)
"ao" = (/obj/structure/interactive/lighting/fixture/bulb{icon_state = "preview"; dir = 4},/obj/marker/cover_node{icon_state = "both"; dir = 8},/turf/simulated/floor/wood/brown,/area/mission/prefab/house/house_D03/hallway)
"ap" = (/obj/marker/cover_node{icon_state = "both"; dir = 8},/turf/simulated/floor/wood/brown,/area/mission/prefab/house/house_D03/hallway)
"aq" = (/obj/structure/interactive/door/airlock/station,/turf/simulated/floor/plating,/area/mission/prefab/house/house_D03/sec)
"ar" = (/obj/marker/cover_node/left,/turf/simulated/floor/wood/brown,/area/mission/prefab/house/house_D03/hallway)
"as" = (/obj/structure/interactive/lighting/fixture/bulb{dir = 1},/obj/marker/cover_node/left,/turf/simulated/floor/wood/brown,/area/mission/prefab/house/house_D03/hallway)
"at" = (/obj/marker/cover_node/left{icon_state = "left"; dir = 4},/turf/simulated/floor/wood/brown,/area/mission/prefab/house/house_D03/hallway)
"au" = (/obj/marker/cover_node/left{icon_state = "left"; dir = 8},/turf/simulated/floor/wood/brown,/area/mission/prefab/house/house_D03/hallway)
"av" = (/obj/marker/cover_node/left{icon_state = "left"; dir = 1},/turf/simulated/floor/wood/brown,/area/mission/prefab/house/house_D03/hallway)
"aw" = (/obj/marker/cover_node/right,/turf/simulated/floor/wood/brown,/area/mission/prefab/house/house_D03/hallway)
"ax" = (/obj/marker/cover_node/right{icon_state = "right"; dir = 1},/turf/simulated/floor/wood/brown,/area/mission/prefab/house/house_D03/hallway)
"ay" = (/obj/marker/cover_node/right{icon_state = "right"; dir = 8},/turf/simulated/floor/wood/brown,/area/mission/prefab/house/house_D03/hallway)
"az" = (/obj/marker/cover_node/right{icon_state = "right"; dir = 4},/turf/simulated/floor/wood/brown,/area/mission/prefab/house/house_D03/hallway)
"aA" = (/obj/marker/map_node,/obj/marker/cover_node/right,/turf/simulated/floor/wood/brown,/area/mission/prefab/house/house_D03/hallway)
"aB" = (/mob/living/advanced/npc/bandit{icon_state = "directional"; dir = 1},/obj/marker/map_node,/turf/simulated/floor/tile/grey/ish,/area/mission/prefab/house/house_D03/command)
"aC" = (/obj/structure/interactive/door/airlock/wood,/obj/marker/cover_node/left{icon_state = "left"; dir = 4},/turf/simulated/floor/wood/brown,/area/mission/prefab/house/house_D03/science)
"aD" = (/mob/living/advanced/npc/bandit{icon_state = "directional"; dir = 4},/obj/structure/interactive/bed/sheet,/obj/marker/cover_node/right{icon_state = "right"; dir = 1},/turf/simulated/floor/wood/brown,/area/mission/prefab/house/house_D03/science)
"aE" = (/obj/structure/interactive/potted_plant/office,/obj/marker/cover_node/left{icon_state = "left"; dir = 4},/turf/simulated/floor/tile/grey/ish,/area/mission/prefab/house/house_D03/command)
"aF" = (/obj/structure/table/wood,/obj/marker/spawning/random/food,/turf/simulated/floor/tile/grey,/area/mission/prefab/house/house_D03/command)
"aG" = (/obj/structure/interactive/door/airlock/station,/obj/marker/cover_node/right{icon_state = "right"; dir = 4},/turf/simulated/floor/tile,/area/mission/prefab/house/house_D03/bathroom)
"aH" = (/obj/structure/interactive/wire/red,/obj/marker/cover_node/right,/turf/simulated/floor/plating,/area/mission/prefab/house/house_D03/hallway)
"aI" = (/obj/structure/interactive/door/airlock/station/maintenance,/obj/marker/cover_node/left{icon_state = "left"; dir = 4},/turf/simulated/floor/plating,/area/mission/prefab/house/house_D03/hallway)
"aJ" = (/obj/structure/interactive/power/smes,/obj/structure/interactive/wire/red,/turf/simulated/floor/plating,/area/mission/prefab/house/house_D03)
"aK" = (/mob/living/advanced/npc/bandit{icon_state = "directional"; dir = 1},/obj/marker/cover_node/left{icon_state = "left"; dir = 4},/turf/simulated/floor/wood/brown,/area/mission/prefab/house/house_D03/hallway)
"aQ" = (/obj/structure/table/wood,/obj/marker/spawning/random/misc,/turf/simulated/floor/wood/brown,/area/mission/prefab/house/house_D03/science)
"br" = (/turf/simulated/wall/wood/brown,/area/mission/prefab/house/house_D03/bathroom)
"cy" = (/obj/structure/interactive/light_switch{icon_state = "setup"; dir = 4},/turf/simulated/wall/wood/brown,/area/mission/prefab/house/house_D03/hallway)
"dP" = (/obj/structure/table/rack/grey,/obj/item/weapon/melee/tool/wrench,/obj/item/weapon/melee/tool/crowbar,/obj/item/weapon/melee/tool/wirecutters,/turf/simulated/floor/tile/grey/ish,/area/mission/prefab/house/house_D03)
"dX" = (/turf/simulated/wall/wood/brown,/area/mission/prefab/house/house_D03/science)
"fx" = (/obj/structure/table/reinforced/steel,/obj/marker/spawning/random/kitchen,/turf/simulated/floor/tile/grey,/area/mission/prefab/house/house_D03/command)
"gl" = (/obj/structure/interactive/bed/sheet,/turf/simulated/floor/wood/brown,/area/mission/prefab/house/house_D03/science)
"jc" = (/obj/structure/interactive/potted_plant/office,/turf/simulated/floor/wood/brown,/area/mission/prefab/house/house_D03/hallway)
"lM" = (/obj/structure/table/cooking/grill,/obj/marker/spawning/random/kitchen,/turf/simulated/floor/tile/grey/ish,/area/mission/prefab/house/house_D03/command)
"lU" = (/obj/structure/interactive/misc/toilet,/obj/structure/interactive/lighting/fixture/bulb,/turf/simulated/floor/tile,/area/mission/prefab/house/house_D03/bathroom)
"lW" = (/obj/structure/table/wood,/turf/simulated/floor/tile/grey,/area/mission/prefab/house/house_D03/command)
"me" = (/obj/structure/interactive/door/airlock/station/glass,/turf/simulated/floor/wood/brown,/area/mission/prefab/house/house_D03/hallway)
"ng" = (/obj/structure/interactive/light_switch,/turf/simulated/wall/wood/brown,/area/mission/prefab/house/house_D03)
"oY" = (/obj/marker/spawning/window,/turf/simulated/floor/plating,/area/mission/prefab/house/house_D03)
"pW" = (/turf/simulated/floor/wood/brown,/area/mission/prefab/house/house_D03/hallway)
"qE" = (/obj/structure/table/rack/grey,/obj/marker/spawning/random/trash,/obj/marker/spawning/random/trash,/obj/marker/spawning/random/trash,/obj/marker/spawning/random/trash,/turf/simulated/floor/plating,/area/mission/prefab/house/house_D03/hallway)
"qQ" = (/mob/living/advanced/npc/bandit,/turf/simulated/floor/wood/brown,/area/mission/prefab/house/house_D03/sec)
"rq" = (/turf/simulated/floor/tile/chapel/decor,/area/mission/prefab/house/house_D03/chapple)
"sc" = (/obj/structure/interactive/light_switch{icon_state = "setup"; dir = 1},/turf/simulated/wall/wood/brown,/area/mission/prefab/house/house_D03/science)
"si" = (/obj/marker/spawning/window,/turf/simulated/floor/plating,/area/mission/prefab/house/house_D03/sec)
"sH" = (/obj/structure/interactive/potted_plant/office,/turf/simulated/floor/wood/brown,/area/mission/prefab/house/house_D03/science)
"uJ" = (/obj/structure/interactive/potted_plant/office,/turf/simulated/floor/tile/chapel/decor{dir = 8},/area/mission/prefab/house/house_D03/chapple)
"vv" = (/obj/marker/map_node,/turf/simulated/floor/wood/brown,/area/mission/prefab/house/house_D03/science)
"vz" = (/obj/structure/interactive/crate/trash,/obj/marker/spawning/random/trash,/turf/simulated/floor/tile/grey,/area/mission/prefab/house/house_D03/command)
"vG" = (/obj/structure/interactive/wire/red,/turf/simulated/wall/wood/brown,/area/mission/prefab/house/house_D03/chapple)
"vK" = (/obj/structure/interactive/door/airlock/station,/turf/simulated/floor/tile/grey/ish,/area/mission/prefab/house/house_D03/sec)
"wg" = (/obj/structure/table/wood,/obj/structure/interactive/storage/ammo_pile,/turf/simulated/floor/tile/grey/ish,/area/mission/prefab/house/house_D03/command)
"wr" = (/obj/structure/table/rack/grey,/obj/marker/spawning/random/misc,/turf/simulated/floor/wood/brown,/area/mission/prefab/house/house_D03/sec)
"xy" = (/obj/structure/interactive/light_switch{icon_state = "setup"; dir = 8},/turf/simulated/wall/wood/brown,/area/mission/prefab/house/house_D03/bathroom)
"Ak" = (/obj/structure/interactive/crate/closet,/obj/marker/spawning/random/misc,/turf/simulated/floor/tile/grey/ish,/area/mission/prefab/house/house_D03)
"An" = (/obj/structure/interactive/lighting/fixture/bulb{icon_state = "preview"; dir = 8},/turf/simulated/floor/tile/grey/ish,/area/mission/prefab/house/house_D03)
"AN" = (/obj/structure/interactive/crate/closet/freezer,/obj/marker/spawning/random/food,/turf/simulated/floor/tile/grey/ish,/area/mission/prefab/house/house_D03/command)
"BJ" = (/obj/structure/interactive/lighting/fixture/bulb,/turf/simulated/floor/wood/brown,/area/mission/prefab/house/house_D03/hallway)
"CQ" = (/obj/structure/table/rack/grey,/obj/marker/spawning/random/valuable,/turf/simulated/floor/wood/brown,/area/mission/prefab/house/house_D03/sec)
"CW" = (/obj/structure/interactive/door/airlock/station,/obj/structure/interactive/wire/red,/turf/simulated/floor/tile/grey/ish,/area/mission/prefab/house/house_D03)
"DK" = (/obj/structure/interactive/wire/red,/turf/simulated/wall/wood/brown,/area/mission/prefab/house/house_D03/hallway)
"EL" = (/obj/structure/interactive/wire/red,/turf/simulated/floor/plating,/area/mission/prefab/house/house_D03/hallway)
"Fd" = (/turf/simulated/wall/wood/brown,/area/mission/prefab/house/house_D03/sec)
"Fm" = (/obj/structure/interactive/power/apc,/turf/simulated/wall/wood/brown,/area/mission/prefab/house/house_D03)
"Fv" = (/turf/simulated/floor/wood/brown,/area/mission/prefab/house/house_D03/sec)
"Gb" = (/obj/structure/table/reinforced/steel,/obj/marker/spawning/random/misc,/turf/simulated/floor/tile/grey/ish,/area/mission/prefab/house/house_D03)
"Gc" = (/turf/dmm_suite/no_wall,/area/dmm_suite/clear_area)
"Gi" = (/turf/simulated/floor/plating,/area/mission/prefab/house/house_D03/sec)
"Gj" = (/obj/structure/interactive/bed/sheet,/turf/simulated/floor/plating,/area/mission/prefab/house/house_D03/sec)
"GQ" = (/turf/simulated/floor/tile/grey/ish,/area/mission/prefab/house/house_D03)
"Hg" = (/obj/structure/interactive/door/airlock/station/glass,/turf/simulated/floor/tile/chapel,/area/mission/prefab/house/house_D03/chapple)
"HA" = (/obj/structure/table/wood,/obj/marker/spawning/random/food,/turf/simulated/floor/tile/grey/ish,/area/mission/prefab/house/house_D03/command)
"HD" = (/turf/dmm_suite/clear_turf,/area/dmm_suite/clear_area)
"HZ" = (/obj/marker/map_node,/turf/simulated/floor/wood/brown,/area/mission/prefab/house/house_D03/hallway)
"IY" = (/obj/structure/interactive/light_switch{icon_state = "setup"; dir = 1},/turf/simulated/wall/wood/brown,/area/mission/prefab/house/house_D03/sec)
"JE" = (/obj/structure/table/rack/grey,/obj/item/weapon/melee/tool/screwdriver,/obj/item/weapon/melee/tool/welder,/obj/item/weapon/melee/tool/multitool,/turf/simulated/floor/tile/grey/ish,/area/mission/prefab/house/house_D03)
"JQ" = (/obj/structure/interactive/door/airlock/station,/turf/simulated/floor/tile/grey/ish,/area/mission/prefab/house/house_D03/command)
"Lh" = (/obj/structure/interactive/solar_panel,/obj/structure/interactive/wire/yellow,/turf/simulated/floor/plating,/area/mission/prefab/house/house_D03)
"Lw" = (/obj/marker/spawning/window,/obj/structure/interactive/wire/red,/turf/simulated/floor/plating,/area/mission/prefab/house/house_D03)
"Lz" = (/obj/marker/spawning/window,/turf/simulated/floor/plating,/area/mission/prefab/house/house_D03/command)
"Nv" = (/obj/structure/interactive/crate/trash,/obj/marker/spawning/random/trash,/turf/simulated/floor/wood/brown,/area/mission/prefab/house/house_D03)
"NJ" = (/turf/simulated/wall/wood/brown,/area/mission/prefab/house/house_D03)
"On" = (/obj/structure/interactive/crate/closet,/obj/marker/spawning/random/misc,/turf/simulated/floor/wood/brown,/area/mission/prefab/house/house_D03/science)
"OU" = (/obj/structure/table/wood,/obj/marker/spawning/random/misc,/obj/structure/interactive/lighting/fixture/bulb,/turf/simulated/floor/tile/chapel/decor{dir = 4},/area/mission/prefab/house/house_D03/chapple)
"Pc" = (/obj/structure/interactive/wire/red,/turf/simulated/floor/tile/grey/ish,/area/mission/prefab/house/house_D03)
"Ph" = (/obj/marker/spawning/window,/turf/simulated/floor/plating,/area/mission/prefab/house/house_D03/hallway)
"Qd" = (/obj/structure/interactive/bed/sheet,/obj/structure/interactive/lighting/fixture/bulb{icon_state = "preview"; dir = 4},/turf/simulated/floor/wood/brown,/area/mission/prefab/house/house_D03/science)
"Qu" = (/obj/structure/interactive/light_switch,/turf/simulated/wall/wood/brown,/area/mission/prefab/house/house_D03/chapple)
"RD" = (/turf/simulated/floor/wood/brown,/area/mission/prefab/house/house_D03/science)
"Sr" = (/turf/simulated/wall/metal,/area/mission/prefab/house/house_D03/command)
"Su" = (/obj/structure/interactive/light_switch{icon_state = "setup"; dir = 4},/turf/simulated/wall/metal,/area/mission/prefab/house/house_D03/command)
"SO" = (/turf/simulated/floor/tile/grey,/area/mission/prefab/house/house_D03/command)
"TS" = (/turf/simulated/wall/wood/brown,/area/mission/prefab/house/house_D03/hallway)
"VA" = (/obj/structure/table/rack/grey,/obj/marker/spawning/random/misc,/obj/structure/interactive/lighting/fixture/bulb,/turf/simulated/floor/wood/brown,/area/mission/prefab/house/house_D03/sec)
"VD" = (/obj/structure/interactive/chair/wood{icon_state = "wooden_chair"; dir = 4},/turf/simulated/floor/tile/grey/ish,/area/mission/prefab/house/house_D03/command)
"VI" = (/obj/structure/interactive/crate/trash,/obj/marker/spawning/random/trash,/turf/simulated/floor/wood/brown,/area/mission/prefab/house/house_D03/hallway)
"WH" = (/obj/structure/interactive/wire/yellow,/turf/simulated/floor/plating,/area/mission/prefab/house/house_D03)
"YF" = (/obj/structure/interactive/lighting/fixture/bulb{dir = 1},/turf/simulated/floor/wood/brown,/area/mission/prefab/house/house_D03/hallway)
"Zv" = (/turf/simulated/wall/wood/brown,/area/mission/prefab/house/house_D03/chapple)
"Zx" = (/obj/marker/spawning/window,/turf/simulated/floor/plating,/area/mission/prefab/house/house_D03/chapple)

(1,1,1) = {"
HDHDHDFdFdFdFdFdFdFdHDHDTSTSanTS
HDbrbrbrGjsiVAwrCQFdTSTSTSqEaaDK
HDbrlUxyGiaqqQFvFvFdabaHELELELTS
HDbraGbrsiFdvKIYFdFdaIvGZvZvQuZv
TSTSHZawpWpWHZpWBJarHZZvajOUakZv
PhjcatSrLzLzLzLzLzSrayZvuJrqacZv
TSaopWSufxlMfxANvzSrazQuZxZxHgZv
meHZpWLzadSOaBSOadLzpWpWpWpWHZal
meHZHZJQaeVDaFHAaeJQHZpWasHZaAme
cyappWSrANahwglWaESratdXdXaCdXdX
ampWazSrSrSrSrSrSrSraudXaDRDOndX
PhVIHZavYFHZpWarpWaxaAdXaQRDsHdX
TSPhamPhTSaKNJFmoYoYngdXQdvvOndX
GcLhLhaJLwafCWPcagGQAndXaQRDsHdX
GcWHWHWHoYNvNJJEdPGbAkdXglaiOndX
GcLhLhLhNJNJNJNJNJNJNJdXdXscdXdX
"}
