//MAP CONVERTED BY dmm2tgm.py THIS HEADER COMMENT PREVENTS RECONVERSION, DO NOT REMOVE
"ae" = (
/obj/structure/table/cooking/grill,
/obj/marker/spawning/random/kitchen,
/turf/simulated/floor/tile/grey,
/area/mission/prefab/house/house_D05/kitchen)
"ah" = (
/obj/structure/interactive/crate/trash,
/obj/marker/spawning/random/trash,
/turf/simulated/floor/wood/brown,
/area/mission/prefab/house/house_D05/bedroom)
"ai" = (
/obj/structure/table/reinforced/steel,
/obj/marker/spawning/random/misc,
/turf/simulated/floor/tile/grey/ish,
/area/mission/prefab/house/house_D05/kitchen)
"bP" = (
/obj/marker/map_node,
/turf/simulated/floor/tile/coldroom,
/area/mission/prefab/house/house_D05/bedroom)
"dr" = (
/obj/structure/interactive/wire/red,
/obj/marker/map_node,
/turf/simulated/floor/wood/brown,
/area/mission/prefab/house/house_D05)
"dL" = (
/obj/structure/interactive/chair/wood,
/turf/simulated/floor/wood/brown,
/area/mission/prefab/house/house_D05/kitchen)
"er" = (
/obj/structure/interactive/chair/stool/bar,
/turf/simulated/floor/wood/brown,
/area/mission/prefab/house/house_D05/kitchen)
"ez" = (
/obj/structure/interactive/potted_plant/office,
/obj/structure/carpet/blue,
/turf/simulated/floor/wood/brown,
/area/mission/prefab/house/house_D05/hall)
"fq" = (
/turf/simulated/wall/wood/brown,
/area/mission/prefab/house/house_D05/closet)
"fS" = (
/obj/structure/interactive/chair,
/obj/marker/map_node,
/turf/simulated/floor/tile/grey,
/area/dmm_suite/clear_area)
"gd" = (
/obj/structure/table/reinforced/steel,
/obj/structure/interactive/lighting/fixture/bulb{
	icon_state = "preview";
	dir = 8
	},
/turf/simulated/floor/tile/grey/ish,
/area/mission/prefab/house/house_D05/kitchen)
"hm" = (
/obj/structure/interactive/lighting/fixture/bulb{
	icon_state = "preview";
	dir = 4
	},
/turf/simulated/floor/wood/brown,
/area/mission/prefab/house/house_D05/hall)
"hz" = (
/turf/simulated/floor/tile/grey,
/area/dmm_suite/clear_area)
"hU" = (
/obj/structure/interactive/door/airlock/station,
/turf/simulated/floor/wood/brown,
/area/mission/prefab/house/house_D05/kitchen)
"iN" = (
/obj/structure/table/cooking/grill,
/obj/marker/spawning/random/food,
/turf/simulated/floor/tile/grey,
/area/mission/prefab/house/house_D05/kitchen)
"iP" = (
/obj/structure/table/reinforced/steel,
/obj/marker/spawning/random/food,
/turf/simulated/floor/tile/grey,
/area/mission/prefab/house/house_D05/kitchen)
"jn" = (
/obj/structure/interactive/door/airlock/wood,
/turf/simulated/floor/wood/brown,
/area/mission/prefab/house/house_D05/closet)
"kp" = (
/obj/structure/interactive/lighting/fixture/bulb{
	icon_state = "preview";
	dir = 8
	},
/turf/simulated/floor/wood/brown,
/area/mission/prefab/house/house_D05/hall)
"kr" = (
/turf/simulated/floor/tile/grey/ish,
/area/mission/prefab/house/house_D05/hall)
"li" = (
/obj/marker/map_node,
/turf/simulated/floor/wood/brown,
/area/mission/prefab/house/house_D05/kitchen)
"ll" = (
/obj/structure/table/wood,
/obj/structure/carpet/blue,
/obj/marker/spawning/random/misc,
/turf/simulated/floor/wood/brown,
/area/mission/prefab/house/house_D05/hall)
"mL" = (
/obj/structure/table/reinforced/steel,
/turf/simulated/floor/tile/grey/ish,
/area/mission/prefab/house/house_D05/kitchen)
"no" = (
/obj/marker/map_node,
/turf/simulated/floor/tile/grey/ish,
/area/mission/prefab/house/house_D05/hall)
"pa" = (
/obj/structure/interactive/power/smes{
	dir = 1
	},
/obj/structure/interactive/wire/red,
/turf/simulated/floor/plating,
/area/mission/prefab/house/house_D05)
"pb" = (
/obj/structure/interactive/wire/red,
/turf/simulated/wall/wood/brown,
/area/mission/prefab/house/house_D05)
"pR" = (
/obj/structure/interactive/misc/sink{
	icon_state = "sink";
	dir = 8
	},
/turf/simulated/floor/tile/coldroom,
/area/mission/prefab/house/house_D05/bedroom)
"pU" = (
/obj/structure/interactive/barricade,
/obj/structure/interactive/barricade{
	dir = 4
	},
/turf/simulated/floor/tile/grey,
/area/dmm_suite/clear_area)
"qd" = (
/obj/structure/interactive/chair/wood{
	icon_state = "wooden_chair";
	dir = 4
	},
/turf/simulated/floor/wood/brown,
/area/mission/prefab/house/house_D05/bedroom)
"qr" = (
/turf/simulated/floor/wood/brown/dark,
/area/mission/prefab/house/house_D05/closet)
"qW" = (
/turf/simulated/floor/tile/grey/ish,
/area/mission/prefab/house/house_D05/kitchen)
"sH" = (
/obj/structure/interactive/crate/trash,
/obj/marker/spawning/random/trash,
/turf/simulated/floor/tile/grey/ish,
/area/mission/prefab/house/house_D05/hall)
"sT" = (
/turf/simulated/wall/wood/brown,
/area/mission/prefab/house/house_D05/bedroom)
"tx" = (
/obj/structure/interactive/light_switch,
/turf/simulated/wall/wood/brown,
/area/mission/prefab/house/house_D05/kitchen)
"tE" = (
/obj/structure/interactive/barricade,
/turf/simulated/floor/tile/grey,
/area/dmm_suite/clear_area)
"uP" = (
/obj/structure/interactive/chair/wood{
	icon_state = "wooden_chair";
	dir = 8
	},
/turf/simulated/floor/wood/brown,
/area/mission/prefab/house/house_D05/kitchen)
"uW" = (
/turf/simulated/wall/wood/brown,
/area/mission/prefab/house/house_D05)
"vc" = (
/obj/structure/interactive/crate/trash,
/obj/marker/spawning/random/trash,
/turf/simulated/floor/tile/grey/ish,
/area/mission/prefab/house/house_D05/kitchen)
"vo" = (
/obj/structure/interactive/door/airlock/station,
/turf/simulated/floor/tile/coldroom,
/area/mission/prefab/house/house_D05)
"vs" = (
/obj/structure/interactive/bed,
/obj/structure/carpet/red,
/turf/simulated/floor/wood/brown,
/area/mission/prefab/house/house_D05/bedroom)
"vM" = (
/obj/structure/interactive/lighting/fixture/bulb{
	icon_state = "preview";
	dir = 1
	},
/obj/structure/interactive/potted_plant/office,
/turf/simulated/floor/wood/brown,
/area/mission/prefab/house/house_D05/kitchen)
"vZ" = (
/obj/structure/carpet/red,
/mob/living/advanced/npc/survivor{
	icon_state = "directional";
	dir = 4
	},
/turf/simulated/floor/wood/brown,
/area/mission/prefab/house/house_D05/bedroom)
"wJ" = (
/obj/structure/interactive/crate/closet,
/obj/marker/spawning/random/valuable,
/turf/simulated/floor/wood/brown/dark,
/area/mission/prefab/house/house_D05/closet)
"xj" = (
/obj/structure/carpet/blue,
/turf/simulated/floor/wood/brown,
/area/mission/prefab/house/house_D05/hall)
"xw" = (
/turf/simulated/floor/tile/grey,
/area/mission/prefab/house/house_D05/kitchen)
"xF" = (
/obj/structure/table/wood,
/obj/structure/interactive/storage/ammo_pile,
/obj/structure/interactive/lighting/fixture/bulb{
	icon_state = "preview";
	dir = 4
	},
/turf/simulated/floor/wood/brown,
/area/mission/prefab/house/house_D05/kitchen)
"yq" = (
/obj/structure/interactive/lighting/fixture/bulb{
	icon_state = "preview";
	dir = 8
	},
/obj/structure/interactive/misc/toilet,
/turf/simulated/floor/tile/coldroom,
/area/mission/prefab/house/house_D05/bedroom)
"zg" = (
/turf/simulated/floor/plating,
/area/mission/prefab/house/house_D05)
"zv" = (
/obj/marker/spawning/window,
/turf/simulated/floor/plating,
/area/mission/prefab/house/house_D05/hall)
"Bm" = (
/obj/structure/interactive/lighting/fixture/bulb{
	icon_state = "preview";
	dir = 1
	},
/turf/simulated/floor/wood/brown,
/area/mission/prefab/house/house_D05/bedroom)
"BC" = (
/turf/simulated/floor/wood/brown,
/area/mission/prefab/house/house_D05/kitchen)
"BN" = (
/obj/structure/interactive/potted_plant/nanotrasen,
/obj/structure/carpet/red,
/turf/simulated/floor/wood/brown,
/area/mission/prefab/house/house_D05/bedroom)
"CA" = (
/obj/structure/table/reinforced/steel,
/obj/marker/spawning/random/kitchen,
/turf/simulated/floor/tile/grey/ish,
/area/mission/prefab/house/house_D05/kitchen)
"CT" = (
/obj/structure/interactive/lighting/fixture/bulb,
/obj/structure/interactive/potted_plant/nanotrasen,
/turf/simulated/floor/wood/brown,
/area/mission/prefab/house/house_D05/hall)
"Ey" = (
/obj/structure/carpet/red,
/turf/simulated/floor/wood/brown,
/area/mission/prefab/house/house_D05/bedroom)
"EE" = (
/obj/structure/interactive/power/apc,
/turf/simulated/wall/wood/brown,
/area/mission/prefab/house/house_D05)
"EF" = (
/obj/structure/interactive/chair/comfy{
	icon_state = "comfychair";
	dir = 1
	},
/obj/structure/carpet/blue,
/turf/simulated/floor/wood/brown,
/area/mission/prefab/house/house_D05/hall)
"Fm" = (
/obj/structure/interactive/misc/tv,
/obj/structure/table/wood,
/turf/simulated/floor/wood/brown,
/area/mission/prefab/house/house_D05/kitchen)
"Fs" = (
/obj/structure/interactive/chair,
/mob/living/advanced/npc/survivor,
/turf/simulated/floor/tile/grey,
/area/dmm_suite/clear_area)
"FI" = (
/obj/structure/interactive/wire/red,
/obj/structure/interactive/potted_plant/bin,
/turf/simulated/floor/wood/brown,
/area/mission/prefab/house/house_D05)
"GT" = (
/obj/structure/interactive/misc/tv,
/obj/structure/table/wood,
/obj/structure/carpet/blue,
/turf/simulated/floor/wood/brown,
/area/mission/prefab/house/house_D05/hall)
"Hq" = (
/obj/structure/interactive/door/airlock/station,
/turf/simulated/floor/tile/grey/ish,
/area/mission/prefab/house/house_D05/hall)
"Hx" = (
/obj/structure/carpet/red,
/obj/marker/map_node,
/turf/simulated/floor/wood/brown,
/area/mission/prefab/house/house_D05/bedroom)
"HL" = (
/obj/structure/table/wood,
/obj/marker/spawning/random/misc,
/turf/simulated/floor/tile/grey/ish,
/area/mission/prefab/house/house_D05/hall)
"HT" = (
/obj/structure/interactive/crate/closet,
/obj/marker/spawning/random/valuable,
/turf/simulated/floor/wood/brown,
/area/mission/prefab/house/house_D05/hall)
"Il" = (
/obj/structure/interactive/wire/yellow,
/turf/simulated/floor/plating,
/area/mission/prefab/house/house_D05)
"Io" = (
/turf/simulated/wall/wood/brown,
/area/mission/prefab/house/house_D05/hall)
"IJ" = (
/obj/structure/interactive/lighting/fixture/bulb{
	icon_state = "preview";
	dir = 8
	},
/obj/marker/map_node,
/mob/living/advanced/npc/survivor{
	icon_state = "directional";
	dir = 8
	},
/turf/simulated/floor/wood/brown/dark,
/area/mission/prefab/house/house_D05/closet)
"Jo" = (
/obj/structure/interactive/crate/closet/freezer,
/obj/marker/spawning/random/food,
/turf/simulated/floor/tile/grey/ish,
/area/mission/prefab/house/house_D05/kitchen)
"JC" = (
/obj/structure/carpet/blue,
/obj/structure/interactive/bookcase,
/turf/simulated/floor/wood/brown,
/area/mission/prefab/house/house_D05/hall)
"JV" = (
/obj/structure/table/steel,
/turf/simulated/floor/tile/grey,
/area/dmm_suite/clear_area)
"Kd" = (
/obj/structure/table/wood,
/obj/structure/interactive/storage/ammo_pile,
/turf/simulated/floor/wood/brown,
/area/mission/prefab/house/house_D05/bedroom)
"KS" = (
/obj/structure/interactive/lighting/fixture/bulb,
/turf/simulated/floor/wood/brown,
/area/mission/prefab/house/house_D05/kitchen)
"LY" = (
/obj/structure/table/wood,
/obj/marker/spawning/random/misc,
/turf/simulated/floor/wood/brown,
/area/mission/prefab/house/house_D05/kitchen)
"LZ" = (
/turf/simulated/floor/stair/wood{
	dir = 4
	},
/area/mission/prefab/house/house_D05/kitchen)
"Mt" = (
/obj/structure/interactive/lighting/fixture/bulb,
/turf/simulated/floor/tile/grey,
/area/dmm_suite/clear_area)
"Nl" = (
/obj/structure/interactive/crate/closet,
/obj/marker/spawning/random/misc,
/turf/simulated/floor/wood/brown,
/area/mission/prefab/house/house_D05/bedroom)
"NC" = (
/obj/structure/interactive/chair/comfy{
	icon_state = "comfychair";
	dir = 1
	},
/obj/structure/carpet/blue,
/mob/living/advanced/npc/survivor{
	dir = 1
	},
/turf/simulated/floor/wood/brown,
/area/mission/prefab/house/house_D05/hall)
"NO" = (
/obj/structure/interactive/potted_plant/office,
/turf/simulated/wall/wood/brown,
/area/mission/prefab/house/house_D05/hall)
"Oh" = (
/obj/structure/interactive/barricade{
	dir = 8
	},
/turf/simulated/floor/tile/grey,
/area/dmm_suite/clear_area)
"Os" = (
/obj/marker/map_node,
/turf/simulated/floor/wood/brown,
/area/mission/prefab/house/house_D05/hall)
"OB" = (
/turf/dmm_suite/no_wall,
/area/dmm_suite/clear_area)
"PI" = (
/turf/simulated/wall/wood/brown,
/area/mission/prefab/house/house_D05/kitchen)
"PJ" = (
/obj/structure/interactive/chair/wood,
/mob/living/advanced/npc/survivor,
/turf/simulated/floor/wood/brown,
/area/mission/prefab/house/house_D05/kitchen)
"QV" = (
/obj/structure/interactive/door/airlock/wood,
/turf/simulated/floor/wood/brown,
/area/mission/prefab/house/house_D05/kitchen)
"Rq" = (
/obj/structure/interactive/solar_panel,
/obj/structure/interactive/wire/yellow,
/turf/simulated/floor/plating,
/area/mission/prefab/house/house_D05)
"RA" = (
/obj/structure/table/wood,
/obj/marker/spawning/random/misc,
/turf/simulated/floor/wood/brown,
/area/mission/prefab/house/house_D05/bedroom)
"RJ" = (
/obj/structure/interactive/lighting/fixture/bulb,
/obj/structure/table/wood,
/obj/marker/spawning/random/misc,
/obj/structure/carpet/red,
/turf/simulated/floor/wood/brown,
/area/mission/prefab/house/house_D05/bedroom)
"RV" = (
/obj/marker/spawning/window,
/turf/simulated/floor/plating,
/area/mission/prefab/house/house_D05/kitchen)
"Su" = (
/obj/structure/interactive/crate/trash,
/obj/marker/spawning/random/trash,
/turf/simulated/floor/tile/coldroom,
/area/mission/prefab/house/house_D05/bedroom)
"SM" = (
/turf/simulated/floor/stair{
	dir = 8
	},
/area/dmm_suite/clear_area)
"Uq" = (
/turf/simulated/floor/wood/brown,
/area/mission/prefab/house/house_D05/bedroom)
"Uy" = (
/obj/structure/interactive/barricade{
	dir = 8
	},
/obj/structure/interactive/barricade,
/turf/simulated/floor/tile/grey,
/area/dmm_suite/clear_area)
"UN" = (
/obj/structure/interactive/light_switch{
	dir = 1
	},
/turf/simulated/wall/wood/brown,
/area/mission/prefab/house/house_D05/closet)
"WT" = (
/obj/marker/spawning/window,
/turf/simulated/floor/plating,
/area/mission/prefab/house/house_D05/bedroom)
"Xr" = (
/obj/structure/interactive/lighting/fireplace/fire03,
/turf/simulated/floor/wood/brown,
/area/mission/prefab/house/house_D05/kitchen)
"XI" = (
/turf/simulated/floor/wood/brown,
/area/mission/prefab/house/house_D05/hall)
"Yt" = (
/obj/structure/interactive/light_switch,
/turf/simulated/wall/wood/brown,
/area/mission/prefab/house/house_D05/bedroom)
"YR" = (
/obj/structure/interactive/light_switch{
	icon_state = "setup";
	dir = 4
	},
/turf/simulated/wall/wood/brown,
/area/mission/prefab/house/house_D05/hall)
"Zv" = (
/obj/structure/interactive/light_switch{
	icon_state = "setup";
	dir = 8
	},
/turf/simulated/wall/wood/brown,
/area/mission/prefab/house/house_D05/bedroom)

(1,1,1) = {"
sT
sT
WT
WT
WT
sT
sT
Io
Io
Io
Io
YR
Io
Io
Io
Io
"}
(2,1,1) = {"
sT
Nl
Uq
Uq
Uq
ah
sT
ez
xj
NC
xj
XI
hm
HL
HL
zv
"}
(3,1,1) = {"
Yt
BN
Ey
vZ
Ey
Uq
sT
GT
xj
ll
xj
XI
XI
kr
sH
Io
"}
(4,1,1) = {"
sT
vs
Hx
Ey
Hx
Bm
sT
JC
xj
EF
xj
XI
XI
no
kr
Hq
"}
(5,1,1) = {"
sT
vs
Ey
Ey
Ey
qd
sT
JC
xj
xj
xj
kp
XI
kr
kr
Io
"}
(6,1,1) = {"
sT
RJ
Ey
Ey
Ey
Kd
sT
CT
XI
Os
Io
Io
zv
zv
NO
Io
"}
(7,1,1) = {"
sT
Nl
Uq
Uq
Uq
RA
sT
HT
XI
XI
Io
OB
OB
OB
OB
OB
"}
(8,1,1) = {"
fq
fq
jn
PI
QV
PI
PI
PI
LZ
LZ
PI
PI
OB
OB
OB
OB
"}
(9,1,1) = {"
fq
wJ
qr
tx
BC
dL
xF
LY
BC
BC
Fm
RV
Oh
Oh
Uy
OB
"}
(10,1,1) = {"
fq
wJ
IJ
UN
KS
PJ
LY
LY
BC
BC
Fm
RV
hz
Fs
tE
OB
"}
(11,1,1) = {"
sT
sT
sT
EE
dr
BC
BC
uP
BC
li
vM
PI
Mt
JV
tE
OB
"}
(12,1,1) = {"
sT
pR
bP
vo
dr
BC
er
er
er
li
BC
hU
hz
fS
tE
OB
"}
(13,1,1) = {"
sT
yq
Su
pb
FI
BC
ai
iP
mL
xw
vc
tx
hz
hz
tE
OB
"}
(14,1,1) = {"
sT
sT
Zv
pb
Xr
BC
xw
qW
xw
qW
xw
RV
SM
SM
tE
OB
"}
(15,1,1) = {"
zg
Il
pa
pb
BC
BC
CA
ae
gd
iN
Jo
RV
OB
OB
pU
OB
"}
(16,1,1) = {"
Rq
Rq
Rq
uW
RV
RV
PI
PI
PI
PI
PI
PI
OB
OB
OB
OB
"}
