"a" = (/turf/simulated/wall/metal/reinforced/syndicate,/area/mission/prefab/vault/vault_01)
"b" = (/obj/structure/table/reinforced/steel/dark,/obj/marker/spawning/random/vault_loot/secure,/turf/simulated/floor/plating/syndicate,/area/mission/prefab/vault/vault_01)
"c" = (/obj/structure/table/reinforced/steel/dark,/obj/structure/interactive/lighting/fixture/tube/syndicate,/obj/marker/spawning/random/vault_loot/secure,/turf/simulated/floor/plating/syndicate,/area/mission/prefab/vault/vault_01)
"d" = (/obj/marker/spawning/window/reinforced,/turf/simulated/floor/plating/syndicate,/area/mission/prefab/vault/vault_01)
"e" = (/obj/structure/table/reinforced/steel/dark,/obj/marker/spawning/random/vault_loot,/turf/simulated/floor/plating/syndicate,/area/mission/prefab/vault/vault_01)
"f" = (/turf/simulated/floor/plating/syndicate,/area/mission/prefab/vault/vault_01)
"g" = (/obj/structure/table/reinforced/steel/dark,/obj/structure/interactive/lighting/fixture/tube/syndicate{icon_state = "preview"; dir = 4},/obj/marker/spawning/random/vault_loot,/turf/simulated/floor/plating/syndicate,/area/mission/prefab/vault/vault_01)
"h" = (/obj/structure/table/reinforced/steel/dark,/obj/structure/interactive/lighting/fixture/tube/syndicate{icon_state = "preview"; dir = 8},/obj/marker/spawning/random/vault_loot,/turf/simulated/floor/plating/syndicate,/area/mission/prefab/vault/vault_01)
"i" = (/obj/structure/interactive/power/apc{icon_state = "apc"; dir = 4},/turf/simulated/wall/metal/reinforced/syndicate,/area/mission/prefab/vault/vault_01)
"j" = (/obj/structure/interactive/wire/red,/turf/simulated/floor/plating/syndicate,/area/mission/prefab/vault/vault_01)
"k" = (/obj/structure/interactive/door/vault/syndicate,/turf/simulated/floor/plating/syndicate,/area/mission/prefab/vault/vault_01)
"l" = (/mob/living/simple/turret/syndicate,/turf/simulated/floor/plating/syndicate,/area/mission/prefab/vault/vault_01)
"m" = (/obj/structure/interactive/lighting/fixture/floor/syndicate,/turf/simulated/floor/plating/syndicate,/area/mission/prefab/vault/vault_01)
"n" = (/turf/dmm_suite/clear_turf,/area/dmm_suite/clear_area)
"o" = (/turf/dmm_suite/no_wall,/area/dmm_suite/clear_area)
"p" = (/obj/structure/interactive/light_switch{icon_state = "setup"; dir = 8},/turf/simulated/wall/metal/reinforced/syndicate,/area/mission/prefab/vault/vault_01)
"q" = (/obj/marker/map_node,/turf/simulated/floor/plating/syndicate,/area/mission/prefab/vault/vault_01)
"r" = (/obj/structure/interactive/wire/red,/obj/marker/map_node,/turf/simulated/floor/plating/syndicate,/area/mission/prefab/vault/vault_01)
"s" = (/obj/marker/map_node,/turf/dmm_suite/no_wall,/area/dmm_suite/clear_area)

(1,1,1) = {"
nnnaaaaann
nnnabcbann
nnnadddann
nnnaeqeann
nnnagfhann
nnnaefeann
nnnijrjpnn
nnoaakaaon
nnolmqmlon
nnooosooon
"}
