//MAP CONVERTED BY dmm2tgm.py THIS HEADER COMMENT PREVENTS RECONVERSION, DO NOT REMOVE
"a" = (
/turf/dmm_suite/clear_turf,
/area/dmm_suite/clear_area)
"b" = (
/turf/simulated/wall/metal/reinforced/syndicate,
/area/mission/prefab/vault/vault_02)
"c" = (
/obj/structure/table/reinforced/steel/dark,
/obj/marker/spawning/random/vault_loot/secure,
/turf/simulated/floor/plating/syndicate,
/area/mission/prefab/vault/vault_02)
"d" = (
/obj/structure/table/reinforced/steel/dark,
/obj/structure/interactive/lighting/fixture/tube/syndicate,
/obj/marker/spawning/random/vault_loot/secure,
/turf/simulated/floor/plating/syndicate,
/area/mission/prefab/vault/vault_02)
"e" = (
/obj/marker/spawning/window/reinforced,
/turf/simulated/floor/plating/syndicate,
/area/mission/prefab/vault/vault_02)
"f" = (
/obj/structure/table/reinforced/steel/dark,
/obj/marker/spawning/random/vault_loot,
/turf/simulated/floor/plating/syndicate,
/area/mission/prefab/vault/vault_02)
"g" = (
/turf/simulated/floor/plating/syndicate,
/area/mission/prefab/vault/vault_02)
"h" = (
/obj/structure/table/reinforced/steel/dark,
/obj/structure/interactive/lighting/fixture/tube/syndicate{
	icon_state = "preview";
	dir = 4
	},
/obj/marker/spawning/random/vault_loot,
/turf/simulated/floor/plating/syndicate,
/area/mission/prefab/vault/vault_02)
"i" = (
/obj/structure/table/reinforced/steel/dark,
/obj/structure/interactive/lighting/fixture/tube/syndicate{
	icon_state = "preview";
	dir = 8
	},
/obj/marker/spawning/random/vault_loot,
/turf/simulated/floor/plating/syndicate,
/area/mission/prefab/vault/vault_02)
"j" = (
/turf/simulated/wall/brick/grey,
/area/dmm_suite/clear_area)
"k" = (
/obj/structure/interactive/power/apc{
	icon_state = "apc";
	dir = 4
	},
/turf/simulated/wall/metal/reinforced/syndicate,
/area/mission/prefab/vault/vault_02)
"l" = (
/turf/dmm_suite/no_wall,
/area/dmm_suite/clear_area)
"m" = (
/obj/structure/interactive/wire/red,
/turf/simulated/floor/plating/syndicate,
/area/mission/prefab/vault/vault_02)
"n" = (
/obj/structure/interactive/light_switch{
	icon_state = "setup";
	dir = 8
	},
/turf/simulated/wall/metal/reinforced/syndicate,
/area/mission/prefab/vault/vault_02)
"o" = (
/obj/structure/interactive/door/vault/syndicate,
/turf/simulated/floor/plating/syndicate,
/area/mission/prefab/vault/vault_02)
"p" = (
/mob/living/simple/turret/syndicate,
/turf/simulated/floor/plating/syndicate,
/area/mission/prefab/vault/vault_02)
"q" = (
/obj/structure/interactive/lighting/fixture/floor/syndicate,
/turf/simulated/floor/plating/syndicate,
/area/mission/prefab/vault/vault_02)
"r" = (
/obj/marker/map_node,
/turf/simulated/floor/plating/syndicate,
/area/mission/prefab/vault/vault_02)
"s" = (
/obj/structure/interactive/wire/red,
/obj/marker/map_node,
/turf/simulated/floor/plating/syndicate,
/area/mission/prefab/vault/vault_02)
"t" = (
/obj/marker/map_node,
/turf/dmm_suite/no_wall,
/area/dmm_suite/clear_area)

(1,1,1) = {"
a
a
a
a
a
a
a
a
a
a
"}
(2,1,1) = {"
a
a
a
a
a
a
a
a
a
a
"}
(3,1,1) = {"
a
a
a
a
a
a
a
l
l
l
"}
(4,1,1) = {"
b
b
b
b
b
j
k
b
p
l
"}
(5,1,1) = {"
b
c
e
f
h
f
m
b
q
l
"}
(6,1,1) = {"
b
d
e
r
g
g
s
o
r
t
"}
(7,1,1) = {"
b
c
e
f
i
f
m
b
q
l
"}
(8,1,1) = {"
b
b
b
b
b
b
n
b
p
l
"}
(9,1,1) = {"
a
a
a
a
a
a
a
l
l
l
"}
(10,1,1) = {"
a
a
a
a
a
a
a
a
a
a
"}
