"a" = (/turf/dmm_suite/clear_turf,/area/dmm_suite/clear_area)
"b" = (/turf/simulated/wall/metal/reinforced/syndicate,/area/mission/prefab/vault/vault_10)
"c" = (/obj/structure/table/reinforced/steel/dark,/obj/marker/spawning/random/vault_loot/secure,/turf/simulated/floor/plating/syndicate,/area/mission/prefab/vault/vault_10)
"d" = (/obj/structure/table/reinforced/steel/dark,/obj/structure/interactive/lighting/fixture/tube/syndicate,/obj/marker/spawning/random/vault_loot/secure,/turf/simulated/floor/plating/syndicate,/area/mission/prefab/vault/vault_10)
"e" = (/obj/marker/spawning/window/reinforced,/turf/simulated/floor/plating/syndicate,/area/mission/prefab/vault/vault_10)
"f" = (/obj/structure/table/reinforced/steel/dark,/obj/marker/spawning/random/vault_loot,/turf/simulated/floor/plating/syndicate,/area/mission/prefab/vault/vault_10)
"g" = (/turf/simulated/floor/plating/syndicate,/area/mission/prefab/vault/vault_10)
"h" = (/obj/structure/table/reinforced/steel/dark,/obj/structure/interactive/lighting/fixture/tube/syndicate{icon_state = "preview"; dir = 4},/obj/marker/spawning/random/vault_loot,/turf/simulated/floor/plating/syndicate,/area/mission/prefab/vault/vault_10)
"i" = (/obj/structure/table/reinforced/steel/dark,/obj/structure/interactive/lighting/fixture/tube/syndicate{icon_state = "preview"; dir = 8},/obj/marker/spawning/random/vault_loot,/turf/simulated/floor/plating/syndicate,/area/mission/prefab/vault/vault_10)
"j" = (/obj/structure/interactive/power/apc{icon_state = "apc"; dir = 4},/turf/simulated/wall/metal/reinforced/syndicate,/area/mission/prefab/vault/vault_10)
"k" = (/obj/structure/interactive/wire/red,/turf/simulated/floor/plating/syndicate,/area/mission/prefab/vault/vault_10)
"l" = (/turf/dmm_suite/no_wall,/area/dmm_suite/clear_area)
"m" = (/obj/structure/interactive/door/vault/syndicate,/turf/simulated/floor/plating/syndicate,/area/mission/prefab/vault/vault_10)
"n" = (/mob/living/simple/turret/syndicate,/turf/simulated/floor/plating/syndicate,/area/mission/prefab/vault/vault_10)
"o" = (/obj/structure/interactive/lighting/fixture/floor/syndicate,/turf/simulated/floor/plating/syndicate,/area/mission/prefab/vault/vault_10)
"p" = (/obj/structure/interactive/light_switch{icon_state = "setup"; dir = 8},/turf/simulated/wall/metal/reinforced/syndicate,/area/mission/prefab/vault/vault_10)
"q" = (/obj/marker/map_node,/turf/simulated/floor/plating/syndicate,/area/mission/prefab/vault/vault_10)
"r" = (/obj/structure/interactive/wire/red,/obj/marker/map_node,/turf/simulated/floor/plating/syndicate,/area/mission/prefab/vault/vault_10)
"s" = (/obj/marker/map_node,/turf/dmm_suite/no_wall,/area/dmm_suite/clear_area)

(1,1,1) = {"
aaabbbbbaa
aaabcdcbaa
aaabeeebaa
aaabfqfbaa
aaabhgibaa
aaabfgfbaa
aaajkrkpaa
aalbbmbbla
aalnoqonla
aalllsllla
"}
