"aE" = (/obj/structure/interactive/misc/computer1,/obj/structure/table/reinforced/steel/dark,/turf/simulated/floor/plating/reinforced,/area/mission/prefab/vault/vault_11)
"dr" = (/obj/structure/interactive/lighting/fixture/tube/syndicate,/turf/simulated/floor/tile/dark/er,/area/mission/prefab/vault/vault_11)
"dL" = (/obj/structure/interactive/intercom,/turf/simulated/wall/metal/reinforced/syndicate,/area/mission/prefab/vault/vault_11)
"en" = (/obj/structure/interactive/door/airlock/dark,/obj/structure/interactive/wire/red,/turf/simulated/floor/tile/dark/er,/area/mission/prefab/vault/vault_11)
"eE" = (/turf/simulated/floor/plating/syndicate,/area/mission/prefab/vault/vault_11)
"eQ" = (/obj/structure/table/reinforced/steel/dark,/obj/structure/interactive/computer/console/laptop,/turf/simulated/floor/tile/dark/er,/area/mission/prefab/vault/vault_11)
"eV" = (/obj/structure/interactive/vending/hydroponics/seeds,/obj/structure/interactive/wire/red,/turf/simulated/floor/tile/dark/er,/area/mission/prefab/vault/vault_11)
"fh" = (/obj/structure/table/reinforced/steel/dark,/turf/simulated/floor/tile/dark/er,/area/mission/prefab/vault/vault_11)
"ga" = (/obj/marker/spawning/window/extra,/turf/simulated/floor/plating/reinforced,/area/mission/prefab/vault/vault_11)
"gb" = (/obj/marker/spawning/random/vault_loot,/obj/structure/table/reinforced/steel/dark,/obj/structure/interactive/wire/red,/obj/structure/interactive/lighting/fixture/tube/syndicate{icon_state = "preview"; dir = 4},/turf/simulated/floor/plating/reinforced,/area/mission/prefab/vault/vault_11)
"gd" = (/obj/structure/interactive/power/apc{icon_state = "apc"; dir = 4},/turf/simulated/wall/metal/reinforced/syndicate,/area/mission/prefab/vault/vault_11)
"gR" = (/obj/structure/interactive/door/airlock/locked,/obj/structure/interactive/wire/red,/turf/simulated/floor/plating/reinforced,/area/mission/prefab/vault/vault_11)
"jd" = (/obj/structure/interactive/lighting/fixture/tube/syndicate{icon_state = "preview"; dir = 8},/turf/simulated/floor/tile/dark/er,/area/mission/prefab/vault/vault_11)
"js" = (/obj/structure/interactive/wire/red,/turf/simulated/floor/tile/dark/er,/area/mission/prefab/vault/vault_11)
"kh" = (/obj/structure/interactive/door/vault/syndicate,/turf/simulated/floor/plating/syndicate,/area/mission/prefab/vault/vault_11)
"kj" = (/obj/structure/interactive/light_switch,/turf/simulated/wall/metal/reinforced/syndicate,/area/mission/prefab/vault/vault_11)
"kB" = (/turf/dmm_suite/no_wall,/area/dmm_suite/clear_area)
"kS" = (/mob/living/simple/turret/syndicate,/turf/simulated/floor/plating/syndicate,/area/mission/prefab/vault/vault_11)
"mL" = (/obj/structure/interactive/potted_plant/office,/turf/simulated/floor/tile/dark/er,/area/mission/prefab/vault/vault_11)
"nh" = (/obj/structure/interactive/misc/curtain_open,/obj/structure/interactive/misc/shower{dir = 1},/obj/structure/interactive/atmospherics/vent,/turf/simulated/floor/tile/dark/er,/area/mission/prefab/vault/vault_11)
"oF" = (/obj/structure/table/reinforced/steel/dark,/turf/simulated/floor/plating/reinforced,/area/mission/prefab/vault/vault_11)
"pc" = (/obj/structure/interactive/vending/medical/medicine,/obj/structure/interactive/wire/red,/turf/simulated/floor/tile/dark/er,/area/mission/prefab/vault/vault_11)
"pE" = (/obj/structure/interactive/door/airlock/dark,/obj/structure/interactive/wire/red,/turf/simulated/floor/plating/syndicate,/area/mission/prefab/vault/vault_11)
"pO" = (/obj/structure/interactive/misc/sink,/obj/structure/interactive/misc/mirror{pixel_y = 22},/turf/simulated/floor/tile/dark/er,/area/mission/prefab/vault/vault_11)
"qA" = (/obj/structure/interactive/vending/soda/solarian,/obj/structure/interactive/wire/red,/turf/simulated/floor/tile/dark/er,/area/mission/prefab/vault/vault_11)
"qS" = (/turf/simulated/wall/metal/reinforced/syndicate,/area/mission/prefab/vault/vault_11)
"rT" = (/turf/simulated/floor/tile/dark/er,/area/mission/prefab/vault/vault_11)
"sw" = (/obj/structure/interactive/chair/office/dark{dir = 4},/mob/living/advanced/npc/unique/sidorovich{dir = 4},/turf/simulated/floor/tile/dark/er,/area/mission/prefab/vault/vault_11)
"uk" = (/obj/structure/interactive/vending/medical/basic,/turf/simulated/wall/metal/reinforced/syndicate,/area/mission/prefab/vault/vault_11)
"uy" = (/obj/structure/interactive/vending/exchange,/obj/structure/interactive/wire/red,/turf/simulated/floor/tile/dark/er,/area/mission/prefab/vault/vault_11)
"vE" = (/obj/structure/interactive/lighting/fixture/tube/syndicate{dir = 4},/obj/structure/interactive/crate/closet/anchored,/turf/simulated/floor/tile/dark/er,/area/mission/prefab/vault/vault_11)
"vP" = (/turf/dmm_suite/clear_turf,/area/dmm_suite/clear_area)
"ze" = (/obj/structure/interactive/vending/medical/equipment,/obj/structure/interactive/wire/red,/turf/simulated/floor/tile/dark/er,/area/mission/prefab/vault/vault_11)
"Ay" = (/obj/structure/interactive/reagent_tank/barrel/water,/turf/simulated/floor/tile/dark/er,/area/mission/prefab/vault/vault_11)
"CQ" = (/obj/structure/interactive/chair{dir = 8},/turf/simulated/floor/tile/dark/er,/area/mission/prefab/vault/vault_11)
"Db" = (/obj/structure/interactive/vending/junk/solarian,/obj/structure/interactive/wire/red,/turf/simulated/floor/tile/dark/er,/area/mission/prefab/vault/vault_11)
"Dl" = (/turf/simulated/floor/plating/reinforced,/area/mission/prefab/vault/vault_11)
"Fw" = (/obj/structure/interactive/wire/red,/obj/structure/interactive/door/airlock/dark,/turf/simulated/floor/tile/dark/er,/area/mission/prefab/vault/vault_11)
"HO" = (/obj/structure/interactive/lighting/fixture/floor/syndicate,/turf/simulated/floor/plating/syndicate,/area/mission/prefab/vault/vault_11)
"JP" = (/obj/marker/spawning/random/vault_loot,/obj/structure/table/reinforced/steel/dark,/obj/structure/interactive/wire/red,/obj/structure/interactive/lighting/fixture/tube/syndicate{dir = 8},/turf/simulated/floor/plating/reinforced,/area/mission/prefab/vault/vault_11)
"JQ" = (/obj/structure/interactive/lighting/fixture/tube/syndicate{icon_state = "preview"; dir = 8},/obj/structure/interactive/misc/yashik,/turf/simulated/floor/tile/dark/er,/area/mission/prefab/vault/vault_11)
"Lf" = (/obj/marker/spawning/random/vault_loot,/obj/structure/table/reinforced/steel/dark,/turf/simulated/floor/plating/reinforced,/area/mission/prefab/vault/vault_11)
"Nq" = (/obj/marker/spawning/window/reinforced,/turf/simulated/floor/tile/dark/er,/area/mission/prefab/vault/vault_11)
"NF" = (/obj/structure/interactive/bed/sleeper/medical/syndicate,/obj/structure/interactive/wire/red,/turf/simulated/floor/tile/dark/er,/area/mission/prefab/vault/vault_11)
"Rc" = (/obj/structure/interactive/lighting/fixture/tube/syndicate{dir = 8},/obj/structure/interactive/potted_plant/office,/turf/simulated/floor/tile/dark/er,/area/mission/prefab/vault/vault_11)
"RU" = (/obj/structure/interactive/light_switch{icon_state = "setup"; dir = 8},/turf/simulated/wall/metal/reinforced/syndicate,/area/mission/prefab/vault/vault_11)
"SO" = (/obj/structure/interactive/lighting/fixture/tube/syndicate{dir = 1},/obj/structure/interactive/crate/closet/anchored,/turf/simulated/floor/tile/dark/er,/area/mission/prefab/vault/vault_11)
"SS" = (/turf/simulated/floor/colored/dirt/soil/rich,/area/mission/prefab/vault/vault_11)
"Ta" = (/obj/structure/interactive/misc/dresser,/turf/simulated/floor/tile/dark/er,/area/mission/prefab/vault/vault_11)
"TV" = (/obj/structure/interactive/crate/trash,/turf/simulated/floor/tile/dark/er,/area/mission/prefab/vault/vault_11)
"Uj" = (/obj/structure/interactive/misc/toilet,/turf/simulated/floor/tile/dark/er,/area/mission/prefab/vault/vault_11)
"Uq" = (/obj/structure/interactive/lighting/fixture/tube/syndicate{icon_state = "preview"; dir = 4},/turf/simulated/floor/tile/dark/er,/area/mission/prefab/vault/vault_11)
"UD" = (/obj/structure/interactive/lighting/fixture/tube/syndicate{dir = 1},/turf/simulated/floor/tile/dark/er,/area/mission/prefab/vault/vault_11)
"Vp" = (/obj/structure/table/rack/steel,/obj/item/supply_remote/crates/slavic,/turf/simulated/floor/tile/dark/er,/area/mission/prefab/vault/vault_11)
"Wk" = (/obj/structure/interactive/wire/red,/turf/simulated/floor/plating/reinforced,/area/mission/prefab/vault/vault_11)
"WJ" = (/obj/structure/interactive/misc/big_yashik,/turf/simulated/floor/tile/dark/er,/area/mission/prefab/vault/vault_11)
"XQ" = (/obj/structure/interactive/lighting/fixture/tube/syndicate{dir = 1},/turf/simulated/floor/plating/reinforced,/area/mission/prefab/vault/vault_11)
"XV" = (/obj/marker/spawning/random/vault_loot/secure,/obj/structure/table/reinforced/steel/dark,/turf/simulated/floor/plating/reinforced,/area/mission/prefab/vault/vault_11)
"YN" = (/obj/structure/interactive/atm,/turf/simulated/wall/metal/reinforced/syndicate,/area/mission/prefab/vault/vault_11)
"ZQ" = (/obj/structure/interactive/lighting/fixture/tube/syndicate{dir = 4},/turf/simulated/floor/colored/dirt/soil/rich,/area/mission/prefab/vault/vault_11)

(1,1,1) = {"
vPvPvPvPvPvPvPvPvPvPvPvPvPvPvPvPvPvPvPvPvPvPvPvP
vPvPvPvPvPvPvPqSqSqSqSqSqSvPvPvPvPvPvPvPvPvPvPvP
vPvPvPqSqSqSqSqSpcrTrTrTqSvPvPvPvPvPvPvPvPvPvPvP
vPvPvPqSSSSSSSNqzejsNFrTqSqSukqSqSqSqSqSqSvPvPvP
vPvPvPqSSSrTeVNqjsrTrTrTqSvErTrTdrrTWJJQqSvPvPvP
vPvPvPqSZQjsjsjsjsjsjsjsenjsjsjsjsjsjsrTqSvPvPvP
vPvPvPqSSSSSSSNqAyrTjsSOqSvErTrTUDrTjsjdqSvPvPvP
vPvPvPqSqSqSkjqSYNqSpEqSqSqSqSqSqSrTjsrTqSvPvPvP
vPvPvPqSrTdrjsuyrTqAjsDbqSpOUjTaqSrTjsrTqSvPvPvP
vPvPvPqSrTeQjsjsjsjsjsjsFwjsjsjsqSrTjsrTqSvPvPvP
vPvPvPqSswfhCQjsrTrTjsRcqSrTnhrTqSUqjsjdqSvPvPvP
vPvPvPqSVpdLmLjsrTrTjsTVqSqSqSqSqSrTjsrTqSvPvPvP
vPvPvPqSqSqSqSgRgagagaqSqSvPvPvPgdjsjsjsRUvPvPvP
vPvPvPqSoFoFaEWkDlDlDlDlqSvPvPvPqSqSkhqSqSvPvPvP
vPvPvPqSLfDlDlWkDlDlDlLfqSvPvPkBkSHOeEHOkSkBvPvP
vPvPvPqSgbWkWkWkWkWkWkJPqSvPvPkBeEeEeEeEeEkBvPvP
vPvPvPqSLfDlDlWkDlDlDlLfqSvPvPkBkBkBkBkBkBkBvPvP
vPvPvPqSDlXQXVXVXVXVXQDlqSvPvPvPvPvPvPvPvPvPvPvP
vPvPvPqSqSqSqSqSqSqSqSqSqSvPvPvPvPvPvPvPvPvPvPvP
vPvPvPvPvPvPvPvPvPvPvPvPvPvPvPvPvPvPvPvPvPvPvPvP
vPvPvPvPvPvPvPvPvPvPvPvPvPvPvPvPvPvPvPvPvPvPvPvP
vPvPvPvPvPvPvPvPvPvPvPvPvPvPvPvPvPvPvPvPvPvPvPvP
vPvPvPvPvPvPvPvPvPvPvPvPvPvPvPvPvPvPvPvPvPvPvPvP
vPvPvPvPvPvPvPvPvPvPvPvPvPvPvPvPvPvPvPvPvPvPvPvP
"}
