"ad" = (/obj/marker/map_node,/turf/simulated/floor/tile/shuttle/black,/area/mission/prefab/misc/golem)
"at" = (/obj/structure/table/reinforced,/obj/item/flare,/obj/item/flare,/obj/item/flare,/obj/item/flare,/obj/item/flare,/turf/simulated/floor/tile/shuttle/black,/area/mission/prefab/misc/golem)
"aw" = (/obj/structure/interactive/lighting/fixture/tube/station{dir = 1;icon_state = "preview"},/obj/structure/table/reinforced,/turf/simulated/floor/tile/shuttle/purple,/area/mission/prefab/misc/golem)
"bP" = (/obj/structure/interactive/lighting/fixture/tube/station{dir = 8;icon_state = "preview"},/turf/simulated/floor/tile/shuttle,/area/mission/prefab/misc/golem)
"dh" = (/turf/dmm_suite/no_wall,/area/dmm_suite/clear_area)
"dK" = (/obj/structure/interactive/door/airlock/shuttle,/turf/simulated/floor/tile/shuttle,/area/mission/prefab/misc/golem)
"em" = (/obj/structure/table/reinforced,/obj/item/storage/bags/mining,/obj/item/storage/bags/mining,/obj/item/storage/bags/mining,/turf/simulated/floor/tile/shuttle/purple,/area/mission/prefab/misc/golem)
"fM" = (/obj/structure/interactive/vending/medical,/turf/simulated/floor/tile/shuttle/purple,/area/mission/prefab/misc/golem)
"gz" = (/obj/structure/interactive/storage/trash_pile,/turf/dmm_suite/clear_turf,/area/dmm_suite/clear_area)
"iq" = (/obj/structure/interactive/storage/trash_pile,/turf/dmm_suite/no_wall,/area/dmm_suite/clear_area)
"jq" = (/obj/marker/map_node,/turf/simulated/floor/tile/shuttle/purple,/area/mission/prefab/misc/golem)
"ke" = (/obj/structure/table/reinforced,/obj/item/storage/bags/mining,/obj/item/storage/bags/mining,/turf/simulated/floor/tile/shuttle/black,/area/mission/prefab/misc/golem)
"ls" = (/obj/structure/interactive/door/airlock/shuttle,/turf/simulated/floor/tile/shuttle/black,/area/mission/prefab/misc/golem)
"lu" = (/obj/structure/interactive/crate/necro,/turf/simulated/floor/tile/shuttle/purple,/area/mission/prefab/misc/golem)
"lT" = (/obj/structure/table/reinforced,/obj/item/weapon/melee/tool/pickaxe,/obj/item/weapon/melee/tool/pickaxe,/obj/item/weapon/melee/tool/pickaxe,/obj/item/flare,/turf/simulated/floor/tile/shuttle/purple,/area/mission/prefab/misc/golem)
"mc" = (/obj/structure/interactive/lighting/fixture/tube/station,/turf/simulated/floor/tile/shuttle/purple,/area/mission/prefab/misc/golem)
"mj" = (/obj/structure/interactive/statue/director,/turf/simulated/floor/tile/shuttle,/area/mission/prefab/misc/golem)
"pY" = (/turf/dmm_suite/clear_turf,/area/dmm_suite/clear_area)
"qn" = (/obj/marker/spawning/window/extra,/turf/simulated/floor/plating/shuttle,/area/mission/prefab/misc/golem)
"qx" = (/obj/structure/table/reinforced,/turf/simulated/floor/tile/shuttle/purple,/area/mission/prefab/misc/golem)
"tC" = (/turf/simulated/floor/tile/shuttle,/area/mission/prefab/misc/golem)
"ub" = (/obj/marker/antag/golem,/turf/simulated/floor/tile/shuttle,/area/mission/prefab/misc/golem)
"wi" = (/obj/structure/interactive/crate/coffin,/turf/simulated/floor/tile/shuttle/black,/area/mission/prefab/misc/golem)
"wI" = (/obj/structure/interactive/lighting/fixture/tube/station,/turf/simulated/floor/tile/shuttle,/area/mission/prefab/misc/golem)
"wP" = (/obj/structure/interactive/lighting/fixture/tube/station{dir = 1;icon_state = "preview"},/turf/simulated/floor/tile/shuttle/purple,/area/mission/prefab/misc/golem)
"yl" = (/obj/structure/table/reinforced,/obj/item/weapon/melee/tool/pickaxe,/obj/item/weapon/melee/tool/pickaxe,/turf/simulated/floor/tile/shuttle/black,/area/mission/prefab/misc/golem)
"zS" = (/obj/structure/interactive/vending/mining/golem,/turf/simulated/floor/tile/shuttle/purple,/area/mission/prefab/misc/golem)
"As" = (/obj/structure/table/reinforced,/obj/item/weapon/ranged/energy/pump/kinetic_accelerator,/turf/simulated/floor/tile/shuttle/purple,/area/mission/prefab/misc/golem)
"Bo" = (/obj/marker/map_node/x2,/turf/dmm_suite/no_wall,/area/dmm_suite/clear_area)
"Br" = (/obj/marker/map_node,/turf/dmm_suite/no_wall,/area/dmm_suite/clear_area)
"Bz" = (/obj/structure/interactive/vending/medical/basic{dir = 1;icon_state = "wallmed"},/turf/simulated/wall/metal/shuttle,/area/mission/prefab/misc/golem)
"Ce" = (/obj/marker/map_node/x2,/turf/simulated/floor/tile/shuttle,/area/mission/prefab/misc/golem)
"Cn" = (/turf/simulated/floor/tile/shuttle/black,/area/mission/prefab/misc/golem)
"DM" = (/obj/structure/table/reinforced,/turf/simulated/floor/tile/shuttle/black,/area/mission/prefab/misc/golem)
"DR" = (/obj/structure/table/reinforced,/obj/item/container/syringe/medipen/mining,/obj/item/container/syringe/medipen/mining,/turf/simulated/floor/tile/shuttle/purple,/area/mission/prefab/misc/golem)
"Ea" = (/obj/marker/map_node,/turf/simulated/floor/tile/shuttle,/area/mission/prefab/misc/golem)
"Fd" = (/obj/structure/table/reinforced,/obj/item/storage/kit/brute,/turf/simulated/floor/tile/shuttle/purple,/area/mission/prefab/misc/golem)
"Is" = (/turf/simulated/wall/metal/shuttle,/area/mission/prefab/misc/golem)
"Jr" = (/obj/structure/table/reinforced,/obj/item/clothing/glasses/medical_hud,/turf/simulated/floor/tile/shuttle/purple,/area/mission/prefab/misc/golem)
"Kz" = (/obj/marker/objective_spawn,/turf/simulated/floor/tile/shuttle,/area/mission/prefab/misc/golem)
"Lg" = (/obj/structure/interactive/lighting/fixture/tube/station/strong{dir = 1;icon_state = "preview"},/turf/simulated/floor/tile/shuttle/purple,/area/mission/prefab/misc/golem)
"Mh" = (/obj/item/ball/soccer,/turf/simulated/floor/tile/shuttle,/area/mission/prefab/misc/golem)
"My" = (/obj/structure/interactive/lighting/fixture/tube/station{dir = 1;icon_state = "preview"},/obj/structure/interactive/crate/medical,/turf/simulated/floor/tile/shuttle/purple,/area/mission/prefab/misc/golem)
"Np" = (/obj/structure/shuttle_engine/large{dir = 4},/turf/simulated/floor/plating/shuttle,/area/dmm_suite/clear_area)
"Pg" = (/obj/structure/interactive/mining_brace{dir = 8},/turf/simulated/floor/tile/shuttle/black,/area/mission/prefab/misc/golem)
"PA" = (/obj/structure/interactive/mining_drill,/turf/simulated/floor/tile/shuttle/black,/area/mission/prefab/misc/golem)
"QF" = (/obj/structure/interactive/lighting/fixture/tube/station{dir = 1;icon_state = "preview"},/turf/simulated/floor/tile/shuttle,/area/mission/prefab/misc/golem)
"Re" = (/obj/structure/interactive/crate/coffin,/turf/simulated/floor/tile/shuttle/purple,/area/mission/prefab/misc/golem)
"Rm" = (/obj/structure/interactive/lighting/fixture/tube/station/strong,/turf/simulated/floor/tile/shuttle/purple,/area/mission/prefab/misc/golem)
"RT" = (/obj/structure/table/reinforced,/obj/item/storage/kit/burn/filled,/turf/simulated/floor/tile/shuttle/purple,/area/mission/prefab/misc/golem)
"SI" = (/obj/structure/table/reinforced,/obj/item/clothing/mask/gas/mining,/obj/item/clothing/mask/gas/mining,/obj/item/clothing/mask/gas/mining,/turf/simulated/floor/tile/shuttle/purple,/area/mission/prefab/misc/golem)
"TJ" = (/turf/simulated/floor/plating/shuttle,/area/dmm_suite/clear_area)
"TP" = (/obj/structure/interactive/lighting/fixture/tube/station,/obj/structure/table/reinforced,/turf/simulated/floor/tile/shuttle/purple,/area/mission/prefab/misc/golem)
"Uo" = (/mob/living/simple/bot/medibot,/turf/simulated/floor/tile/shuttle,/area/mission/prefab/misc/golem)
"UX" = (/obj/structure/interactive/computer/console/medical{dir = 4},/turf/simulated/floor/tile/shuttle,/area/mission/prefab/misc/golem)
"Ve" = (/obj/structure/table/reinforced,/obj/item/clothing/head/helmet/welding,/turf/simulated/floor/tile/shuttle/black,/area/mission/prefab/misc/golem)
"VJ" = (/obj/structure/table/reinforced,/obj/item/supply_crate/medicine,/turf/simulated/floor/tile/shuttle/purple,/area/mission/prefab/misc/golem)
"VU" = (/obj/marker/lobby,/obj/marker/map_node/x2,/turf/simulated/floor/tile/shuttle,/area/mission/prefab/misc/golem)
"XG" = (/obj/structure/interactive/computer/arcade/bubbletwist,/turf/simulated/floor/tile/shuttle,/area/mission/prefab/misc/golem)
"YH" = (/obj/structure/interactive/bed/sleeper/medical,/turf/simulated/floor/tile/shuttle/purple,/area/mission/prefab/misc/golem)
"Zk" = (/obj/structure/interactive/mining_brace{dir = 4},/turf/simulated/floor/tile/shuttle/black,/area/mission/prefab/misc/golem)
"Zm" = (/obj/marker/map_node/x3,/turf/simulated/floor/tile/shuttle,/area/mission/prefab/misc/golem)
"Zs" = (/obj/structure/interactive/lighting/fixture/tube/station,/obj/structure/table/reinforced,/obj/item/weapon/ranged/energy/fed/plasma_cutter,/turf/simulated/floor/tile/shuttle/purple,/area/mission/prefab/misc/golem)
"ZY" = (/turf/simulated/floor/tile/shuttle/purple,/area/mission/prefab/misc/golem)

(1,1,1) = {"
pYpYpYpYpYpYpYpYpYpYpYpYpYpYpYpYpYpYpYpYpYpYpYpYpYpYpYpYpYpYpYpY
pYpYpYpYpYpYpYpYpYpYpYpYpYpYpYpYpYpYpYpYpYpYpYpYpYpYpYpYpYpYpYpY
pYpYpYpYpYpYpYpYpYpYpYpYpYpYpYpYpYpYpYpYpYpYpYpYpYpYpYpYpYpYpYpY
pYpYpYpYpYpYpYpYpYpYpYpYpYpYpYpYpYpYpYpYpYpYpYpYpYpYpYpYpYpYpYpY
pYpYpYpYpYpYpYpYpYpYpYpYpYpYpYpYpYpYpYpYpYpYpYpYpYpYpYpYpYpYpYpY
pYpYpYpYpYpYpYpYpYpYpYpYdhpYpYpYpYpYpYpYpYpYpYdhpYpYpYpYpYpYpYpY
pYpYpYpYpYpYpYpYpYpYpYdhBrdhpYpYpYpYpYpYpYpYdhBrdhpYpYpYpYpYpYpY
pYpYpYpYpYpYpYpYpYpYIsIslsIsIsIsIsIsIsIsIsIsIslsIsIsIsIsIspYpYpY
pYpYpYpYpYpYpYpYpYgzIsCnadZkPAPgVekeylatZkPAPgadwiwiIsTJTJpYpYpY
pYpYpYpYpYpYpYpYpYgzIsZYZYZYZYjqZYZYZYjqjqZYZYZYReReIsNpTJpYpYpY
pYpYpYpYpYpYpYpYpYdhIsIsIsIsIsdKIsIsIsdKdKIsIsIsIsIsIsTJTJpYpYpY
pYpYpYpYpYpYpYpYdhdhIsXGMhtCtCEatCtCIsjqjqSIZslTAszSIsNpTJpYpYpY
pYpYpYpYpYpYpYdhdhBrdKEatCtCQFEatCtCdKjqtCtCCetCtCzSIsTJTJpYpYpY
pYpYpYIsIsIsIsIsIsIsIsIsIsIsIsIsIsIsIsZYtCtCtCtCtCemIsNpTJdhpYpY
pYpYpYIsRmZYqxqxqxTPqxqxqxqxmcIsluZYmcZYtCtCtCbPIsIsIsIsIsdhdhpY
pYpYpYIsqnqnububububtCtCtCtCtCdKtCtCtCtCtCtCtCtCdKtCwItCdKdhdhdh
pYpYpYIsmjqntCKzZmtCtCtCtCCetCdKtCVUtCtCtCZmtCtCdKtCCetCdKdhBodh
pYpYpYIsqnqnububububtCtCtCtCtCdKtCtCtCtCtCtCtCtCdKtCQFtCdKdhdhdh
pYpYpYIsLgZYqxqxqxawqxqxqxqxwPIsZYZYwPZYtCtCtCbPIsIsIsIsIsiqdhdh
pYpYpYIsIsIsIsIsIsIsIsIsIsIsIsIsIsIsIsYHtCUXtCtCtCJrIsTJTJdhdhpY
pYpYpYpYpYpYpYdhdhBrdKEatCtCwItCtCEadKfMtCtCCetCUoDRIsNpTJdhpYpY
pYpYpYpYpYpYpYpYdhdhIstCtCtCtCEatCtCIsqxVJqxMyZYRTFdIsTJTJpYpYpY
pYpYpYpYpYpYpYpYpYdhIsIsIsIsIsdKIsIsIsdKdKIsIsBzIsIsIsNpTJpYpYpY
pYpYpYpYpYpYpYpYpYpYIsZYZYZYZYjqZYZYZYjqjqZYZYZYReReIsTJTJpYpYpY
pYpYpYpYpYpYpYpYpYpYIsCnadZkPAPgatDMDMVeZkPAPgadwiwiIsNpTJpYpYpY
pYpYpYpYpYpYpYpYpYpYIsIslsIsIsIsIsIsIsIsIsIsIslsIsIsIsIsIspYpYpY
pYpYpYpYpYpYpYpYpYpYpYdhBrdhdhpYpYpYpYgzpYpYdhBrdhdhpYpYpYpYpYpY
pYpYpYpYpYpYpYpYpYpYpYpYdhdhpYpYpYpYpYpYpYpYpYdhdhpYpYpYpYpYpYpY
pYpYpYpYpYpYpYpYpYpYpYpYpYpYpYpYpYpYpYpYpYpYpYpYpYpYpYpYpYpYpYpY
pYpYpYpYpYpYpYpYpYpYpYpYpYpYpYpYpYpYpYpYpYpYpYpYpYpYpYpYpYpYpYpY
pYpYpYpYpYpYpYpYpYpYpYpYpYpYpYpYpYpYpYpYpYpYpYpYpYpYpYpYpYpYpYpY
pYpYpYpYpYpYpYpYpYpYpYpYpYpYpYpYpYpYpYpYpYpYpYpYpYpYpYpYpYpYpYpY
"}
