"aa" = (/turf/dmm_suite/clear_turf,/area/dmm_suite/clear_area)
"ab" = (/turf/simulated/wall/brick/red,/area/prefab/rev_base)
"ac" = (/turf/simulated/floor/colored/dirt,/area/prefab/rev_base)
"ad" = (/turf/simulated/floor/colored/grass/jungle,/area/prefab/rev_base)
"ae" = (/obj/structure/scenery/rocks,/turf/simulated/floor/colored/dirt,/area/prefab/rev_base)
"af" = (/obj/structure/interactive/tree/evergreen,/turf/simulated/floor/colored/dirt,/area/prefab/rev_base)
"ag" = (/obj/structure/scenery/grass,/turf/simulated/floor/colored/grass/jungle,/area/prefab/rev_base)
"ah" = (/obj/item/storage/heavy/trash_pile,/turf/simulated/floor/colored/dirt,/area/prefab/rev_base)
"ai" = (/turf/simulated/wall/brick/red/dark,/area/prefab/rev_base)
"aj" = (/obj/structure/interactive/misc/shower,/turf/simulated/floor/brick/grey/dark,/area/prefab/rev_base)
"ak" = (/turf/simulated/floor/brick/grey/dark,/area/prefab/rev_base)
"al" = (/mob/living/advanced/npc/rev,/turf/simulated/floor/brick/grey/dark,/area/prefab/rev_base)
"am" = (/obj/structure/interactive/crate/trash,/turf/simulated/floor/brick/grey/dark,/area/prefab/rev_base)
"an" = (/obj/structure/interactive/tree/evergreen,/turf/simulated/floor/colored/grass/jungle,/area/prefab/rev_base)
"ao" = (/obj/structure/smooth/table/dark,/turf/simulated/floor/brick/grey/dark,/area/prefab/rev_base)
"ap" = (/obj/structure/smooth/table/dark,/obj/structure/interactive/lighting/fixture/bulb,/turf/simulated/floor/brick/grey/dark,/area/prefab/rev_base)
"aq" = (/obj/structure/interactive/vending/syndicate/medicine,/turf/simulated/floor/brick/grey/dark,/area/prefab/rev_base)
"ar" = (/obj/structure/interactive/vending/syndicate/attachment,/turf/simulated/floor/brick/grey/dark,/area/prefab/rev_base)
"as" = (/obj/structure/interactive/vending/syndicate/guns/rev,/turf/simulated/floor/brick/grey/dark,/area/prefab/rev_base)
"at" = (/obj/structure/interactive/vending/syndicate/prize/rev,/obj/structure/interactive/lighting/fixture/bulb,/turf/simulated/floor/brick/grey/dark,/area/prefab/rev_base)
"au" = (/obj/structure/interactive/restocker/ammo,/turf/simulated/floor/brick/grey/dark,/area/prefab/rev_base)
"av" = (/obj/structure/interactive/lighting/fixture/bulb{icon_state = "preview"; dir = 4},/turf/simulated/floor/brick/grey/dark,/area/prefab/rev_base)
"aw" = (/obj/structure/interactive/misc/toilet{icon_state = "toilet"; dir = 8},/turf/simulated/floor/brick/grey/dark,/area/prefab/rev_base)
"ax" = (/obj/marker/antag/revolutionary,/turf/simulated/floor/brick/grey/dark,/area/prefab/rev_base)
"ay" = (/obj/structure/interactive/door/metal,/turf/simulated/floor/brick/grey/dark,/area/prefab/rev_base)
"az" = (/obj/structure/interactive/misc/sink{icon_state = "sink"; dir = 8},/turf/simulated/floor/brick/grey/dark,/area/prefab/rev_base)
"aA" = (/obj/structure/interactive/lighting/fixture/bulb{icon_state = "preview"; dir = 8},/turf/simulated/floor/brick/grey/dark,/area/prefab/rev_base)
"aB" = (/obj/structure/interactive/lighting/streetlamp,/turf/simulated/floor/colored/grass/jungle,/area/prefab/rev_base)
"aC" = (/mob/living/advanced/npc/rev{icon_state = "directional"; dir = 4},/turf/simulated/floor/brick/grey/dark,/area/prefab/rev_base)
"aD" = (/obj/structure/interactive/light_switch{icon_state = "setup"; dir = 8},/turf/simulated/wall/brick/red/dark,/area/prefab/rev_base)
"aE" = (/mob/living/advanced/npc/rev,/turf/simulated/floor/colored/dirt,/area/prefab/rev_base)
"aF" = (/obj/structure/interactive/lighting/streetlamp,/turf/simulated/floor/colored/dirt,/area/prefab/rev_base)
"aG" = (/obj/structure/interactive/lighting/fixture/bulb{icon_state = "preview"; dir = 4},/mob/living/advanced/npc/rev{icon_state = "directional"; dir = 4},/turf/simulated/floor/brick/grey/dark,/area/prefab/rev_base)
"aH" = (/obj/structure/interactive/light_switch{icon_state = "setup"; dir = 1},/turf/simulated/wall/brick/red/dark,/area/prefab/rev_base)
"aI" = (/obj/structure/interactive/misc/mirror/cracked/chargen{pixel_x = 32},/obj/structure/interactive/misc/sink{icon_state = "sink"; dir = 4},/turf/simulated/floor/brick/grey/dark,/area/prefab/rev_base)
"aJ" = (/obj/structure/interactive/chair{icon_state = "chair"; dir = 4},/mob/living/advanced/npc/rev{icon_state = "directional"; dir = 4},/turf/simulated/floor/brick/grey/dark,/area/prefab/rev_base)
"aK" = (/obj/structure/interactive/chair{icon_state = "chair"; dir = 8},/turf/simulated/floor/brick/grey/dark,/area/prefab/rev_base)
"aL" = (/obj/structure/interactive/chair{icon_state = "chair"; dir = 4},/turf/simulated/floor/brick/grey/dark,/area/prefab/rev_base)
"aM" = (/obj/structure/interactive/chair{icon_state = "chair"; dir = 8},/mob/living/advanced/npc/rev{icon_state = "directional"; dir = 8},/turf/simulated/floor/brick/grey/dark,/area/prefab/rev_base)
"aN" = (/turf/simulated/wall/wood,/area/prefab/rev_base)
"aO" = (/obj/item/storage/heavy/trash_pile,/turf/simulated/floor/colored/grass/jungle,/area/prefab/rev_base)
"aP" = (/obj/structure/interactive/crate/closet,/turf/simulated/floor/wood/brown,/area/prefab/rev_base)
"aQ" = (/obj/structure/interactive/crate/closet,/obj/structure/interactive/lighting/fixture/bulb,/turf/simulated/floor/wood/brown,/area/prefab/rev_base)
"aR" = (/obj/structure/smooth/table/reinforced,/obj/structure/interactive/misc/tv,/turf/simulated/floor/wood/brown,/area/prefab/rev_base)
"aS" = (/obj/structure/smooth/table/grill,/turf/simulated/floor/wood/brown,/area/prefab/rev_base)
"aT" = (/obj/structure/smooth/table/reinforced,/turf/simulated/floor/wood/brown,/area/prefab/rev_base)
"aU" = (/obj/structure/interactive/light_switch{icon_state = "setup"; dir = 4},/turf/simulated/wall/brick/red/dark,/area/prefab/rev_base)
"aV" = (/obj/structure/interactive/lighting/fixture/bulb{icon_state = "preview"; dir = 4},/turf/simulated/floor/wood/brown,/area/prefab/rev_base)
"aW" = (/turf/simulated/floor/wood/brown,/area/prefab/rev_base)
"aX" = (/mob/living/advanced/npc/rev,/turf/simulated/floor/wood/brown,/area/prefab/rev_base)
"aY" = (/obj/structure/interactive/lighting/fixture/bulb{icon_state = "preview"; dir = 8},/turf/simulated/floor/wood/brown,/area/prefab/rev_base)
"aZ" = (/obj/structure/smooth/table/wood,/obj/item/container/food/plant/wheat,/turf/simulated/floor/wood/brown,/area/prefab/rev_base)
"ba" = (/obj/structure/smooth/table/wood,/obj/item/container/food/plant/wheat,/obj/item/container/food/plant/wheat,/turf/simulated/floor/wood/brown,/area/prefab/rev_base)
"bb" = (/obj/structure/smooth/table/wood,/turf/simulated/floor/wood/brown,/area/prefab/rev_base)
"bd" = (/obj/structure/interactive/lighting/fixture/bulb{dir = 1},/turf/simulated/floor/brick/grey/dark,/area/prefab/rev_base)
"be" = (/obj/structure/smooth/table/dark,/obj/structure/interactive/lighting/fixture/bulb{dir = 1},/turf/simulated/floor/brick/grey/dark,/area/prefab/rev_base)
"bf" = (/obj/structure/interactive/chair/stool/bar,/turf/simulated/floor/wood/brown,/area/prefab/rev_base)
"bg" = (/obj/structure/smooth/wall/wood,/turf/simulated/floor/colored/grass/jungle,/area/prefab/rev_base)
"bh" = (/obj/structure/interactive/plant/wheat,/turf/simulated/floor/colored/dirt/soil,/area/prefab/rev_base)
"bi" = (/turf/simulated/floor/colored/dirt/soil,/area/prefab/rev_base)
"bj" = (/obj/structure/interactive/chair/wood{icon_state = "wooden_chair"; dir = 4},/mob/living/advanced/npc/rev{icon_state = "directional"; dir = 4},/turf/simulated/floor/wood/brown,/area/prefab/rev_base)
"bk" = (/obj/structure/interactive/chair/wood{icon_state = "wooden_chair"; dir = 8},/turf/simulated/floor/wood/brown,/area/prefab/rev_base)
"bl" = (/obj/structure/interactive/light_switch{icon_state = "setup"; dir = 8},/turf/simulated/wall/wood,/area/prefab/rev_base)
"bm" = (/obj/structure/interactive/chair/wood{icon_state = "wooden_chair"; dir = 4},/turf/simulated/floor/wood/brown,/area/prefab/rev_base)
"bn" = (/obj/structure/interactive/door/wood,/turf/simulated/floor/wood/brown,/area/prefab/rev_base)
"bo" = (/obj/structure/interactive/potted_plant/bin,/turf/simulated/floor/wood/brown,/area/prefab/rev_base)
"bp" = (/obj/structure/interactive/chair/wood{icon_state = "wooden_chair"; dir = 1},/turf/simulated/floor/wood/brown,/area/prefab/rev_base)
"bq" = (/obj/structure/interactive/lighting/fixture/bulb{dir = 1},/turf/simulated/floor/wood/brown,/area/prefab/rev_base)
"br" = (/obj/structure/interactive/crate/trash,/turf/simulated/floor/wood/brown,/area/prefab/rev_base)
"bs" = (/mob/living/advanced/npc/rev{icon_state = "directional"; dir = 8},/turf/simulated/floor/colored/dirt,/area/prefab/rev_base)
"bt" = (/turf/dmm_suite/no_wall,/area/dmm_suite/clear_area)
"bu" = (/mob/living/advanced/npc/rev{icon_state = "directional"; dir = 4},/turf/simulated/floor/colored/grass/jungle,/area/prefab/rev_base)
"bv" = (/obj/structure/interactive/barricade,/mob/living/advanced/npc/rev,/turf/simulated/floor/colored/dirt,/area/prefab/rev_base)

(1,1,1) = {"
abababababababababababababababababababababababababababababababab
abacacacacacacacacacacacacadadadadadacacacacacacacacaeaeaeaeaeab
abacacacacadadadafacadagagagadadadacacacacacahahahacacacacaeaeab
abacacaiaiaiaiaiaiadagagagagadacacahaiaiaiaiaiaiaiaiaiaiaiacaeab
abacacaiajakalamaiadagagagadanacacahaiamaoapaqarasataoauaiacaeab
abacacaiavakakawaiadadadadadacacacahaiakakakaxaxaxaxakakayahacab
abacacaiazakakaAaiadadaBacacacacacacaiaCakakakakakakakakaDahacab
abacadaiakakakakaiadadacacacaEacacaFaiaGakakakakakakakaAaiahacab
abacadaiaiaHayaiaiadacacacacacacacacaiaCakakakakakakakaIaiacacab
abacadaBanadadadaBadanacacacacacacacaiakakakaJaoaoaKakaIaiacacab
abacacadadadadadadadadacacacacacacacaiakakakaLaoaoaKakaIaiacacab
abacadadadadanadadadadadadadacaEacacaiakakakaLaoaoaMakaIaiahacab
abacadaNaNaNaNaNaNaNaNaNaNaBacacacaFaiavakakakakakakakaAaiaOacab
abacadaNaPaPaPaQaRaSaTaTaNadacacacacaUakakakakakakakakakaiaOadab
abacadaNaVaWaWaWaXaWaXaYaNacacacacacayakakakakakakakakakaiaOadab
abacadaNaWaZbaaZbbbbbbbbaNacacacacadaiamakbdakakakbeaoaoaiadadab
abacaOaNaWbfbfbfbfbfbfbfaNadacacacadaiaiaiaiaiaiaiaiaiaiaiadadab
abacaOaNaWaWaWaWaWaWaWaWaNadacacacadbgbhbhbhbhbibiadadadadadadab
abadaOaNaWbjbbbbbbbkaWaWbladacacacadbgbibhbhbhbhbiadadadanadacab
abadaOaNaVbmbbbbbbbkaWaWbnadacacacadbgbhbhbibibhbibgadadadacacab
abadadaNboaWbpbpbpaWbqbraNadacacacacbgbgbgbgbgbgbgbgadadacacacab
abadadaNaNaNaNaNaNaNaNaNaNaBacacacacaBadadadadadadadadacacacbsab
abacadanadadadaBadadadadadadacacacacacadadanadadadadacacacacacab
abacacadadadbuadadadadadadacacacacacacacacacacacacacacacacacacab
abacacacacacacacacacacacacbvbvacacbvbvacacacacacacacacacacacacab
abababababababababababababacacacacacacababababababababababababab
aaaaaaaaaaaaaaaaaabtbtbtbtbtbtbtbtbtbtbtbtbtbtaaaaaaaaaaaaaaaaaa
aaaaaaaaaaaaaabtbtbtbtbtbtbtbtbtbtbtbtbtbtbtaaaaaaaaaaaaaaaaaaaa
aaaaaaaaaaaaaaaabtbtbtbtbtbtbtbtbtbtbtbtbtbtbtaaaaaaaaaaaaaaaaaa
aaaaaaaaaaaaaabtbtbtbtbtbtbtbtbtbtbtbtbtbtbtbtaaaaaaaaaaaaaaaaaa
aaaaaaaaaaaaaaaaaaaabtbtbtbtbtbtbtbtbtbtaaaaaaaaaaaaaaaaaaaaaaaa
aaaaaaaaaaaaaaaaaaaaaaaaaaaaaaaaaaaaaaaaaaaaaaaaaaaaaaaaaaaaaaaa
"}
