"aa" = (/turf/dmm_suite/clear_turf,/area/dmm_suite/clear_area)
"ab" = (/obj/structure/shuttle_engine/burst{icon_state = "burst_s"; dir = 4},/turf/dmm_suite/no_wall,/area/dmm_suite/clear_area)
"ac" = (/turf/simulated/wall/dark/shuttle,/area/prefab/syndicate_ship)
"ad" = (/turf/dmm_suite/no_wall,/area/dmm_suite/clear_area)
"ae" = (/obj/marker/spawning/random/supply_crate,/turf/simulated/floor/tile/shuttle/red,/area/prefab/syndicate_ship)
"af" = (/obj/structure/interactive/lighting/fixture/tube/syndicate,/obj/item/weapon/melee/toolbox/syndicate,/turf/simulated/floor/tile/shuttle/red,/area/prefab/syndicate_ship)
"ag" = (/obj/item/radio,/turf/simulated/floor/tile/shuttle/red,/area/prefab/syndicate_ship)
"ah" = (/obj/item/grenade/timed/explosive,/obj/item/grenade/timed/explosive,/turf/simulated/floor/tile/shuttle/red,/area/prefab/syndicate_ship)
"ai" = (/obj/item/grenade/landmine/proximity/explosive,/obj/item/grenade/landmine/proximity/explosive,/obj/item/grenade/landmine/proximity/explosive,/turf/simulated/floor/tile/shuttle/red,/area/prefab/syndicate_ship)
"aj" = (/obj/structure/interactive/vending/syndicate/attachment,/turf/simulated/floor/tile/shuttle/red,/area/prefab/syndicate_ship)
"ak" = (/obj/structure/interactive/vending/syndicate/guns,/turf/simulated/floor/tile/shuttle/red,/area/prefab/syndicate_ship)
"al" = (/obj/structure/interactive/vending/syndicate/prize,/turf/simulated/floor/tile/shuttle/red,/area/prefab/syndicate_ship)
"am" = (/obj/structure/interactive/vending/syndicate/medicine,/turf/simulated/floor/tile/shuttle/red,/area/prefab/syndicate_ship)
"an" = (/obj/structure/interactive/lighting/fixture/tube/syndicate,/obj/item/soapstone/red,/turf/simulated/floor/tile/shuttle/red,/area/prefab/syndicate_ship)
"ao" = (/obj/item/announcement/syndicate,/turf/simulated/floor/tile/shuttle/red,/area/prefab/syndicate_ship)
"ap" = (/obj/marker/map_node/x3,/turf/dmm_suite/no_wall,/area/dmm_suite/clear_area)
"aq" = (/obj/marker/map_node,/turf/simulated/floor/tile/shuttle/black,/area/prefab/syndicate_ship)
"ar" = (/obj/structure/interactive/door/airlock/shuttle/dark,/turf/simulated/floor/tile/shuttle/black,/area/prefab/syndicate_ship)
"as" = (/obj/item/firing_pin/electronic/iff/syndicate,/obj/item/firing_pin/electronic/iff/syndicate,/turf/simulated/floor/tile/shuttle/red,/area/prefab/syndicate_ship)
"at" = (/turf/simulated/floor/tile/shuttle/black,/area/prefab/syndicate_ship)
"au" = (/obj/marker/antag/syndicate,/turf/simulated/floor/tile/shuttle/black,/area/prefab/syndicate_ship)
"av" = (/obj/item/weapon/melee/toolbox/syndicate,/turf/simulated/floor/tile/shuttle/red,/area/prefab/syndicate_ship)
"aw" = (/obj/item/cross,/turf/simulated/floor/tile/shuttle/red,/area/prefab/syndicate_ship)
"ax" = (/obj/item/cell_charger,/obj/item/powercell/advanced,/turf/simulated/floor/tile/shuttle/black,/area/prefab/syndicate_ship)
"ay" = (/obj/item/bikehorn,/turf/simulated/floor/tile/shuttle/red,/area/prefab/syndicate_ship)
"az" = (/obj/structure/interactive/lighting/fixture/tube/syndicate{dir = 4},/obj/item/handcuffs,/turf/simulated/floor/tile/shuttle/red,/area/prefab/syndicate_ship)
"aA" = (/obj/structure/interactive/lighting/fixture/tube/syndicate{dir = 8},/turf/simulated/floor/tile/shuttle/red,/area/prefab/syndicate_ship)
"aB" = (/obj/structure/interactive/computer/console{icon_state = "computer"; dir = 4},/turf/simulated/floor/tile/shuttle/black,/area/prefab/syndicate_ship)
"aC" = (/obj/structure/interactive/computer/console{icon_state = "computer"; dir = 4},/turf/simulated/floor/tile/shuttle/red,/area/prefab/syndicate_ship)
"aD" = (/obj/structure/interactive/door/airlock/shuttle/dark,/turf/simulated/floor/tile/shuttle/red,/area/prefab/syndicate_ship)
"aE" = (/obj/structure/interactive/lighting/fixture/tube/syndicate,/turf/simulated/floor/tile/shuttle/red,/area/prefab/syndicate_ship)
"aF" = (/obj/marker/objective_spawn,/turf/simulated/floor/tile/shuttle/red,/area/prefab/syndicate_ship)
"aG" = (/obj/marker/lobby,/turf/simulated/floor/tile/shuttle/red,/area/prefab/syndicate_ship)
"aH" = (/obj/structure/interactive/lighting/fixture/tube/syndicate{dir = 4},/turf/simulated/floor/tile/shuttle/red,/area/prefab/syndicate_ship)
"aI" = (/obj/item/rcd,/turf/simulated/floor/tile/shuttle/black,/area/prefab/syndicate_ship)
"aJ" = (/turf/simulated/floor/tile/shuttle/red,/area/prefab/syndicate_ship)
"aK" = (/obj/structure/interactive/bed/sleeper/medical/syndicate,/turf/simulated/floor/tile/shuttle/red,/area/prefab/syndicate_ship)
"aL" = (/obj/item/weapon/melee/energy/sword/red,/turf/simulated/floor/tile/shuttle/black,/area/prefab/syndicate_ship)
"aM" = (/obj/marker/hostage_spawn,/turf/simulated/floor/tile/shuttle/red,/area/prefab/syndicate_ship)
"aN" = (/obj/item/analyzer/health,/turf/simulated/floor/tile/shuttle/red,/area/prefab/syndicate_ship)
"aO" = (/obj/item/defib,/turf/simulated/floor/tile/shuttle/red,/area/prefab/syndicate_ship)
"aP" = (/obj/structure/interactive/lighting/fixture/tube/syndicate{dir = 1},/obj/marker/spawning/random/supply_crate,/turf/simulated/floor/tile/shuttle/red,/area/prefab/syndicate_ship)
"aQ" = (/obj/item/storage/kit/syndicate/filled,/turf/simulated/floor/tile/shuttle/red,/area/prefab/syndicate_ship)
"aR" = (/obj/item/storage/kit/burn/filled,/turf/simulated/floor/tile/shuttle/red,/area/prefab/syndicate_ship)
"aS" = (/obj/item/storage/kit/brute/filled,/turf/simulated/floor/tile/shuttle/red,/area/prefab/syndicate_ship)
"aT" = (/obj/item/storage/kit/advanced/filled,/turf/simulated/floor/tile/shuttle/red,/area/prefab/syndicate_ship)
"aU" = (/obj/structure/interactive/lighting/fixture/tube/syndicate{dir = 1},/obj/item/implanter/death_alarm,/turf/simulated/floor/tile/shuttle/red,/area/prefab/syndicate_ship)
"aV" = (/obj/item/implanter/od_purge,/turf/simulated/floor/tile/shuttle/red,/area/prefab/syndicate_ship)
"aW" = (/obj/structure/shuttle_engine/large{icon_state = "large_engine"; dir = 4},/turf/dmm_suite/no_wall,/area/dmm_suite/clear_area)
"aX" = (/obj/structure/interactive/misc/mirror/cracked/chargen{pixel_y = -32},/turf/simulated/floor/tile/shuttle/red,/area/prefab/syndicate_ship)
"aY" = (/obj/marker/map_node,/turf/simulated/floor/tile/shuttle/red,/area/prefab/syndicate_ship)
"aZ" = (/obj/marker/map_node,/turf/dmm_suite/no_wall,/area/dmm_suite/clear_area)
"ba" = (/obj/marker/map_node/x2,/turf/simulated/floor/tile/shuttle/black,/area/prefab/syndicate_ship)

(1,1,1) = {"
aaaaaaaaaaaaaaaaaaaaaaaaaaaaaaaaaaaaaaaaaaaaaaaaaaaaaaaaaaaaaaaa
aaaaaaaaaaaaaaaaaaaaaaaaaaaaaaaaaaaaaaaaaaaaaaaaaaaaaaaaaaaaaaaa
aaaaaaaaaaaaaaaaaaaaaaaaaaaaaaaaaaaaaaaaaaaaaaaaaaaaaaaaaaaaaaaa
aaaaaaaaaaaaaaaaaaaaaaaaaaaaaaaaaaaaaaaaaaaaaaaaaaaaaaaaaaaaaaaa
aaaaaaaaaaaaaaaaaaaaaaaaaaaaaaaaaaaaaaaaaaaaaaaaaaaaaaaaaaaaaaaa
aaaaaaaaaaaaaaaaaaaaaaaaaaaaaaaaaaaaaaaaaaaaaaaaaaaaaaaaaaaaaaaa
aaaaaaaaaaaaaaaaaaaaaaaaaaaaaaaaaaaaaaaaaaaaaaaaaaaaaaaaaaaaaaaa
aaaaaaaaaaaaaaaaacacacacacacacacacacacacacacabadadadaaaaaaaaaaaa
aaaaaaaaaaaaaaaaacaeafagahaiacajakalamanaoacacacadadaaaaaaaaaaaa
aaaaaaaaaaaaaaacacaJatatataqaraqatatataqaJaJasacaWadaaaaaaaaaaaa
aaaaaaaaaaaaaaacataJatatataqaraqauauauauaJaJavacadadaaaaaaaaaaaa
aaaaaaaaaaaaacacacacacaJaJaJacaXaXaXaXaJaJacacacaWadaaaaaaaaaaaa
aaaaaaaaaaaaacawaxayacatbaaJacacacacacacacacabadadadaaaaaaaaaaaa
aaaaaaaaaaacacazataYaraqataAacadadadadadadadadadadadaaaaaaaaaaaa
aaaaaaaaaaacaBaJataJacatataJacacacacacacadadadadadadaaaaaaaaaaaa
aaaaaaaaaaacaCaJaJaJacaJaJaJaYaDaYaEaYaDaZadadadadadaaaaaaaaaaaa
aaaaaaaaaaacaBaYataFacatbaaGataratatataradadadapadadaaaaaaaaaaaa
aaaaaaaaaaacaCaJaJaJacaJaJaJaYaDaYaJaYaDaZadadadadadaaaaaaaaaaaa
aaaaaaaaaaacaBaJataJacatataJacacacacacacadadadadadadaaaaaaaaaaaa
aaaaaaaaaaacacaHataYaraqbaaAacadadadadadadadadadadadaaaaaaaaaaaa
aaaaaaaaaaaaacaeaIaJacatataJacacacacacacacacabadadadaaaaaaaaaaaa
aaaaaaaaaaaaacacacacacaJaJaJacamamaKaJaKaJacacacadadaaaaaaaaaaaa
aaaaaaaaaaaaaaacaLaJatatataqaraqatatatataJaMaNacaWadaaaaaaaaaaaa
aaaaaaaaaaaaaaacacaJatatataqaraqatatataqaJaMaOacadadaaaaaaaaaaaa
aaaaaaaaaaaaaaaaacaeaPaeaeaeacaQaRaSaTaUaVacacacaWadaaaaaaaaaaaa
aaaaaaaaaaaaaaaaacacacacacacacacacacacacacacabadadadaaaaaaaaaaaa
aaaaaaaaaaaaaaaaaaaaaaaaaaaaaaaaaaaaaaaaaaaaaaaaaaaaaaaaaaaaaaaa
aaaaaaaaaaaaaaaaaaaaaaaaaaaaaaaaaaaaaaaaaaaaaaaaaaaaaaaaaaaaaaaa
aaaaaaaaaaaaaaaaaaaaaaaaaaaaaaaaaaaaaaaaaaaaaaaaaaaaaaaaaaaaaaaa
aaaaaaaaaaaaaaaaaaaaaaaaaaaaaaaaaaaaaaaaaaaaaaaaaaaaaaaaaaaaaaaa
aaaaaaaaaaaaaaaaaaaaaaaaaaaaaaaaaaaaaaaaaaaaaaaaaaaaaaaaaaaaaaaa
aaaaaaaaaaaaaaaaaaaaaaaaaaaaaaaaaaaaaaaaaaaaaaaaaaaaaaaaaaaaaaaa
"}
