//MAP CONVERTED BY dmm2tgm.py THIS HEADER COMMENT PREVENTS RECONVERSION, DO NOT REMOVE
"aa" = (
/turf/dmm_suite/clear_turf,
/area/dmm_suite/clear_area)
"ab" = (
/obj/structure/shuttle_engine/burst{
	dir = 4;
	icon_state = "burst_s"
	},
/turf/dmm_suite/no_wall,
/area/dmm_suite/clear_area)
"ac" = (
/turf/simulated/wall/dark/shuttle,
/area/mission/prefab/misc/syndicate_antag_ship)
"ad" = (
/turf/dmm_suite/no_wall,
/area/dmm_suite/clear_area)
"ae" = (
/obj/marker/spawning/random/supply_crate,
/obj/structure/table/reinforced/steel/dark,
/turf/simulated/floor/tile/shuttle/red,
/area/mission/prefab/misc/syndicate_antag_ship)
"af" = (
/obj/structure/interactive/lighting/fixture/tube/syndicate,
/obj/item/weapon/melee/toolbox/syndicate,
/obj/structure/table/reinforced/steel/dark,
/turf/simulated/floor/tile/shuttle/red,
/area/mission/prefab/misc/syndicate_antag_ship)
"ag" = (
/obj/item/radio,
/obj/structure/table/reinforced/steel/dark,
/turf/simulated/floor/tile/shuttle/red,
/area/mission/prefab/misc/syndicate_antag_ship)
"ah" = (
/obj/item/grenade/timed/explosive,
/obj/item/grenade/timed/explosive,
/obj/structure/table/reinforced/steel/dark,
/turf/simulated/floor/tile/shuttle/red,
/area/mission/prefab/misc/syndicate_antag_ship)
"ai" = (
/obj/item/grenade/landmine/proximity/explosive,
/obj/item/grenade/landmine/proximity/explosive,
/obj/item/grenade/landmine/proximity/explosive,
/obj/structure/table/reinforced/steel/dark,
/turf/simulated/floor/tile/shuttle/red,
/area/mission/prefab/misc/syndicate_antag_ship)
"aj" = (
/obj/structure/interactive/vending/syndicate/attachment,
/turf/simulated/floor/tile/shuttle/red,
/area/mission/prefab/misc/syndicate_antag_ship)
"ak" = (
/obj/structure/interactive/vending/syndicate/guns,
/turf/simulated/floor/tile/shuttle/red,
/area/mission/prefab/misc/syndicate_antag_ship)
"al" = (
/obj/structure/interactive/vending/syndicate/prize,
/turf/simulated/floor/tile/shuttle/red,
/area/mission/prefab/misc/syndicate_antag_ship)
"am" = (
/obj/structure/interactive/vending/syndicate/medicine,
/turf/simulated/floor/tile/shuttle/red,
/area/mission/prefab/misc/syndicate_antag_ship)
"an" = (
/obj/structure/interactive/lighting/fixture/tube/syndicate,
/obj/item/soapstone/red,
/obj/structure/table/reinforced/steel/dark,
/turf/simulated/floor/tile/shuttle/red,
/area/mission/prefab/misc/syndicate_antag_ship)
"ao" = (
/obj/item/announcement/syndicate,
/obj/structure/table/reinforced/steel/dark,
/turf/simulated/floor/tile/shuttle/red,
/area/mission/prefab/misc/syndicate_antag_ship)
"ap" = (
/obj/marker/map_node/x3,
/turf/dmm_suite/no_wall,
/area/dmm_suite/clear_area)
"aq" = (
/turf/simulated/floor/tile/shuttle/red,
/area/mission/prefab/misc/syndicate_antag_ship)
"ar" = (
/turf/simulated/floor/tile/shuttle/black,
/area/mission/prefab/misc/syndicate_antag_ship)
"as" = (
/obj/marker/map_node,
/turf/simulated/floor/tile/shuttle/black,
/area/mission/prefab/misc/syndicate_antag_ship)
"at" = (
/obj/structure/interactive/door/airlock/shuttle/dark,
/turf/simulated/floor/tile/shuttle/black,
/area/mission/prefab/misc/syndicate_antag_ship)
"au" = (
/obj/item/firing_pin/electronic/iff/syndicate,
/obj/item/firing_pin/electronic/iff/syndicate,
/obj/structure/table/reinforced/steel/dark,
/turf/simulated/floor/tile/shuttle/red,
/area/mission/prefab/misc/syndicate_antag_ship)
"av" = (
/obj/structure/table/reinforced/steel/dark,
/turf/simulated/floor/tile/shuttle/red,
/area/mission/prefab/misc/syndicate_antag_ship)
"aw" = (
/obj/structure/table/reinforced/steel/dark,
/turf/simulated/floor/tile/shuttle/black,
/area/mission/prefab/misc/syndicate_antag_ship)
"ax" = (
/obj/marker/antag/syndicate,
/turf/simulated/floor/tile/shuttle/black,
/area/mission/prefab/misc/syndicate_antag_ship)
"ay" = (
/obj/item/weapon/melee/toolbox/syndicate,
/obj/structure/table/reinforced/steel/dark,
/turf/simulated/floor/tile/shuttle/red,
/area/mission/prefab/misc/syndicate_antag_ship)
"az" = (
/obj/structure/interactive/misc/mirror/cracked/chargen{
	pixel_y = -32
	},
/turf/simulated/floor/tile/shuttle/red,
/area/mission/prefab/misc/syndicate_antag_ship)
"aA" = (
/obj/item/cross,
/obj/structure/table/reinforced/steel/dark,
/turf/simulated/floor/tile/shuttle/red,
/area/mission/prefab/misc/syndicate_antag_ship)
"aB" = (
/obj/item/cell_charger,
/obj/item/powercell/advanced,
/obj/structure/table/reinforced/steel/dark,
/turf/simulated/floor/tile/shuttle/black,
/area/mission/prefab/misc/syndicate_antag_ship)
"aC" = (
/obj/item/bikehorn,
/obj/structure/table/reinforced/steel/dark,
/turf/simulated/floor/tile/shuttle/red,
/area/mission/prefab/misc/syndicate_antag_ship)
"aD" = (
/obj/marker/map_node/x2,
/turf/simulated/floor/tile/shuttle/black,
/area/mission/prefab/misc/syndicate_antag_ship)
"aE" = (
/obj/structure/interactive/lighting/fixture/tube/syndicate{
	dir = 4
	},
/obj/item/handcuffs,
/obj/structure/table/reinforced/steel/dark,
/turf/simulated/floor/tile/shuttle/red,
/area/mission/prefab/misc/syndicate_antag_ship)
"aF" = (
/obj/marker/map_node,
/turf/simulated/floor/tile/shuttle/red,
/area/mission/prefab/misc/syndicate_antag_ship)
"aG" = (
/obj/structure/interactive/lighting/fixture/tube/syndicate{
	dir = 8
	},
/turf/simulated/floor/tile/shuttle/red,
/area/mission/prefab/misc/syndicate_antag_ship)
"aH" = (
/obj/structure/interactive/computer/console{
	dir = 4;
	icon_state = "computer"
	},
/turf/simulated/floor/tile/shuttle/black,
/area/mission/prefab/misc/syndicate_antag_ship)
"aI" = (
/obj/structure/interactive/computer/console{
	dir = 4;
	icon_state = "computer"
	},
/turf/simulated/floor/tile/shuttle/red,
/area/mission/prefab/misc/syndicate_antag_ship)
"aJ" = (
/obj/structure/interactive/door/airlock/shuttle/dark,
/turf/simulated/floor/tile/shuttle/red,
/area/mission/prefab/misc/syndicate_antag_ship)
"aK" = (
/obj/structure/interactive/lighting/fixture/tube/syndicate,
/turf/simulated/floor/tile/shuttle/red,
/area/mission/prefab/misc/syndicate_antag_ship)
"aL" = (
/obj/marker/objective_spawn,
/turf/simulated/floor/tile/shuttle/red,
/area/mission/prefab/misc/syndicate_antag_ship)
"aM" = (
/obj/marker/lobby,
/turf/simulated/floor/tile/shuttle/red,
/area/mission/prefab/misc/syndicate_antag_ship)
"aN" = (
/obj/structure/interactive/lighting/fixture/tube/syndicate{
	dir = 4
	},
/turf/simulated/floor/tile/shuttle/red,
/area/mission/prefab/misc/syndicate_antag_ship)
"aO" = (
/obj/item/rcd,
/obj/structure/table/reinforced/steel/dark,
/turf/simulated/floor/tile/shuttle/black,
/area/mission/prefab/misc/syndicate_antag_ship)
"aP" = (
/obj/structure/interactive/bed/sleeper/medical/syndicate,
/turf/simulated/floor/tile/shuttle/red,
/area/mission/prefab/misc/syndicate_antag_ship)
"aQ" = (
/obj/item/weapon/melee/energy/sword/red,
/turf/simulated/floor/tile/shuttle/black,
/area/mission/prefab/misc/syndicate_antag_ship)
"aR" = (
/obj/marker/hostage_spawn,
/turf/simulated/floor/tile/shuttle/red,
/area/mission/prefab/misc/syndicate_antag_ship)
"aS" = (
/obj/item/analyzer/health,
/obj/structure/table/reinforced/steel/dark,
/turf/simulated/floor/tile/shuttle/red,
/area/mission/prefab/misc/syndicate_antag_ship)
"aT" = (
/obj/item/defib,
/obj/structure/table/reinforced/steel/dark,
/turf/simulated/floor/tile/shuttle/red,
/area/mission/prefab/misc/syndicate_antag_ship)
"aU" = (
/obj/structure/interactive/lighting/fixture/tube/syndicate{
	dir = 1
	},
/obj/marker/spawning/random/supply_crate,
/obj/structure/table/reinforced/steel/dark,
/turf/simulated/floor/tile/shuttle/red,
/area/mission/prefab/misc/syndicate_antag_ship)
"aV" = (
/obj/item/storage/kit/syndicate/filled,
/obj/structure/table/reinforced/steel/dark,
/turf/simulated/floor/tile/shuttle/red,
/area/mission/prefab/misc/syndicate_antag_ship)
"aW" = (
/obj/structure/shuttle_engine/large{
	dir = 4;
	icon_state = "large_engine"
	},
/turf/dmm_suite/no_wall,
/area/dmm_suite/clear_area)
"aX" = (
/obj/item/storage/kit/burn/filled,
/obj/structure/table/reinforced/steel/dark,
/turf/simulated/floor/tile/shuttle/red,
/area/mission/prefab/misc/syndicate_antag_ship)
"aY" = (
/obj/item/storage/kit/brute/filled,
/obj/structure/table/reinforced/steel/dark,
/turf/simulated/floor/tile/shuttle/red,
/area/mission/prefab/misc/syndicate_antag_ship)
"aZ" = (
/obj/marker/map_node,
/turf/dmm_suite/no_wall,
/area/dmm_suite/clear_area)
"ba" = (
/obj/item/storage/kit/advanced/filled,
/obj/structure/table/reinforced/steel/dark,
/turf/simulated/floor/tile/shuttle/red,
/area/mission/prefab/misc/syndicate_antag_ship)
"bb" = (
/obj/structure/interactive/lighting/fixture/tube/syndicate{
	dir = 1
	},
/obj/item/implanter/death_alarm,
/obj/structure/table/reinforced/steel/dark,
/turf/simulated/floor/tile/shuttle/red,
/area/mission/prefab/misc/syndicate_antag_ship)
"bc" = (
/obj/item/implanter/od_purge,
/obj/structure/table/reinforced/steel/dark,
/turf/simulated/floor/tile/shuttle/red,
/area/mission/prefab/misc/syndicate_antag_ship)

(1,1,1) = {"
aa
aa
aa
aa
aa
aa
aa
aa
aa
aa
aa
aa
aa
aa
aa
aa
aa
aa
aa
aa
aa
aa
aa
aa
aa
aa
aa
aa
aa
aa
aa
aa
"}
(2,1,1) = {"
aa
aa
aa
aa
aa
aa
aa
aa
aa
aa
aa
aa
aa
aa
aa
aa
aa
aa
aa
aa
aa
aa
aa
aa
aa
aa
aa
aa
aa
aa
aa
aa
"}
(3,1,1) = {"
aa
aa
aa
aa
aa
aa
aa
aa
aa
aa
aa
aa
aa
aa
aa
aa
aa
aa
aa
aa
aa
aa
aa
aa
aa
aa
aa
aa
aa
aa
aa
aa
"}
(4,1,1) = {"
aa
aa
aa
aa
aa
aa
aa
aa
aa
aa
aa
aa
aa
aa
aa
aa
aa
aa
aa
aa
aa
aa
aa
aa
aa
aa
aa
aa
aa
aa
aa
aa
"}
(5,1,1) = {"
aa
aa
aa
aa
aa
aa
aa
aa
aa
aa
aa
aa
aa
aa
aa
aa
aa
aa
aa
aa
aa
aa
aa
aa
aa
aa
aa
aa
aa
aa
aa
aa
"}
(6,1,1) = {"
aa
aa
aa
aa
aa
aa
aa
aa
aa
aa
aa
aa
aa
ac
ac
ac
ac
ac
ac
ac
aa
aa
aa
aa
aa
aa
aa
aa
aa
aa
aa
aa
"}
(7,1,1) = {"
aa
aa
aa
aa
aa
aa
aa
aa
aa
aa
aa
ac
ac
ac
aH
aI
aH
aI
aH
ac
ac
ac
aa
aa
aa
aa
aa
aa
aa
aa
aa
aa
"}
(8,1,1) = {"
aa
aa
aa
aa
aa
aa
aa
aa
aa
ac
ac
ac
aA
aE
aq
aq
aF
aq
aq
aN
ae
ac
ac
ac
aa
aa
aa
aa
aa
aa
aa
aa
"}
(9,1,1) = {"
aa
aa
aa
aa
aa
aa
aa
ac
ac
ac
ar
ac
aB
ar
ar
aq
ar
aq
ar
ar
aO
ac
aQ
ac
ac
ac
aa
aa
aa
aa
aa
aa
"}
(10,1,1) = {"
aa
aa
aa
aa
aa
aa
aa
ac
ae
aq
av
ac
aC
aF
aq
aq
aL
aq
aq
aF
av
ac
aq
aq
ae
ac
aa
aa
aa
aa
aa
aa
"}
(11,1,1) = {"
aa
aa
aa
aa
aa
aa
aa
ac
af
ar
aw
ac
ac
at
ac
ac
ac
ac
ac
at
ac
ac
ar
ar
aU
ac
aa
aa
aa
aa
aa
aa
"}
(12,1,1) = {"
aa
aa
aa
aa
aa
aa
aa
ac
ag
ar
ar
aq
ar
as
ar
aq
ar
aq
ar
as
ar
aq
ar
ar
ae
ac
aa
aa
aa
aa
aa
aa
"}
(13,1,1) = {"
aa
aa
aa
aa
aa
aa
aa
ac
ah
ar
ar
aq
aD
ar
ar
aq
aD
aq
ar
aD
ar
aq
ar
ar
ae
ac
aa
aa
aa
aa
aa
aa
"}
(14,1,1) = {"
aa
aa
aa
aa
aa
aa
aa
ac
ai
as
as
aq
aq
aG
aq
aq
aM
aq
aq
aG
aq
aq
as
as
ae
ac
aa
aa
aa
aa
aa
aa
"}
(15,1,1) = {"
aa
aa
aa
aa
aa
aa
aa
ac
ac
at
at
ac
ac
ac
ac
aF
ar
aF
ac
ac
ac
ac
at
at
ac
ac
aa
aa
aa
aa
aa
aa
"}
(16,1,1) = {"
aa
aa
aa
aa
aa
aa
aa
ac
aj
as
as
az
ac
ad
ac
aJ
at
aJ
ac
ad
ac
am
as
as
aV
ac
aa
aa
aa
aa
aa
aa
"}
(17,1,1) = {"
aa
aa
aa
aa
aa
aa
aa
ac
ak
ar
ax
az
ac
ad
ac
aF
ar
aF
ac
ad
ac
am
ar
ar
aX
ac
aa
aa
aa
aa
aa
aa
"}
(18,1,1) = {"
aa
aa
aa
aa
aa
aa
aa
ac
al
ar
ax
az
ac
ad
ac
aK
ar
aq
ac
ad
ac
aP
ar
ar
aY
ac
aa
aa
aa
aa
aa
aa
"}
(19,1,1) = {"
aa
aa
aa
aa
aa
aa
aa
ac
am
ar
ax
az
ac
ad
ac
aF
ar
aF
ac
ad
ac
aq
ar
ar
ba
ac
aa
aa
aa
aa
aa
aa
"}
(20,1,1) = {"
aa
aa
aa
aa
aa
aa
aa
ac
an
as
ax
aq
ac
ad
ac
aJ
at
aJ
ac
ad
ac
aP
ar
as
bb
ac
aa
aa
aa
aa
aa
aa
"}
(21,1,1) = {"
aa
aa
aa
aa
aa
aa
aa
ac
ao
aq
aq
aq
ac
ad
ad
aZ
ad
aZ
ad
ad
ac
aq
aq
aq
bc
ac
aa
aa
aa
aa
aa
aa
"}
(22,1,1) = {"
aa
aa
aa
aa
aa
aa
aa
ac
ac
aq
aq
ac
ac
ad
ad
ad
ad
ad
ad
ad
ac
ac
aR
aR
ac
ac
aa
aa
aa
aa
aa
aa
"}
(23,1,1) = {"
aa
aa
aa
aa
aa
aa
aa
ab
ac
au
ay
ac
ab
ad
ad
ad
ad
ad
ad
ad
ab
ac
aS
aT
ac
ab
aa
aa
aa
aa
aa
aa
"}
(24,1,1) = {"
aa
aa
aa
aa
aa
aa
aa
ad
ac
ac
ac
ac
ad
ad
ad
ad
ap
ad
ad
ad
ad
ac
ac
ac
ac
ad
aa
aa
aa
aa
aa
aa
"}
(25,1,1) = {"
aa
aa
aa
aa
aa
aa
aa
ad
ad
aW
ad
aW
ad
ad
ad
ad
ad
ad
ad
ad
ad
ad
aW
ad
aW
ad
aa
aa
aa
aa
aa
aa
"}
(26,1,1) = {"
aa
aa
aa
aa
aa
aa
aa
ad
ad
ad
ad
ad
ad
ad
ad
ad
ad
ad
ad
ad
ad
ad
ad
ad
ad
ad
aa
aa
aa
aa
aa
aa
"}
(27,1,1) = {"
aa
aa
aa
aa
aa
aa
aa
aa
aa
aa
aa
aa
aa
aa
aa
aa
aa
aa
aa
aa
aa
aa
aa
aa
aa
aa
aa
aa
aa
aa
aa
aa
"}
(28,1,1) = {"
aa
aa
aa
aa
aa
aa
aa
aa
aa
aa
aa
aa
aa
aa
aa
aa
aa
aa
aa
aa
aa
aa
aa
aa
aa
aa
aa
aa
aa
aa
aa
aa
"}
(29,1,1) = {"
aa
aa
aa
aa
aa
aa
aa
aa
aa
aa
aa
aa
aa
aa
aa
aa
aa
aa
aa
aa
aa
aa
aa
aa
aa
aa
aa
aa
aa
aa
aa
aa
"}
(30,1,1) = {"
aa
aa
aa
aa
aa
aa
aa
aa
aa
aa
aa
aa
aa
aa
aa
aa
aa
aa
aa
aa
aa
aa
aa
aa
aa
aa
aa
aa
aa
aa
aa
aa
"}
(31,1,1) = {"
aa
aa
aa
aa
aa
aa
aa
aa
aa
aa
aa
aa
aa
aa
aa
aa
aa
aa
aa
aa
aa
aa
aa
aa
aa
aa
aa
aa
aa
aa
aa
aa
"}
(32,1,1) = {"
aa
aa
aa
aa
aa
aa
aa
aa
aa
aa
aa
aa
aa
aa
aa
aa
aa
aa
aa
aa
aa
aa
aa
aa
aa
aa
aa
aa
aa
aa
aa
aa
"}
