//MAP CONVERTED BY dmm2tgm.py THIS HEADER COMMENT PREVENTS RECONVERSION, DO NOT REMOVE
"a" = (
/turf/dmm_suite/clear_turf,
/area/dmm_suite/clear_area)
"b" = (
/obj/structure/shuttle_engine/burst{
	icon_state = "burst_s";
	dir = 4
	},
/turf/dmm_suite/no_wall,
/area/dmm_suite/clear_area)
"c" = (
/turf/simulated/wall/dark/shuttle,
/area/prefab/syndicate_ship)
"d" = (
/turf/dmm_suite/no_wall,
/area/dmm_suite/clear_area)
"e" = (
/obj/structure/smooth/table/dark,
/obj/marker/spawning/random/supply_crate,
/turf/simulated/floor/tile/shuttle/red,
/area/prefab/syndicate_ship)
"f" = (
/obj/structure/interactive/lighting/fixture/tube/syndicate,
/obj/structure/smooth/table/dark,
/obj/item/weapon/melee/toolbox/syndicate,
/turf/simulated/floor/tile/shuttle/red,
/area/prefab/syndicate_ship)
"g" = (
/obj/structure/smooth/table/dark,
/obj/item/radio,
/turf/simulated/floor/tile/shuttle/red,
/area/prefab/syndicate_ship)
"h" = (
/obj/structure/smooth/table/dark,
/obj/item/grenade/timed/explosive,
/obj/item/grenade/timed/explosive,
/turf/simulated/floor/tile/shuttle/red,
/area/prefab/syndicate_ship)
"i" = (
/obj/structure/smooth/table/dark,
/obj/item/grenade/landmine/proximity/explosive,
/obj/item/grenade/landmine/proximity/explosive,
/obj/item/grenade/landmine/proximity/explosive,
/turf/simulated/floor/tile/shuttle/red,
/area/prefab/syndicate_ship)
"j" = (
/obj/structure/interactive/vending/syndicate/attachment,
/turf/simulated/floor/tile/shuttle/red,
/area/prefab/syndicate_ship)
"k" = (
/obj/structure/interactive/vending/syndicate/guns,
/turf/simulated/floor/tile/shuttle/red,
/area/prefab/syndicate_ship)
"l" = (
/obj/structure/interactive/vending/syndicate/prize,
/turf/simulated/floor/tile/shuttle/red,
/area/prefab/syndicate_ship)
"m" = (
/obj/structure/interactive/vending/syndicate/medicine,
/turf/simulated/floor/tile/shuttle/red,
/area/prefab/syndicate_ship)
"n" = (
/obj/structure/interactive/lighting/fixture/tube/syndicate,
/obj/structure/smooth/table/dark,
/obj/item/soapstone/red,
/turf/simulated/floor/tile/shuttle/red,
/area/prefab/syndicate_ship)
"o" = (
/obj/structure/smooth/table/dark,
/obj/item/announcement/syndicate,
/turf/simulated/floor/tile/shuttle/red,
/area/prefab/syndicate_ship)
"p" = (
/turf/simulated/floor/tile/shuttle/red,
/area/prefab/syndicate_ship)
"q" = (
/turf/simulated/floor/tile/shuttle/black,
/area/prefab/syndicate_ship)
"r" = (
/obj/structure/interactive/door/airlock/shuttle/dark,
/turf/simulated/floor/tile/shuttle/black,
/area/prefab/syndicate_ship)
"s" = (
/obj/structure/smooth/table/dark,
/obj/item/firing_pin/electronic/iff/syndicate,
/obj/item/firing_pin/electronic/iff/syndicate,
/turf/simulated/floor/tile/shuttle/red,
/area/prefab/syndicate_ship)
"t" = (
/obj/structure/smooth/table/dark,
/turf/simulated/floor/tile/shuttle/black,
/area/prefab/syndicate_ship)
"u" = (
/obj/marker/antag/syndicate,
/turf/simulated/floor/tile/shuttle/black,
/area/prefab/syndicate_ship)
"v" = (
/obj/structure/smooth/table/dark,
/obj/item/weapon/melee/toolbox/syndicate,
/turf/simulated/floor/tile/shuttle/red,
/area/prefab/syndicate_ship)
"w" = (
/obj/structure/smooth/table/dark,
/obj/item/cross,
/turf/simulated/floor/tile/shuttle/red,
/area/prefab/syndicate_ship)
"x" = (
/obj/structure/smooth/table/dark,
/obj/item/cell_charger,
/obj/item/powercell/advanced,
/turf/simulated/floor/tile/shuttle/black,
/area/prefab/syndicate_ship)
"y" = (
/obj/structure/smooth/table/dark,
/obj/item/bikehorn,
/turf/simulated/floor/tile/shuttle/red,
/area/prefab/syndicate_ship)
"z" = (
/obj/structure/interactive/lighting/fixture/tube/syndicate{
	dir = 4
	},
/obj/structure/smooth/table/dark,
/obj/item/handcuffs,
/turf/simulated/floor/tile/shuttle/red,
/area/prefab/syndicate_ship)
"A" = (
/obj/structure/interactive/lighting/fixture/tube/syndicate{
	dir = 8
	},
/turf/simulated/floor/tile/shuttle/red,
/area/prefab/syndicate_ship)
"B" = (
/obj/structure/interactive/computer/console{
	icon_state = "computer";
	dir = 4
	},
/turf/simulated/floor/tile/shuttle/black,
/area/prefab/syndicate_ship)
"C" = (
/obj/structure/interactive/computer/console{
	icon_state = "computer";
	dir = 4
	},
/turf/simulated/floor/tile/shuttle/red,
/area/prefab/syndicate_ship)
"D" = (
/obj/structure/interactive/door/airlock/shuttle/dark,
/turf/simulated/floor/tile/shuttle/red,
/area/prefab/syndicate_ship)
"E" = (
/obj/structure/interactive/lighting/fixture/tube/syndicate,
/turf/simulated/floor/tile/shuttle/red,
/area/prefab/syndicate_ship)
"F" = (
/obj/marker/objective_spawn,
/turf/simulated/floor/tile/shuttle/red,
/area/prefab/syndicate_ship)
"G" = (
/obj/marker/lobby,
/turf/simulated/floor/tile/shuttle/red,
/area/prefab/syndicate_ship)
"H" = (
/obj/structure/interactive/lighting/fixture/tube/syndicate{
	dir = 4
	},
/obj/structure/smooth/table/dark,
/turf/simulated/floor/tile/shuttle/red,
/area/prefab/syndicate_ship)
"I" = (
/obj/structure/smooth/table/dark,
/obj/item/rcd,
/turf/simulated/floor/tile/shuttle/black,
/area/prefab/syndicate_ship)
"J" = (
/obj/structure/smooth/table/dark,
/obj/item/deployable/barricade/filled,
/turf/simulated/floor/tile/shuttle/red,
/area/prefab/syndicate_ship)
"K" = (
/obj/structure/interactive/bed/sleeper/medical/syndicate,
/turf/simulated/floor/tile/shuttle/red,
/area/prefab/syndicate_ship)
"L" = (
/obj/structure/smooth/table/dark,
/obj/item/weapon/melee/energy/sword/red,
/turf/simulated/floor/tile/shuttle/black,
/area/prefab/syndicate_ship)
"M" = (
/obj/marker/hostage_spawn,
/turf/simulated/floor/tile/shuttle/red,
/area/prefab/syndicate_ship)
"N" = (
/obj/structure/smooth/table/dark,
/obj/item/analyzer/health,
/turf/simulated/floor/tile/shuttle/red,
/area/prefab/syndicate_ship)
"O" = (
/obj/structure/smooth/table/dark,
/obj/item/defib,
/turf/simulated/floor/tile/shuttle/red,
/area/prefab/syndicate_ship)
"P" = (
/obj/structure/interactive/lighting/fixture/tube/syndicate{
	dir = 1
	},
/obj/structure/smooth/table/dark,
/obj/marker/spawning/random/supply_crate,
/turf/simulated/floor/tile/shuttle/red,
/area/prefab/syndicate_ship)
"Q" = (
/obj/structure/smooth/table/dark,
/obj/item/storage/kit/syndicate/filled,
/turf/simulated/floor/tile/shuttle/red,
/area/prefab/syndicate_ship)
"R" = (
/obj/structure/smooth/table/dark,
/obj/item/storage/kit/burn/filled,
/turf/simulated/floor/tile/shuttle/red,
/area/prefab/syndicate_ship)
"S" = (
/obj/structure/smooth/table/dark,
/obj/item/storage/kit/brute/filled,
/turf/simulated/floor/tile/shuttle/red,
/area/prefab/syndicate_ship)
"T" = (
/obj/structure/smooth/table/dark,
/obj/item/storage/kit/advanced/filled,
/turf/simulated/floor/tile/shuttle/red,
/area/prefab/syndicate_ship)
"U" = (
/obj/structure/interactive/lighting/fixture/tube/syndicate{
	dir = 1
	},
/obj/structure/smooth/table/dark,
/obj/item/implanter/death_alarm,
/turf/simulated/floor/tile/shuttle/red,
/area/prefab/syndicate_ship)
"V" = (
/obj/structure/smooth/table/dark,
/obj/item/implanter/od_purge,
/turf/simulated/floor/tile/shuttle/red,
/area/prefab/syndicate_ship)
"W" = (
/obj/structure/shuttle_engine/large{
	icon_state = "large_engine";
	dir = 4
	},
/turf/dmm_suite/no_wall,
/area/dmm_suite/clear_area)

(1,1,1) = {"
a
a
a
a
a
a
a
a
a
a
a
a
a
a
a
a
a
a
a
a
a
a
a
a
a
a
a
a
a
a
a
a
"}
(2,1,1) = {"
a
a
a
a
a
a
a
a
a
a
a
a
a
a
a
a
a
a
a
a
a
a
a
a
a
a
a
a
a
a
a
a
"}
(3,1,1) = {"
a
a
a
a
a
a
a
a
a
a
a
a
a
a
a
a
a
a
a
a
a
a
a
a
a
a
a
a
a
a
a
a
"}
(4,1,1) = {"
a
a
a
a
a
a
a
a
a
a
a
a
a
a
a
a
a
a
a
a
a
a
a
a
a
a
a
a
a
a
a
a
"}
(5,1,1) = {"
a
a
a
a
a
a
a
a
a
a
a
a
a
a
a
a
a
a
a
a
a
a
a
a
a
a
a
a
a
a
a
a
"}
(6,1,1) = {"
a
a
a
a
a
a
a
a
a
a
a
a
a
c
c
c
c
c
c
c
a
a
a
a
a
a
a
a
a
a
a
a
"}
(7,1,1) = {"
a
a
a
a
a
a
a
a
a
a
a
c
c
c
B
C
B
C
B
c
c
c
a
a
a
a
a
a
a
a
a
a
"}
(8,1,1) = {"
a
a
a
a
a
a
a
a
a
c
c
c
w
z
p
p
p
p
p
H
e
c
c
c
a
a
a
a
a
a
a
a
"}
(9,1,1) = {"
a
a
a
a
a
a
a
c
c
c
t
c
x
q
q
p
q
p
q
q
I
c
L
c
c
c
a
a
a
a
a
a
"}
(10,1,1) = {"
a
a
a
a
a
a
a
c
e
p
p
c
y
p
p
p
F
p
p
p
J
c
p
p
e
c
a
a
a
a
a
a
"}
(11,1,1) = {"
a
a
a
a
a
a
a
c
f
q
q
c
c
r
c
c
c
c
c
r
c
c
q
q
P
c
a
a
a
a
a
a
"}
(12,1,1) = {"
a
a
a
a
a
a
a
c
g
q
q
p
q
q
q
p
q
p
q
q
q
p
q
q
e
c
a
a
a
a
a
a
"}
(13,1,1) = {"
a
a
a
a
a
a
a
c
h
q
q
p
q
q
q
p
q
p
q
q
q
p
q
q
e
c
a
a
a
a
a
a
"}
(14,1,1) = {"
a
a
a
a
a
a
a
c
i
q
q
p
p
A
p
p
G
p
p
A
p
p
q
q
e
c
a
a
a
a
a
a
"}
(15,1,1) = {"
a
a
a
a
a
a
a
c
c
r
r
c
c
c
c
p
q
p
c
c
c
c
r
r
c
c
a
a
a
a
a
a
"}
(16,1,1) = {"
a
a
a
a
a
a
a
c
j
q
q
p
c
d
c
D
r
D
c
d
c
m
q
q
Q
c
a
a
a
a
a
a
"}
(17,1,1) = {"
a
a
a
a
a
a
a
c
k
q
u
p
c
d
c
p
q
p
c
d
c
m
q
q
R
c
a
a
a
a
a
a
"}
(18,1,1) = {"
a
a
a
a
a
a
a
c
l
q
u
p
c
d
c
E
q
p
c
d
c
K
q
q
S
c
a
a
a
a
a
a
"}
(19,1,1) = {"
a
a
a
a
a
a
a
c
m
q
u
p
c
d
c
p
q
p
c
d
c
p
q
q
T
c
a
a
a
a
a
a
"}
(20,1,1) = {"
a
a
a
a
a
a
a
c
n
q
u
p
c
d
c
D
r
D
c
d
c
K
q
q
U
c
a
a
a
a
a
a
"}
(21,1,1) = {"
a
a
a
a
a
a
a
c
o
p
p
p
c
d
d
d
d
d
d
d
c
p
p
p
V
c
a
a
a
a
a
a
"}
(22,1,1) = {"
a
a
a
a
a
a
a
c
c
p
p
c
c
d
d
d
d
d
d
d
c
c
M
M
c
c
a
a
a
a
a
a
"}
(23,1,1) = {"
a
a
a
a
a
a
a
b
c
s
v
c
b
d
d
d
d
d
d
d
b
c
N
O
c
b
a
a
a
a
a
a
"}
(24,1,1) = {"
a
a
a
a
a
a
a
d
c
c
c
c
d
d
d
d
d
d
d
d
d
c
c
c
c
d
a
a
a
a
a
a
"}
(25,1,1) = {"
a
a
a
a
a
a
a
d
d
W
d
W
d
d
d
d
d
d
d
d
d
d
W
d
W
d
a
a
a
a
a
a
"}
(26,1,1) = {"
a
a
a
a
a
a
a
d
d
d
d
d
d
d
d
d
d
d
d
d
d
d
d
d
d
d
a
a
a
a
a
a
"}
(27,1,1) = {"
a
a
a
a
a
a
a
a
a
a
a
a
a
a
a
a
a
a
a
a
a
a
a
a
a
a
a
a
a
a
a
a
"}
(28,1,1) = {"
a
a
a
a
a
a
a
a
a
a
a
a
a
a
a
a
a
a
a
a
a
a
a
a
a
a
a
a
a
a
a
a
"}
(29,1,1) = {"
a
a
a
a
a
a
a
a
a
a
a
a
a
a
a
a
a
a
a
a
a
a
a
a
a
a
a
a
a
a
a
a
"}
(30,1,1) = {"
a
a
a
a
a
a
a
a
a
a
a
a
a
a
a
a
a
a
a
a
a
a
a
a
a
a
a
a
a
a
a
a
"}
(31,1,1) = {"
a
a
a
a
a
a
a
a
a
a
a
a
a
a
a
a
a
a
a
a
a
a
a
a
a
a
a
a
a
a
a
a
"}
(32,1,1) = {"
a
a
a
a
a
a
a
a
a
a
a
a
a
a
a
a
a
a
a
a
a
a
a
a
a
a
a
a
a
a
a
a
"}
