"aa" = (/turf/dmm_suite/clear_turf,/area/dmm_suite/clear_area)
"ab" = (/obj/structure/shuttle_engine/burst{dir = 4;icon_state = "burst_s"},/turf/dmm_suite/no_wall,/area/dmm_suite/clear_area)
"ac" = (/turf/simulated/wall/dark/shuttle,/area/mission/prefab/misc/syndicate_antag_ship)
"ad" = (/turf/dmm_suite/no_wall,/area/dmm_suite/clear_area)
"ae" = (/obj/marker/spawning/random/supply_crate,/obj/structure/table/reinforced/steel/dark,/turf/simulated/floor/tile/shuttle/red,/area/mission/prefab/misc/syndicate_antag_ship)
"af" = (/obj/structure/interactive/lighting/fixture/tube/syndicate,/obj/item/weapon/melee/toolbox/syndicate,/obj/structure/table/reinforced/steel/dark,/turf/simulated/floor/tile/shuttle/red,/area/mission/prefab/misc/syndicate_antag_ship)
"ag" = (/obj/item/radio,/obj/structure/table/reinforced/steel/dark,/turf/simulated/floor/tile/shuttle/red,/area/mission/prefab/misc/syndicate_antag_ship)
"ah" = (/obj/item/grenade/timed/explosive,/obj/item/grenade/timed/explosive,/obj/structure/table/reinforced/steel/dark,/turf/simulated/floor/tile/shuttle/red,/area/mission/prefab/misc/syndicate_antag_ship)
"ai" = (/obj/item/grenade/landmine/proximity/explosive,/obj/item/grenade/landmine/proximity/explosive,/obj/item/grenade/landmine/proximity/explosive,/obj/structure/table/reinforced/steel/dark,/turf/simulated/floor/tile/shuttle/red,/area/mission/prefab/misc/syndicate_antag_ship)
"aj" = (/obj/structure/interactive/vending/syndicate/attachment,/turf/simulated/floor/tile/shuttle/red,/area/mission/prefab/misc/syndicate_antag_ship)
"ak" = (/obj/structure/interactive/vending/syndicate/guns,/turf/simulated/floor/tile/shuttle/red,/area/mission/prefab/misc/syndicate_antag_ship)
"al" = (/obj/structure/interactive/vending/syndicate/prize,/turf/simulated/floor/tile/shuttle/red,/area/mission/prefab/misc/syndicate_antag_ship)
"am" = (/obj/structure/interactive/vending/syndicate/medicine,/turf/simulated/floor/tile/shuttle/red,/area/mission/prefab/misc/syndicate_antag_ship)
"an" = (/obj/structure/interactive/lighting/fixture/tube/syndicate,/obj/item/soapstone/red,/obj/structure/table/reinforced/steel/dark,/turf/simulated/floor/tile/shuttle/red,/area/mission/prefab/misc/syndicate_antag_ship)
"ao" = (/obj/item/announcement/syndicate,/obj/structure/table/reinforced/steel/dark,/turf/simulated/floor/tile/shuttle/red,/area/mission/prefab/misc/syndicate_antag_ship)
"ap" = (/obj/marker/map_node/x3,/turf/dmm_suite/no_wall,/area/dmm_suite/clear_area)
"aq" = (/turf/simulated/floor/tile/shuttle/red,/area/mission/prefab/misc/syndicate_antag_ship)
"ar" = (/turf/simulated/floor/tile/shuttle/black,/area/mission/prefab/misc/syndicate_antag_ship)
"as" = (/obj/marker/map_node,/turf/simulated/floor/tile/shuttle/black,/area/mission/prefab/misc/syndicate_antag_ship)
"at" = (/obj/structure/interactive/door/airlock/shuttle/dark,/turf/simulated/floor/tile/shuttle/black,/area/mission/prefab/misc/syndicate_antag_ship)
"au" = (/obj/item/firing_pin/electronic/iff/syndicate,/obj/item/firing_pin/electronic/iff/syndicate,/obj/structure/table/reinforced/steel/dark,/turf/simulated/floor/tile/shuttle/red,/area/mission/prefab/misc/syndicate_antag_ship)
"av" = (/obj/structure/table/reinforced/steel/dark,/turf/simulated/floor/tile/shuttle/red,/area/mission/prefab/misc/syndicate_antag_ship)
"aw" = (/obj/structure/table/reinforced/steel/dark,/turf/simulated/floor/tile/shuttle/black,/area/mission/prefab/misc/syndicate_antag_ship)
"ax" = (/obj/marker/antag/syndicate,/turf/simulated/floor/tile/shuttle/black,/area/mission/prefab/misc/syndicate_antag_ship)
"ay" = (/obj/item/weapon/melee/toolbox/syndicate,/obj/structure/table/reinforced/steel/dark,/turf/simulated/floor/tile/shuttle/red,/area/mission/prefab/misc/syndicate_antag_ship)
"az" = (/obj/structure/interactive/misc/mirror/cracked/chargen{pixel_y = -32},/turf/simulated/floor/tile/shuttle/red,/area/mission/prefab/misc/syndicate_antag_ship)
"aA" = (/obj/item/cross,/obj/structure/table/reinforced/steel/dark,/turf/simulated/floor/tile/shuttle/red,/area/mission/prefab/misc/syndicate_antag_ship)
"aB" = (/obj/item/cell_charger,/obj/item/powercell/advanced,/obj/structure/table/reinforced/steel/dark,/turf/simulated/floor/tile/shuttle/black,/area/mission/prefab/misc/syndicate_antag_ship)
"aC" = (/obj/item/bikehorn,/obj/structure/table/reinforced/steel/dark,/turf/simulated/floor/tile/shuttle/red,/area/mission/prefab/misc/syndicate_antag_ship)
"aD" = (/obj/marker/map_node/x2,/turf/simulated/floor/tile/shuttle/black,/area/mission/prefab/misc/syndicate_antag_ship)
"aE" = (/obj/structure/interactive/lighting/fixture/tube/syndicate{dir = 4},/obj/item/handcuffs,/obj/structure/table/reinforced/steel/dark,/turf/simulated/floor/tile/shuttle/red,/area/mission/prefab/misc/syndicate_antag_ship)
"aF" = (/obj/marker/map_node,/turf/simulated/floor/tile/shuttle/red,/area/mission/prefab/misc/syndicate_antag_ship)
"aG" = (/obj/structure/interactive/lighting/fixture/tube/syndicate{dir = 8},/turf/simulated/floor/tile/shuttle/red,/area/mission/prefab/misc/syndicate_antag_ship)
"aH" = (/obj/structure/interactive/computer/console{dir = 4;icon_state = "computer"},/turf/simulated/floor/tile/shuttle/black,/area/mission/prefab/misc/syndicate_antag_ship)
"aI" = (/obj/structure/interactive/computer/console{dir = 4;icon_state = "computer"},/turf/simulated/floor/tile/shuttle/red,/area/mission/prefab/misc/syndicate_antag_ship)
"aJ" = (/obj/structure/interactive/door/airlock/shuttle/dark,/turf/simulated/floor/tile/shuttle/red,/area/mission/prefab/misc/syndicate_antag_ship)
"aK" = (/obj/structure/interactive/lighting/fixture/tube/syndicate,/turf/simulated/floor/tile/shuttle/red,/area/mission/prefab/misc/syndicate_antag_ship)
"aL" = (/obj/marker/objective_spawn,/turf/simulated/floor/tile/shuttle/red,/area/mission/prefab/misc/syndicate_antag_ship)
"aM" = (/obj/marker/lobby,/turf/simulated/floor/tile/shuttle/red,/area/mission/prefab/misc/syndicate_antag_ship)
"aN" = (/obj/structure/interactive/lighting/fixture/tube/syndicate{dir = 4},/turf/simulated/floor/tile/shuttle/red,/area/mission/prefab/misc/syndicate_antag_ship)
"aO" = (/obj/item/rcd,/obj/structure/table/reinforced/steel/dark,/turf/simulated/floor/tile/shuttle/black,/area/mission/prefab/misc/syndicate_antag_ship)
"aP" = (/obj/structure/interactive/bed/sleeper/medical/syndicate,/turf/simulated/floor/tile/shuttle/red,/area/mission/prefab/misc/syndicate_antag_ship)
"aQ" = (/obj/item/weapon/melee/energy/sword/red,/turf/simulated/floor/tile/shuttle/black,/area/mission/prefab/misc/syndicate_antag_ship)
"aR" = (/obj/marker/hostage_spawn,/turf/simulated/floor/tile/shuttle/red,/area/mission/prefab/misc/syndicate_antag_ship)
"aS" = (/obj/item/analyzer/health,/obj/structure/table/reinforced/steel/dark,/turf/simulated/floor/tile/shuttle/red,/area/mission/prefab/misc/syndicate_antag_ship)
"aT" = (/obj/item/defib,/obj/structure/table/reinforced/steel/dark,/turf/simulated/floor/tile/shuttle/red,/area/mission/prefab/misc/syndicate_antag_ship)
"aU" = (/obj/structure/interactive/lighting/fixture/tube/syndicate{dir = 1},/obj/marker/spawning/random/supply_crate,/obj/structure/table/reinforced/steel/dark,/turf/simulated/floor/tile/shuttle/red,/area/mission/prefab/misc/syndicate_antag_ship)
"aV" = (/obj/item/storage/kit/syndicate/filled,/obj/structure/table/reinforced/steel/dark,/turf/simulated/floor/tile/shuttle/red,/area/mission/prefab/misc/syndicate_antag_ship)
"aW" = (/obj/structure/shuttle_engine/large{dir = 4;icon_state = "large_engine"},/turf/dmm_suite/no_wall,/area/dmm_suite/clear_area)
"aX" = (/obj/item/storage/kit/burn/filled,/obj/structure/table/reinforced/steel/dark,/turf/simulated/floor/tile/shuttle/red,/area/mission/prefab/misc/syndicate_antag_ship)
"aY" = (/obj/item/storage/kit/brute/filled,/obj/structure/table/reinforced/steel/dark,/turf/simulated/floor/tile/shuttle/red,/area/mission/prefab/misc/syndicate_antag_ship)
"aZ" = (/obj/marker/map_node,/turf/dmm_suite/no_wall,/area/dmm_suite/clear_area)
"ba" = (/obj/item/storage/kit/advanced/filled,/obj/structure/table/reinforced/steel/dark,/turf/simulated/floor/tile/shuttle/red,/area/mission/prefab/misc/syndicate_antag_ship)
"bb" = (/obj/structure/interactive/lighting/fixture/tube/syndicate{dir = 1},/obj/item/implanter/death_alarm,/obj/structure/table/reinforced/steel/dark,/turf/simulated/floor/tile/shuttle/red,/area/mission/prefab/misc/syndicate_antag_ship)
"bc" = (/obj/item/implanter/od_purge,/obj/structure/table/reinforced/steel/dark,/turf/simulated/floor/tile/shuttle/red,/area/mission/prefab/misc/syndicate_antag_ship)

(1,1,1) = {"
aaaaaaaaaaaaaaaaaaaaaaaaaaaaaaaaaaaaaaaaaaaaaaaaaaaaaaaaaaaaaaaa
aaaaaaaaaaaaaaaaaaaaaaaaaaaaaaaaaaaaaaaaaaaaaaaaaaaaaaaaaaaaaaaa
aaaaaaaaaaaaaaaaaaaaaaaaaaaaaaaaaaaaaaaaaaaaaaaaaaaaaaaaaaaaaaaa
aaaaaaaaaaaaaaaaaaaaaaaaaaaaaaaaaaaaaaaaaaaaaaaaaaaaaaaaaaaaaaaa
aaaaaaaaaaaaaaaaaaaaaaaaaaaaaaaaaaaaaaaaaaaaaaaaaaaaaaaaaaaaaaaa
aaaaaaaaaaaaaaaaaaaaaaaaaaaaaaaaaaaaaaaaaaaaaaaaaaaaaaaaaaaaaaaa
aaaaaaaaaaaaaaaaaaaaaaaaaaaaaaaaaaaaaaaaaaaaaaaaaaaaaaaaaaaaaaaa
aaaaaaaaaaaaaaaaacacacacacacacacacacacacacacabadadadaaaaaaaaaaaa
aaaaaaaaaaaaaaaaacaeafagahaiacajakalamanaoacacacadadaaaaaaaaaaaa
aaaaaaaaaaaaaaacacaqarararasatasarararasaqaqauacaWadaaaaaaaaaaaa
aaaaaaaaaaaaaaacaravawararasatasaxaxaxaxaqaqayacadadaaaaaaaaaaaa
aaaaaaaaaaaaacacacacacaqaqaqacazazazazaqaqacacacaWadaaaaaaaaaaaa
aaaaaaaaaaaaacaAaBaCacaraDaqacacacacacacacacabadadadaaaaaaaaaaaa
aaaaaaaaaaacacaEaraFatasaraGacadadadadadadadadadadadaaaaaaaaaaaa
aaaaaaaaaaacaHaqaraqacararaqacacacacacacadadadadadadaaaaaaaaaaaa
aaaaaaaaaaacaIaqaqaqacaqaqaqaFaJaFaKaFaJaZadadadadadaaaaaaaaaaaa
aaaaaaaaaaacaHaFaraLacaraDaMaratarararatadadadapadadaaaaaaaaaaaa
aaaaaaaaaaacaIaqaqaqacaqaqaqaFaJaFaqaFaJaZadadadadadaaaaaaaaaaaa
aaaaaaaaaaacaHaqaraqacararaqacacacacacacadadadadadadaaaaaaaaaaaa
aaaaaaaaaaacacaNaraFatasaDaGacadadadadadadadadadadadaaaaaaaaaaaa
aaaaaaaaaaaaacaeaOavacararaqacacacacacacacacabadadadaaaaaaaaaaaa
aaaaaaaaaaaaacacacacacaqaqaqacamamaPaqaPaqacacacadadaaaaaaaaaaaa
aaaaaaaaaaaaaaacaQaqarararasatasararararaqaRaSacaWadaaaaaaaaaaaa
aaaaaaaaaaaaaaacacaqarararasatasarararasaqaRaTacadadaaaaaaaaaaaa
aaaaaaaaaaaaaaaaacaeaUaeaeaeacaVaXaYbabbbcacacacaWadaaaaaaaaaaaa
aaaaaaaaaaaaaaaaacacacacacacacacacacacacacacabadadadaaaaaaaaaaaa
aaaaaaaaaaaaaaaaaaaaaaaaaaaaaaaaaaaaaaaaaaaaaaaaaaaaaaaaaaaaaaaa
aaaaaaaaaaaaaaaaaaaaaaaaaaaaaaaaaaaaaaaaaaaaaaaaaaaaaaaaaaaaaaaa
aaaaaaaaaaaaaaaaaaaaaaaaaaaaaaaaaaaaaaaaaaaaaaaaaaaaaaaaaaaaaaaa
aaaaaaaaaaaaaaaaaaaaaaaaaaaaaaaaaaaaaaaaaaaaaaaaaaaaaaaaaaaaaaaa
aaaaaaaaaaaaaaaaaaaaaaaaaaaaaaaaaaaaaaaaaaaaaaaaaaaaaaaaaaaaaaaa
aaaaaaaaaaaaaaaaaaaaaaaaaaaaaaaaaaaaaaaaaaaaaaaaaaaaaaaaaaaaaaaa
"}
