"a" = (/turf/dmm_suite/clear_turf,/area/dmm_suite/clear_area)
"b" = (/turf/dmm_suite/no_wall,/area/dmm_suite/clear_area)
"c" = (/mob/living/simple/ash_drake,/turf/dmm_suite/no_wall,/area/dmm_suite/clear_area)
"d" = (/turf/simulated/wall/brick/grey,/area/dmm_suite/clear_area)
"e" = (/turf/simulated/floor/brick/grey,/area/dmm_suite/clear_area)
"f" = (/obj/structure/interactive/door/wood,/turf/simulated/floor/brick/grey,/area/dmm_suite/clear_area)
"g" = (/obj/marker/lobby,/turf/dmm_suite/no_wall,/area/dmm_suite/clear_area)
"h" = (/obj/marker/objective_spawn,/turf/simulated/floor/brick/grey,/area/dmm_suite/clear_area)
"i" = (/obj/marker/map_node,/turf/dmm_suite/no_wall,/area/dmm_suite/clear_area)
"j" = (/obj/marker/map_node,/turf/simulated/floor/brick/grey,/area/dmm_suite/clear_area)
"k" = (/obj/marker/map_node/x3,/turf/dmm_suite/no_wall,/area/dmm_suite/clear_area)
"l" = (/obj/marker/map_node/x2,/turf/dmm_suite/no_wall,/area/dmm_suite/clear_area)
"m" = (/obj/marker/smart_clear_turf,/turf/dmm_suite/no_wall,/area/dmm_suite/clear_area)
"E" = (/obj/structure/interactive/crate/chest/filled,/turf/simulated/floor/brick/grey,/area/dmm_suite/clear_area)

(1,1,1) = {"
aaaaaaaaaambbbbbbaaaaaaaaaaaaaaa
aaaaaaaaaabbbbbbbaaaaaaaaaaaaaaa
aaaaaaaaaabbbkbbbaaaaaaaaaaaaaaa
aaaaaaaaaabbbbbbbaaaaaaaaaaaaaaa
aaaaabbbbbbbbbbbbbbbbaaaaaaaaaaa
aaaabddddddbbbbbbbbbbbbaaaaaaaaa
aaaabdeeeEdbbbbbbbbbbibbbaaaaaaa
aaaabdejejfiblbbbddddfdddaaaaaaa
aaaabdeeeedbbbbbbdeeejeEdaaaaaaa
aaaabdejeedbbbbbifjeeeeedaaaaaaa
mbbbbddfdddbbgbbbdeeheeedaaaaaaa
bbbbbbbibbbbbbbbbdeeeeeedaaaaaaa
blbbbbbbbbbbbcbbbdeeeejedaaaaaaa
bbbbbbbbblbbblbbbdddddfddaaaaaaa
aaaabblbbbbbbbbbbbbbbbibbbbbbbaa
aaaabbbbbbibbbbbibbibbbbbbbbbbbm
aaaabbbbbdfddddddddbbbbbbbbbbbbb
aaaabbbbbdjeeeeeeEdbbbbbblbbbblb
aaaabbbbbdeeeeeeejeibbbbbbbbbbbb
aaaaaaaabdeeeeeeeedbbbbbaaaaaaaa
aaaaaaaabdeeeeeeeedbbaaaaaaaaaaa
aaaaaaaabdeeeeejeedbbaaaaaaaaaaa
aaaaaaaaaddddddfdddbaaaaaaaaaaaa
aaaaaaaaabbbbbbibbbaaaaaaaaaaaaa
aaaaaaaaabbbbbbbbbbaaaaaaaaaaaaa
aaaaaaaaabblbbbkbbaaaaaaaaaaaaaa
aaaaaaabbbbbbbbbbbaaaaaaaaaaaaaa
aaaaaaabbbbbbbbbbbaaaaaaaaaaaaaa
aaaaaaabbbbbbibbbbaaaaaaaaaaaaaa
aaaaaaabbbkbbbbbbbaaaaaaaaaaaaaa
aaaaaaabbbbbbbaaaaaaaaaaaaaaaaaa
aaaaaaabbbbbbmaaaaaaaaaaaaaaaaaa
"}
