"a" = (/turf/dmm_suite/clear_turf,/area/dmm_suite/clear_area)
"b" = (/turf/dmm_suite/no_wall,/area/dmm_suite/clear_area)
"c" = (/mob/living/simple/ash_drake,/turf/dmm_suite/no_wall,/area/dmm_suite/clear_area)
"d" = (/turf/simulated/wall/brick/grey,/area/dmm_suite/clear_area)
"e" = (/turf/simulated/floor/brick/grey,/area/dmm_suite/clear_area)
"f" = (/obj/structure/interactive/door/wood,/turf/simulated/floor/brick/grey,/area/dmm_suite/clear_area)
"g" = (/obj/marker/lobby,/turf/dmm_suite/no_wall,/area/dmm_suite/clear_area)
"h" = (/obj/marker/objective_spawn,/turf/simulated/floor/brick/grey,/area/dmm_suite/clear_area)
"i" = (/obj/marker/map_node,/turf/dmm_suite/no_wall,/area/dmm_suite/clear_area)
"j" = (/obj/marker/map_node,/turf/simulated/floor/brick/grey,/area/dmm_suite/clear_area)
"E" = (/obj/structure/interactive/crate/chest/filled,/turf/simulated/floor/brick/grey,/area/dmm_suite/clear_area)

(1,1,1) = {"
aaaaaaaaaabbbbbbbaaaaaaaaaaaaaaa
aaaaaaaaaabbbibbbaaaaaaaaaaaaaaa
aaaaaaaaaabbbbbbbaaaaaaaaaaaaaaa
aaaaaaaaaabbbbbbbaaaaaaaaaaaaaaa
aaaaabbbbbbbbbbbbbbbbaaaaaaaaaaa
aaaabddddddbbbbbbbbbbbbaaaaaaaaa
aaaabdeeeEdbbbbbbbbbbbbbbaaaaaaa
aaaabdejeefbbibbbddddfdddaaaaaaa
aaaabdeeeedbbbbbbdeeeeeEdaaaaaaa
aaaabdeeeedbbbbbifeeejeedaaaaaaa
bbbbbddfdddbbgbbbdeeheeedaaaaaaa
bbbbbbbbbbbbbbbbbdeeeeeedaaaaaaa
bibbbbbibbbbbcbbbdeeeejedaaaaaaa
bbbbbbbbbbbbbbbbbdddddfddaaaaaaa
aaaabbbbbbbbbbbbbbbbbbbbbbbbbbaa
aaaabbbbbbibbbbbbbbbbbibbbbbbbbb
aaaabbbbbdfddddddddbbbbbbbbbbbbb
aaaabbbbbdjeeeeeeEdbbbbbbbbbbibb
aaaabbbbbdeeeeeeeeebbbbbbbbbbbbb
aaaaaaaabdeeeeeeeedbbbbbaaaaaaaa
aaaaaaaabdeeeeeeeedbbaaaaaaaaaaa
aaaaaaaabdeeeeejeedbbaaaaaaaaaaa
aaaaaaaaaddddddfdddbaaaaaaaaaaaa
aaaaaaaaabbbbbbbbbbaaaaaaaaaaaaa
aaaaaaaaabbbbbbbbbbaaaaaaaaaaaaa
aaaaaaaaabbbbbbibbaaaaaaaaaaaaaa
aaaaaaabbbbbbbbbbbaaaaaaaaaaaaaa
aaaaaaabbbbbbbbbbbaaaaaaaaaaaaaa
aaaaaaabbbbbbbbbbbaaaaaaaaaaaaaa
aaaaaaabbbibbbbbbbaaaaaaaaaaaaaa
aaaaaaabbbbbbbaaaaaaaaaaaaaaaaaa
aaaaaaabbbbbbbaaaaaaaaaaaaaaaaaa
"}
