"a" = (/turf/dmm_suite/clear_turf,/area/dmm_suite/clear_area)
"b" = (/turf/dmm_suite/no_wall,/area/dmm_suite/clear_area)
"c" = (/turf/simulated/wall/brick/grey,/area/dmm_suite/clear_area)
"d" = (/turf/simulated/floor/brick/grey,/area/dmm_suite/clear_area)
"e" = (/obj/structure/interactive/crate/chest/filled,/turf/simulated/floor/brick/grey,/area/dmm_suite/clear_area)
"f" = (/obj/structure/interactive/door/wood,/turf/simulated/floor/brick/grey,/area/dmm_suite/clear_area)
"g" = (/obj/marker/lobby,/turf/dmm_suite/no_wall,/area/dmm_suite/clear_area)
"h" = (/mob/living/simple/goliath/ancient,/turf/simulated/floor/brick/grey,/area/dmm_suite/clear_area)
"i" = (/mob/living/simple/goliath,/turf/dmm_suite/no_wall,/area/dmm_suite/clear_area)
"j" = (/mob/living/simple/goliath/broodmother,/turf/dmm_suite/no_wall,/area/dmm_suite/clear_area)

(1,1,1) = {"
aaaaaaaaaabbbbbbbaaaaaaaaaaaaaaa
aaaaaaaaaabbbbbbbaaaaaaaaaaaaaaa
aaaaaaaaaabbbbbbbaaaaaaaaaaaaaaa
aaaaaaaaaabbbbbbbaaaaaaaaaaaaaaa
aaaaabbbbbbbbbbbbbbbbaaaaaaaaaaa
aaaabccccccbbbbbbbbbbbbaaaaaaaaa
aaaabcdddecbbbbbbbbbbbbbbaaaaaaa
aaaabcdhddfbbibbbccccfcccaaaaaaa
aaaabcddddcbbbbbbcdddddecaaaaaaa
aaaabcddddcbbbbbbfddddddcaaaaaaa
bbbbbccfcccbbgbbbcddddhdcaaaaaaa
bbbbbbbbbbbbbbbbbcddddddcaaaaaaa
bbbbbbbbbbbbbjbbbcddddddcaaaaaaa
bbbbbbibbbbbbbbbbcccccfccaaaaaaa
aaaabbbbbbbbbbbbbbbbbbbbbbbbbbaa
aaaabbbbbbbbbbbbbbbbbbbbbbbbbbbb
aaaabbbbbcfccccccccbbibbbbbbbbbb
aaaabbbbbcdddddddecbbbbbbbbbbbbb
aaaabbbbbcdddddddddbbbbbbbbbbbbb
aaaaaaaabcddhdddddcbbbbbaaaaaaaa
aaaaaaaabcddddddddcbbaaaaaaaaaaa
aaaaaaaabcddddddddcbbaaaaaaaaaaa
aaaaaaaaaccccccfcccbaaaaaaaaaaaa
aaaaaaaaabbbbbbbbbbaaaaaaaaaaaaa
aaaaaaaaabbbbbbbbbbaaaaaaaaaaaaa
aaaaaaaaabbbbbbbbbaaaaaaaaaaaaaa
aaaaaaabbbbbbbbbbbaaaaaaaaaaaaaa
aaaaaaabbbbbbbbbbbaaaaaaaaaaaaaa
aaaaaaabbbbbbbbbbbaaaaaaaaaaaaaa
aaaaaaabbbbbbbbbbbaaaaaaaaaaaaaa
aaaaaaabbbbbbbaaaaaaaaaaaaaaaaaa
aaaaaaabbbbbbbaaaaaaaaaaaaaaaaaa
"}
