"a" = (/turf/dmm_suite/clear_turf,/area/dmm_suite/clear_area)
"b" = (/turf/dmm_suite/no_wall,/area/dmm_suite/clear_area)
"c" = (/turf/simulated/wall/brick/grey,/area/dmm_suite/clear_area)
"d" = (/turf/simulated/floor/brick/grey,/area/dmm_suite/clear_area)
"e" = (/obj/structure/interactive/crate/chest/filled,/turf/simulated/floor/brick/grey,/area/dmm_suite/clear_area)
"f" = (/obj/structure/interactive/door/wood,/turf/simulated/floor/brick/grey,/area/dmm_suite/clear_area)
"g" = (/obj/marker/lobby,/turf/dmm_suite/no_wall,/area/dmm_suite/clear_area)
"h" = (/mob/living/simple/goliath/ancient,/turf/simulated/floor/brick/grey,/area/dmm_suite/clear_area)
"i" = (/mob/living/simple/goliath,/turf/dmm_suite/no_wall,/area/dmm_suite/clear_area)
"j" = (/mob/living/simple/goliath/broodmother,/turf/dmm_suite/no_wall,/area/dmm_suite/clear_area)
"k" = (/obj/marker/objective_spawn,/turf/simulated/floor/brick/grey,/area/dmm_suite/clear_area)
"l" = (/obj/marker/map_node,/turf/dmm_suite/no_wall,/area/dmm_suite/clear_area)
"m" = (/obj/marker/map_node,/mob/living/simple/goliath/ancient,/turf/simulated/floor/brick/grey,/area/dmm_suite/clear_area)
"n" = (/obj/marker/map_node,/mob/living/simple/goliath,/turf/dmm_suite/no_wall,/area/dmm_suite/clear_area)
"o" = (/obj/marker/map_node,/turf/simulated/floor/brick/grey,/area/dmm_suite/clear_area)

(1,1,1) = {"
aaaaaaaaaabbbbbbbaaaaaaaaaaaaaaa
aaaaaaaaaabbblbbbaaaaaaaaaaaaaaa
aaaaaaaaaabbbbbbbaaaaaaaaaaaaaaa
aaaaaaaaaabbbbbbbaaaaaaaaaaaaaaa
aaaaabbbbbbbbbbbbbbbbaaaaaaaaaaa
aaaabccccccbbbbbbbbbblbaaaaaaaaa
aaaabcdddecbbbbbbbbbbbbbbaaaaaaa
aaaabcdmddfbbnbbbccccfcccaaaaaaa
aaaabcddddcbbbbbbcdddddecaaaaaaa
aaaabcddddcbblbblfdddoddcaaaaaaa
bbbbbccfcccbbgbbbcddddhdcaaaaaaa
bbbbbbbbbbbbbbbbbcddddddcaaaaaaa
blbbbbblbbbbbjbbbcddddddcaaaaaaa
bbbbbbibbbbbbbbbbcccccfccaaaaaaa
aaaabbbbbbbbbbbbbbbbbblbbbbbbbaa
aaaabbbbbblbbbbbbbbbbbbbbbbbbbbb
aaaabbbbbcfccccccccbbibbbbbbblbb
aaaabbbbbcoddddddecbbbbbbbbbbbbb
aaaabbbbbcdddddddddbbbbbbbbbbbbb
aaaaaaaabcddhdkdddcbbbbbaaaaaaaa
aaaaaaaabcddddddddcbbaaaaaaaaaaa
aaaaaaaabcdddddoddcbbaaaaaaaaaaa
aaaaaaaaaccccccfcccbaaaaaaaaaaaa
aaaaaaaaabbbbbblbbbaaaaaaaaaaaaa
aaaaaaaaabbbbbbbbbbaaaaaaaaaaaaa
aaaaaaaaabbbbbbbbbaaaaaaaaaaaaaa
aaaaaaabbbbbbbbbbbaaaaaaaaaaaaaa
aaaaaaabbbbbbbbbbbaaaaaaaaaaaaaa
aaaaaaabbbblbbbbbbaaaaaaaaaaaaaa
aaaaaaabbbbbbbbbbbaaaaaaaaaaaaaa
aaaaaaabbbbbbbaaaaaaaaaaaaaaaaaa
aaaaaaabbbbbbbaaaaaaaaaaaaaaaaaa
"}
