"a" = (/turf/dmm_suite/clear_turf,/area/dmm_suite/clear_area)
"b" = (/turf/dmm_suite/no_wall,/area/dmm_suite/clear_area)
"c" = (/turf/simulated/wall/brick/grey,/area/dmm_suite/clear_area)
"d" = (/turf/simulated/floor/brick/grey,/area/dmm_suite/clear_area)
"e" = (/obj/structure/interactive/crate/chest/filled,/turf/simulated/floor/brick/grey,/area/dmm_suite/clear_area)
"f" = (/obj/structure/interactive/door/wood,/turf/simulated/floor/brick/grey,/area/dmm_suite/clear_area)
"g" = (/obj/marker/lobby,/turf/dmm_suite/no_wall,/area/dmm_suite/clear_area)
"h" = (/obj/marker/map_node/x3,/turf/dmm_suite/no_wall,/area/dmm_suite/clear_area)
"i" = (/obj/marker/map_node/x2,/turf/dmm_suite/no_wall,/area/dmm_suite/clear_area)
"j" = (/mob/living/simple/goliath/broodmother,/turf/dmm_suite/no_wall,/area/dmm_suite/clear_area)
"k" = (/obj/marker/objective_spawn,/turf/simulated/floor/brick/grey,/area/dmm_suite/clear_area)
"l" = (/obj/marker/map_node,/turf/dmm_suite/no_wall,/area/dmm_suite/clear_area)
"o" = (/obj/marker/map_node,/turf/simulated/floor/brick/grey,/area/dmm_suite/clear_area)

(1,1,1) = {"
aaaaaaaaaabbbbbbbaaaaaaaaaaaaaaa
aaaaaaaaaabbbbbbbaaaaaaaaaaaaaaa
aaaaaaaaaabbbhbbbaaaaaaaaaaaaaaa
aaaaaaaaaabbbbbbbaaaaaaaaaaaaaaa
aaaaabbbbbbbbbbbbbbbbaaaaaaaaaaa
aaaabccccccbbbbbbbbbbbbaaaaaaaaa
aaaabcdddecbbbbbbbbbblbbbaaaaaaa
aaaabcdodoflbibbbccccfcccaaaaaaa
aaaabcddddcbbbbbbcdddodecaaaaaaa
aaaabcdoddcbbbbblfodddddcaaaaaaa
bbbbbccfcccbbgbbbcddkdddcaaaaaaa
bbbbbbblbbbbbbbbbcddddddcaaaaaaa
bibbbbbbbbbbbjbbbcddddodcaaaaaaa
bbbbbbbbbibbbibbbcccccfccaaaaaaa
aaaabbibbbbbbbbbbbbbbblbbbbbbbaa
aaaabbbbbblbbbbblbblbbbbbbbbbbbb
aaaabbbbbcfccccccccbbbbbbbbbbbbb
aaaabbbbbcoddddddecbbbbbbibbbbib
aaaabbbbbcdddddddodlbbbbbbbbbbbb
aaaaaaaabcddddddddcbbbbbaaaaaaaa
aaaaaaaabcddddddddcbbaaaaaaaaaaa
aaaaaaaabcdddddoddcbbaaaaaaaaaaa
aaaaaaaaaccccccfcccbaaaaaaaaaaaa
aaaaaaaaabbbbbblbbbaaaaaaaaaaaaa
aaaaaaaaabbbbbbbbbbaaaaaaaaaaaaa
aaaaaaaaabbibbbhbbaaaaaaaaaaaaaa
aaaaaaabbbbbbbbbbbaaaaaaaaaaaaaa
aaaaaaabbbbbbbbbbbaaaaaaaaaaaaaa
aaaaaaabbbbbblbbbbaaaaaaaaaaaaaa
aaaaaaabbbhbbbbbbbaaaaaaaaaaaaaa
aaaaaaabbbbbbbaaaaaaaaaaaaaaaaaa
aaaaaaabbbbbbbaaaaaaaaaaaaaaaaaa
"}
