"a" = (/turf/simulated/wall/boss,/area/dmm_suite/clear_area)
"b" = (/turf/simulated/floor/colored/ash/rocky,/area/dmm_suite/clear_area)
"c" = (/mob/living/simple/bubblegum,/turf/simulated/floor/colored/ash/rocky,/area/dmm_suite/clear_area)
"d" = (/turf/dmm_suite/clear_turf,/area/dmm_suite/clear_area)
"e" = (/turf/dmm_suite/no_wall,/area/dmm_suite/clear_area)
"f" = (/turf/simulated/floor/basalt,/area/dmm_suite/clear_area)
"h" = (/obj/marker/lobby,/turf/simulated/floor/colored/ash/rocky,/area/dmm_suite/clear_area)
"i" = (/obj/marker/objective_spawn,/turf/simulated/floor/colored/ash/rocky,/area/dmm_suite/clear_area)
"j" = (/turf/simulated/liquid/lava,/area/dmm_suite/clear_area)
"C" = (/obj/structure/interactive/crate/chest/filled,/turf/simulated/floor/colored/ash/rocky,/area/dmm_suite/clear_area)
"O" = (/obj/structure/interactive/crate/chest/filled,/turf/simulated/floor/basalt,/area/dmm_suite/clear_area)

(1,1,1) = {"
adeeeddaaaaaaaadeeeddaaaaadddddd
adeeedddaaaaaaaaeeeaaaaaaaaaaddd
adeeeeeeffjjjfbbeeebbbbbeeeeeeee
aaebbbbbfffffffbbeebbbbbbbeeeeee
aaebbbbbbfffffffbebbbbbbbbbbbeee
aaaaaaaaaaaaaaaabbbaaaaaaaabbbad
aaffObbbbbbbbbbbbffajjjjjfObbbad
aajjffbbbbbbbffffffjjffffffbbbad
aajjjffbbbbbfffjjjjjffbbbbbbbbad
daaaaafbbaaaaajjjjjjfbbaaaaaaadd
eeeeeafbbajjjjjjjjjafbbeeeeeeeee
eeeeeabbbajjfffffffabbbbeeeeeeee
eeeeeabbbajffbbbbbiabbbbbbeeeeee
ddeeeabbbaffbbbbbbaabbbaaaaddadd
ddeeedbbbafbbbbbbbbbbbbCffbbbbdd
aaeebbbbbbbbbbbcbbbbbbbbbbbbbbad
aaeebbbbbbbbbbbbbbbbbbbbbbbbbfaa
aaeebbbbbbbbhbbbbbaaaaabbbabbfja
aaebbaffbabbbbbbbbajjjabbbabbfja
aabbbaffbabbbbbbjjjjjjabbfabbfaa
aabbbafffabbffjjjjafffabbfabbbaa
aabbbjjjfabbfaaaaaafbfabbfabbeda
aabbbjjjfabbffffOfffbfffbfabbeaa
aabbbajffabbbbbbbbbbbbbfffabbeaa
aabbbaffbabbbbbbbbbbbbbfjjabbeda
aabbbafbbaaaaaaaaaabbbaaajabbeda
aabbeddaaaaaaaaaaaabbbaaaaabbedd
aabbeeeebbbbffffbbbbbbbbbbbbeeee
adbbeeeeebbbbbbbbbbbbbbeeeeeeeee
ddbeeeeeeeeeeeeeeeeebeeeeeeeeeee
deeeddaaaaaaaaaadddeeedddddaaaaa
deeeddaaaaaaaaaaaddeeeddaaaaaaaa
"}
