"a" = (/turf/simulated/wall/boss,/area/dmm_suite/clear_area)
"b" = (/turf/simulated/floor/colored/ash/rocky,/area/dmm_suite/clear_area)
"c" = (/obj/marker/map_node/x2,/turf/dmm_suite/no_wall,/area/dmm_suite/clear_area)
"d" = (/turf/dmm_suite/clear_turf,/area/dmm_suite/clear_area)
"e" = (/turf/dmm_suite/no_wall,/area/dmm_suite/clear_area)
"f" = (/turf/simulated/floor/basalt,/area/dmm_suite/clear_area)
"g" = (/obj/marker/map_node/x2,/turf/simulated/floor/colored/ash/rocky,/area/dmm_suite/clear_area)
"h" = (/obj/marker/lobby,/turf/simulated/floor/colored/ash/rocky,/area/dmm_suite/clear_area)
"i" = (/obj/marker/objective_spawn,/turf/simulated/floor/colored/ash/rocky,/area/dmm_suite/clear_area)
"j" = (/turf/simulated/liquid/lava,/area/dmm_suite/clear_area)
"k" = (/obj/marker/map_node/x2,/mob/living/simple/bubblegum,/turf/simulated/floor/colored/ash/rocky,/area/dmm_suite/clear_area)
"l" = (/obj/marker/map_node,/turf/simulated/floor/colored/ash/rocky,/area/dmm_suite/clear_area)
"m" = (/obj/marker/map_node,/turf/simulated/floor/basalt,/area/dmm_suite/clear_area)
"n" = (/obj/marker/map_node,/turf/dmm_suite/clear_turf,/area/dmm_suite/clear_area)
"o" = (/obj/marker/map_node,/turf/dmm_suite/no_wall,/area/dmm_suite/clear_area)
"C" = (/obj/structure/interactive/crate/chest/filled,/turf/simulated/floor/colored/ash/rocky,/area/dmm_suite/clear_area)
"O" = (/obj/structure/interactive/crate/chest/filled,/turf/simulated/floor/basalt,/area/dmm_suite/clear_area)

(1,1,1) = {"
adeeeddaaaaaaaadeeeddaaaaadddddd
adecedddaaaaaaaaeceaaaaaaaaaaddd
adeeeeeeffjjjfbbeeebbbbbeeeeeeee
aaebbbbbfffffffbboebbgbbbbeceece
aaebbbblbfffmfffbebbbbbbbbbbbeee
aaaaaaaaaaaaaaaabbbaaaaaaaabbbad
aaffObbbbbbbbbbbbffajjjjjfObbbad
aajjffbgbbbbgffffffjjffffffblbad
aajjjffbbbbbfffjjjjjfmbbblbbbbad
daaaaafbbaaaaajjjjjjfbbaaaaaaadd
eeeeeafbbajjjjjjjjjafbbeeeeeeeee
eceeeabbbajjfffffffabgbbeeeeeece
eeeeeabgbajffbbbbbiabbbbbbeeeeee
ddeeeabbbaffbbbbbbaabbbaaaaddadd
ddecedbbbafbbbbbbbbbbbbCffbbbbdd
aaeebbbbbbbbbbbkbblbbgbbbbbgbbad
aaeebbbgbbbgbbbbbbbbbbbbgbbbbfaa
aaecbbbbbbbbhbbbbbaaaaabbbabbfja
aaebbaffbabbbbbbbbajjjabbbabbfja
aabbbaffbablbbbbjjjjjjabbfabbfaa
aabbbaffmabbffjjjjafffabgfabgbaa
aabgbjjjfabbfaaaaaafbfabbfabbeda
aabbbjjjfabbffffOfffbffflfabbeaa
aabbbajfmabgbbbblbbbgbbmffabbeaa
aabbbaffbabbbbbbbbbbbbbfjjabbeda
aabgbamblaaaaaaaaaabbbaaajabgeda
aabbednaaaaaaaaaaaabbbaaaaabbedd
aabbeeeebbbbffffbbbbgbbbbbbbeeee
adbgeeecebbgbbbbbgbbbbbceeeceece
ddbeeeeeeeeeeeeeeeeebeeeeeeeeeee
deeeddaaaaaaaaaadddecedddddaaaaa
deeeddaaaaaaaaaaaddeeeddaaaaaaaa
"}
