//MAP CONVERTED BY dmm2tgm.py THIS HEADER COMMENT PREVENTS RECONVERSION, DO NOT REMOVE
"a" = (
/turf/dmm_suite/clear_turf,
/area/dmm_suite/clear_area)
"b" = (
/turf/dmm_suite/no_wall,
/area/dmm_suite/clear_area)
"c" = (
/turf/simulated/wall/brick/grey,
/area/dmm_suite/clear_area)
"d" = (
/turf/simulated/floor/brick/grey,
/area/dmm_suite/clear_area)
"e" = (
/obj/structure/interactive/door/wood,
/turf/simulated/floor/brick/grey,
/area/dmm_suite/clear_area)
"f" = (
/obj/marker/lobby,
/turf/dmm_suite/no_wall,
/area/dmm_suite/clear_area)
"g" = (
/mob/living/simple/can_man,
/turf/dmm_suite/no_wall,
/area/dmm_suite/clear_area)
"h" = (
/obj/marker/objective_spawn,
/turf/simulated/floor/brick/grey,
/area/dmm_suite/clear_area)

(1,1,1) = {"
a
a
a
a
a
a
a
a
a
a
b
b
b
b
a
a
a
a
a
a
a
a
a
a
a
a
a
a
a
a
a
a
"}
(2,1,1) = {"
a
a
a
a
a
a
a
a
a
a
b
b
b
b
a
a
a
a
a
a
a
a
a
a
a
a
a
a
a
a
a
a
"}
(3,1,1) = {"
a
a
a
a
a
a
a
a
a
a
b
b
b
b
a
a
a
a
a
a
a
a
a
a
a
a
a
a
a
a
a
a
"}
(4,1,1) = {"
a
a
a
a
a
a
a
a
a
a
b
b
b
b
a
a
a
a
a
a
a
a
a
a
a
a
a
a
a
a
a
a
"}
(5,1,1) = {"
a
a
a
a
a
b
b
b
b
b
b
b
b
b
b
b
b
b
b
a
a
a
a
a
a
a
a
a
a
a
a
a
"}
(6,1,1) = {"
a
a
a
a
b
c
c
c
c
c
c
b
b
b
b
b
b
b
b
a
a
a
a
a
a
a
a
a
a
a
a
a
"}
(7,1,1) = {"
a
a
a
a
b
c
h
d
d
d
c
b
b
b
b
b
b
b
b
a
a
a
a
a
a
a
a
a
a
a
a
a
"}
(8,1,1) = {"
a
a
a
a
b
c
d
d
d
d
e
b
b
b
b
b
b
b
b
a
a
a
a
a
a
a
b
b
b
b
b
b
"}
(9,1,1) = {"
a
a
a
a
b
c
d
d
d
d
c
b
b
b
b
b
b
b
b
b
b
b
a
a
a
a
b
b
b
b
b
b
"}
(10,1,1) = {"
a
a
a
a
b
c
d
d
d
d
c
b
b
b
b
b
c
c
c
c
c
c
c
b
b
b
b
b
b
b
b
b
"}
(11,1,1) = {"
b
b
b
b
b
c
c
e
c
c
c
b
b
b
b
b
e
d
d
d
d
d
c
b
b
b
b
b
b
b
b
b
"}
(12,1,1) = {"
b
b
b
b
b
b
b
b
b
b
b
b
b
b
b
b
c
d
d
d
d
d
c
b
b
b
b
b
b
b
b
b
"}
(13,1,1) = {"
b
b
b
b
b
b
b
b
b
b
b
b
b
b
b
b
c
d
d
d
d
d
c
b
b
b
b
b
b
b
b
b
"}
(14,1,1) = {"
b
b
b
b
b
b
b
b
b
b
f
b
g
b
b
b
c
d
d
d
d
d
c
b
b
b
b
b
b
b
b
b
"}
(15,1,1) = {"
b
b
b
b
b
b
b
b
b
b
b
b
b
b
b
b
c
d
d
d
d
d
c
b
b
b
b
b
b
b
a
a
"}
(16,1,1) = {"
b
b
b
b
b
b
b
b
b
b
b
b
b
b
b
b
c
d
d
d
d
d
e
b
b
b
b
b
b
b
a
a
"}
(17,1,1) = {"
b
b
b
b
b
b
b
b
b
b
b
b
b
b
b
b
c
d
d
d
d
d
c
b
b
b
b
b
b
b
a
a
"}
(18,1,1) = {"
a
a
a
a
b
b
b
c
c
e
c
c
c
c
b
b
c
d
d
d
d
d
c
b
b
b
b
b
b
b
a
a
"}
(19,1,1) = {"
a
a
a
a
b
b
b
c
d
d
d
d
d
c
b
b
c
c
d
c
c
c
c
b
b
a
a
a
a
a
a
a
"}
(20,1,1) = {"
a
a
a
a
b
b
b
c
d
d
d
d
d
c
b
b
b
b
b
b
b
b
b
a
a
a
a
a
a
a
a
a
"}
(21,1,1) = {"
a
a
a
a
b
b
b
c
d
d
d
d
d
c
b
b
b
b
b
b
b
b
a
a
a
a
a
a
a
a
a
a
"}
(22,1,1) = {"
a
a
a
a
a
b
b
e
d
d
d
d
d
c
b
b
b
b
b
b
a
a
a
a
a
a
a
a
a
a
a
a
"}
(23,1,1) = {"
a
a
a
a
a
b
b
c
d
d
d
d
d
e
b
b
b
b
b
b
a
a
a
a
a
a
a
a
a
a
a
a
"}
(24,1,1) = {"
a
a
a
a
a
a
b
c
d
d
d
d
d
c
b
b
b
b
b
b
a
a
a
a
a
a
a
a
a
a
a
a
"}
(25,1,1) = {"
a
a
a
a
a
a
b
c
c
c
c
c
c
c
b
b
b
b
b
a
a
a
a
a
a
a
a
a
a
a
a
a
"}
(26,1,1) = {"
a
a
a
a
a
a
a
a
a
a
a
a
a
a
b
b
b
b
b
a
a
a
a
a
a
a
a
a
a
a
a
a
"}
(27,1,1) = {"
a
a
a
a
a
a
a
a
a
a
a
a
a
a
b
b
b
b
b
a
a
a
a
a
a
a
a
a
a
a
a
a
"}
(28,1,1) = {"
a
a
a
a
a
a
a
a
a
a
a
a
a
a
b
b
b
b
b
a
a
a
a
a
a
a
a
a
a
a
a
a
"}
(29,1,1) = {"
a
a
a
a
a
a
a
a
a
a
a
a
a
a
b
b
b
b
b
a
a
a
a
a
a
a
a
a
a
a
a
a
"}
(30,1,1) = {"
a
a
a
a
a
a
a
a
a
a
a
a
a
a
b
b
b
b
b
a
a
a
a
a
a
a
a
a
a
a
a
a
"}
(31,1,1) = {"
a
a
a
a
a
a
a
a
a
a
a
a
a
a
a
b
b
b
b
a
a
a
a
a
a
a
a
a
a
a
a
a
"}
(32,1,1) = {"
a
a
a
a
a
a
a
a
a
a
a
a
a
a
a
b
b
b
b
a
a
a
a
a
a
a
a
a
a
a
a
a
"}
