"a" = (/turf/simulated/wall/metal/reinforced,/area/dmm_suite/clear_area)
"b" = (/obj/structure/interactive/door/airlock/external,/turf/simulated/floor/plating,/area/dmm_suite/clear_area)
"c" = (/turf/simulated/floor/snow_plating,/area/dmm_suite/clear_area)
"d" = (/turf/simulated/floor/plating,/area/dmm_suite/clear_area)
"e" = (/obj/structure/interactive/crate/chest/filled,/turf/simulated/floor/plating,/area/dmm_suite/clear_area)
"f" = (/turf/simulated/floor/colored/snow,/area/dmm_suite/clear_area)
"g" = (/turf/simulated/floor/ice,/area/dmm_suite/clear_area)
"h" = (/obj/structure/scenery/grass/snow,/turf/simulated/floor/colored/snow,/area/dmm_suite/clear_area)
"i" = (/turf/simulated/floor/colored/dirt/snow,/area/dmm_suite/clear_area)
"j" = (/obj/structure/interactive/vending/random,/turf/simulated/floor/plating,/area/dmm_suite/clear_area)
"k" = (/mob/living/simple/colossus,/turf/simulated/floor/ice,/area/dmm_suite/clear_area)
"l" = (/obj/marker/lobby,/turf/simulated/floor/ice,/area/dmm_suite/clear_area)
"m" = (/obj/marker/objective_spawn,/turf/simulated/floor/colored/dirt/snow,/area/dmm_suite/clear_area)
"n" = (/turf/dmm_suite/clear_turf,/area/dmm_suite/clear_area)
"o" = (/turf/dmm_suite/no_wall,/area/dmm_suite/clear_area)
"p" = (/obj/marker/map_node,/turf/dmm_suite/no_wall,/area/dmm_suite/clear_area)
"q" = (/obj/marker/map_node,/turf/simulated/floor/plating,/area/dmm_suite/clear_area)
"r" = (/obj/marker/map_node,/turf/simulated/floor/colored/dirt/snow,/area/dmm_suite/clear_area)
"s" = (/obj/marker/map_node,/turf/simulated/floor/colored/snow,/area/dmm_suite/clear_area)
"t" = (/obj/marker/map_node,/turf/simulated/floor/ice,/area/dmm_suite/clear_area)
"u" = (/obj/marker/map_node/x2,/turf/simulated/floor/colored/snow,/area/dmm_suite/clear_area)
"v" = (/obj/marker/map_node/x3,/turf/simulated/floor/colored/dirt/snow,/area/dmm_suite/clear_area)
"w" = (/obj/marker/map_node/x3,/turf/simulated/floor/colored/snow,/area/dmm_suite/clear_area)
"x" = (/obj/structure/scenery/grass/snow,/obj/marker/map_node/x2,/turf/simulated/floor/colored/snow,/area/dmm_suite/clear_area)
"y" = (/obj/marker/map_node/x5,/turf/simulated/floor/snow_plating,/area/dmm_suite/clear_area)

(1,1,1) = {"
nnnnnnnnnopooponnnnnnnnnnnnnnnnn
naaaaaaaaabaabaaaaaaaaaaaaaaaaan
naccccccadqdeqdaccccccccccccccan
nacfffffaddddddafffffffffffffcan
nacfffffadqddqdaffffufggggfffcan
nacfhhhfaabaabaaffgggggggaaaaaan
nacfxhhfffriirmfffgggggggadedjan
nacfhhhhfffiffiiiffgggggtbqddqbp
nacfhhhhfffifffuiiiifggggaddddao
nacffffffffifffffffiiviiiaddddao
naaaaaaffwiifggggffffhhhrbqddqbp
naeddjafffifggggggffhhhhiaddddan
pbqdddaffiifgggkgggfhhhhiaaaaaan
pbqdddaffiffggglgggfhhhhiffffcan
oaddddafiifffgggggfffhhhiffffcan
oadddqbrifffffgggffffffifffffcan
oadddqbriiifffffffffffiifffffcan
oaddddafffviiiifffffivifffwffcan
pbqdddafffffffiiffiiiffffffffcan
pbqdddafffffhhhiviiffffffffffcan
nadddeaffffhhhhhiffffcccccfffcan
naaaaaafffhhhhhhiffffcccccfffcan
nacffffffuhhhhhfiffffcccccfffcan
nacfffffffffhhffiffffcccccfffcan
nacfxhhffffffsffrffffcccycfffcan
nacfhhhffffaabaabaaffcccccfffcan
nacfhhhhfffadddeddaffcccccfffcan
nacfhhhhhffaddddddaffcccccfffcan
nacffffufffaddddddaffffffffffcan
nacccccccccaddddddacccccccccccan
naaaaaaaaaaaabaabaaaaaaaaaaaaaan
nnnnnnnnnnnnnpooponnnnnnnnnnnnnn
"}
