//MAP CONVERTED BY dmm2tgm.py THIS HEADER COMMENT PREVENTS RECONVERSION, DO NOT REMOVE
"a" = (
/turf/simulated/wall/metal/reinforced,
/area/mission/prefab/boss/colossus)
"b" = (
/obj/structure/interactive/door/airlock/external,
/turf/simulated/floor/plating,
/area/mission/prefab/boss/colossus)
"c" = (
/turf/simulated/floor/snow_plating,
/area/mission/prefab/boss/colossus)
"d" = (
/turf/simulated/floor/plating,
/area/mission/prefab/boss/colossus)
"e" = (
/obj/marker/map_node,
/turf/simulated/floor/plating,
/area/mission/prefab/boss/colossus)
"f" = (
/obj/structure/interactive/crate/chest/filled,
/turf/simulated/floor/plating,
/area/mission/prefab/boss/colossus)
"g" = (
/turf/simulated/floor/colored/snow,
/area/mission/prefab/boss/colossus)
"h" = (
/obj/marker/map_node/x2,
/turf/simulated/floor/colored/snow,
/area/mission/prefab/boss/colossus)
"i" = (
/turf/simulated/floor/ice,
/area/mission/prefab/boss/colossus)
"j" = (
/obj/structure/scenery/grass/snow,
/turf/simulated/floor/colored/snow,
/area/mission/prefab/boss/colossus)
"k" = (
/obj/structure/scenery/grass/snow,
/obj/marker/map_node/x2,
/turf/simulated/floor/colored/snow,
/area/mission/prefab/boss/colossus)
"l" = (
/obj/marker/map_node,
/turf/simulated/floor/colored/dirt/snow,
/area/mission/prefab/boss/colossus)
"m" = (
/turf/simulated/floor/colored/dirt/snow,
/area/mission/prefab/boss/colossus)
"n" = (
/turf/dmm_suite/clear_turf,
/area/dmm_suite/clear_area)
"o" = (
/turf/dmm_suite/no_wall,
/area/dmm_suite/clear_area)
"p" = (
/obj/marker/map_node,
/turf/dmm_suite/no_wall,
/area/dmm_suite/clear_area)
"q" = (
/obj/marker/objective_spawn,
/turf/simulated/floor/colored/dirt/snow,
/area/mission/prefab/boss/colossus)
"r" = (
/obj/structure/interactive/vending/random,
/turf/simulated/floor/plating,
/area/mission/prefab/boss/colossus)
"s" = (
/obj/marker/map_node,
/turf/simulated/floor/ice,
/area/mission/prefab/boss/colossus)
"t" = (
/obj/marker/map_node/x3,
/turf/simulated/floor/colored/dirt/snow,
/area/mission/prefab/boss/colossus)
"u" = (
/obj/marker/map_node/x3,
/turf/simulated/floor/colored/snow,
/area/mission/prefab/boss/colossus)
"v" = (
/mob/living/simple/colossus,
/turf/simulated/floor/ice,
/area/mission/prefab/boss/colossus)
"w" = (
/obj/marker/lobby,
/turf/simulated/floor/ice,
/area/mission/prefab/boss/colossus)
"x" = (
/obj/marker/map_node,
/turf/simulated/floor/colored/snow,
/area/mission/prefab/boss/colossus)
"y" = (
/obj/marker/map_node/x5,
/turf/simulated/floor/snow_plating,
/area/mission/prefab/boss/colossus)
"z" = (
/obj/marker/smart_clear_turf,
/turf/dmm_suite/no_wall,
/area/dmm_suite/clear_area)

(1,1,1) = {"
n
n
n
n
n
n
n
n
n
n
n
n
p
p
z
o
o
z
p
p
n
n
n
n
n
n
n
n
n
n
n
n
"}
(2,1,1) = {"
n
a
a
a
a
a
a
a
a
a
a
a
b
b
a
a
a
a
b
b
a
a
a
a
a
a
a
a
a
a
a
n
"}
(3,1,1) = {"
n
a
c
c
c
c
c
c
c
c
a
f
e
e
d
d
d
d
e
e
d
a
c
c
c
c
c
c
c
c
a
n
"}
(4,1,1) = {"
n
a
c
g
g
g
g
g
g
g
a
d
d
d
d
d
d
d
d
d
d
a
g
g
g
g
g
g
g
c
a
n
"}
(5,1,1) = {"
n
a
c
g
g
j
k
j
j
g
a
d
d
d
d
d
d
d
d
d
d
a
g
g
k
j
j
j
g
c
a
n
"}
(6,1,1) = {"
n
a
c
g
g
j
j
j
j
g
a
r
d
d
d
e
e
d
d
d
f
a
g
g
j
j
j
j
g
c
a
n
"}
(7,1,1) = {"
n
a
c
g
g
j
j
j
j
g
a
a
a
a
a
b
b
a
a
a
a
a
g
g
j
j
j
j
g
c
a
n
"}
(8,1,1) = {"
n
a
c
g
g
g
g
j
j
g
g
g
g
g
g
l
l
g
g
g
g
g
g
g
g
g
j
j
h
c
a
n
"}
(9,1,1) = {"
n
a
a
a
a
a
g
g
g
g
g
g
g
g
m
m
m
g
g
g
g
g
g
g
g
g
g
j
g
c
a
n
"}
(10,1,1) = {"
o
a
d
d
d
a
g
g
g
g
u
g
m
m
m
g
m
g
g
g
g
g
h
g
g
g
g
g
g
c
a
n
"}
(11,1,1) = {"
p
b
e
d
e
b
l
g
g
g
m
m
m
g
g
g
m
t
g
g
g
j
j
g
g
g
g
g
g
c
a
n
"}
(12,1,1) = {"
o
a
d
d
d
a
m
m
m
m
m
g
g
g
g
g
g
m
g
g
j
j
j
g
g
a
a
a
a
a
a
n
"}
(13,1,1) = {"
z
a
f
d
d
a
m
g
g
g
g
i
i
i
g
g
g
m
g
j
j
j
j
j
g
a
d
d
d
d
a
n
"}
(14,1,1) = {"
p
b
e
d
e
b
l
g
g
g
i
i
i
i
i
g
g
m
g
j
j
j
j
j
x
b
d
d
d
d
b
p
"}
(15,1,1) = {"
o
a
d
d
d
a
q
m
g
g
i
i
i
i
i
i
g
m
m
j
j
j
j
g
g
a
d
d
d
d
a
o
"}
(16,1,1) = {"
n
a
a
a
a
a
g
m
h
g
i
i
v
w
i
i
g
g
m
m
j
j
g
g
g
a
f
d
d
d
a
z
"}
(17,1,1) = {"
n
a
c
g
g
g
g
m
m
g
i
i
i
i
i
i
g
g
g
t
m
m
m
m
l
b
d
d
d
d
b
p
"}
(18,1,1) = {"
n
a
c
g
g
g
g
g
m
g
g
i
i
i
i
g
g
g
g
m
g
g
g
g
g
a
d
d
d
d
a
o
"}
(19,1,1) = {"
n
a
c
g
g
i
i
g
m
g
g
g
i
i
g
g
g
g
m
m
g
g
g
g
g
a
a
a
a
a
a
n
"}
(20,1,1) = {"
n
a
c
g
g
i
i
i
m
m
g
g
g
g
g
g
g
g
m
g
g
g
g
g
g
g
g
g
g
c
a
n
"}
(21,1,1) = {"
n
a
c
g
h
i
i
i
g
m
g
j
j
j
g
g
g
m
m
g
g
g
g
g
g
g
g
g
g
c
a
n
"}
(22,1,1) = {"
n
a
c
g
g
i
i
i
i
t
j
j
j
j
j
g
g
t
g
g
c
c
c
c
c
c
c
c
g
c
a
n
"}
(23,1,1) = {"
n
a
c
g
i
i
i
i
i
m
j
j
j
j
j
g
m
m
g
g
c
c
c
c
c
c
c
c
g
c
a
n
"}
(24,1,1) = {"
n
a
c
g
i
i
i
i
i
m
j
j
j
j
j
m
m
g
g
g
c
c
c
c
c
c
c
c
g
c
a
n
"}
(25,1,1) = {"
n
a
c
g
i
i
i
s
i
m
l
m
m
m
m
g
g
g
g
g
c
c
c
c
y
c
c
c
g
c
a
n
"}
(26,1,1) = {"
n
a
c
g
i
a
a
b
a
a
b
a
a
g
g
g
g
g
g
g
c
c
c
c
c
c
c
c
g
c
a
n
"}
(27,1,1) = {"
n
a
c
g
g
a
d
e
d
d
e
d
a
g
g
g
g
u
g
g
g
g
g
g
g
g
g
g
g
c
a
n
"}
(28,1,1) = {"
n
a
c
g
g
a
f
d
d
d
d
d
a
g
g
g
g
g
g
g
g
g
g
g
g
g
g
g
g
c
a
n
"}
(29,1,1) = {"
n
a
c
g
g
a
d
d
d
d
d
d
a
g
g
g
g
g
g
g
g
g
g
g
g
g
g
g
g
c
a
n
"}
(30,1,1) = {"
n
a
c
c
c
a
r
e
d
d
e
d
a
c
c
c
c
c
c
c
c
c
c
c
c
c
c
c
c
c
a
n
"}
(31,1,1) = {"
n
a
a
a
a
a
a
b
a
a
b
a
a
a
a
a
a
a
a
a
a
a
a
a
a
a
a
a
a
a
a
n
"}
(32,1,1) = {"
n
n
n
n
n
n
n
p
z
o
p
n
n
n
n
n
n
n
n
n
n
n
n
n
n
n
n
n
n
n
n
n
"}
