"a" = (/turf/simulated/wall/metal/reinforced,/area/mission/prefab/boss/colossus)
"b" = (/obj/structure/interactive/door/airlock/external,/turf/simulated/floor/plating,/area/mission/prefab/boss/colossus)
"c" = (/turf/simulated/floor/snow_plating,/area/mission/prefab/boss/colossus)
"d" = (/turf/simulated/floor/plating,/area/mission/prefab/boss/colossus)
"e" = (/obj/marker/map_node,/turf/simulated/floor/plating,/area/mission/prefab/boss/colossus)
"f" = (/obj/structure/interactive/crate/chest/filled,/turf/simulated/floor/plating,/area/mission/prefab/boss/colossus)
"g" = (/turf/simulated/floor/colored/snow,/area/mission/prefab/boss/colossus)
"h" = (/obj/marker/map_node/x2,/turf/simulated/floor/colored/snow,/area/mission/prefab/boss/colossus)
"i" = (/turf/simulated/floor/ice,/area/mission/prefab/boss/colossus)
"j" = (/obj/structure/scenery/grass/snow,/turf/simulated/floor/colored/snow,/area/mission/prefab/boss/colossus)
"k" = (/obj/structure/scenery/grass/snow,/obj/marker/map_node/x2,/turf/simulated/floor/colored/snow,/area/mission/prefab/boss/colossus)
"l" = (/obj/marker/map_node,/turf/simulated/floor/colored/dirt/snow,/area/mission/prefab/boss/colossus)
"m" = (/turf/simulated/floor/colored/dirt/snow,/area/mission/prefab/boss/colossus)
"n" = (/turf/dmm_suite/clear_turf,/area/dmm_suite/clear_area)
"o" = (/turf/dmm_suite/no_wall,/area/dmm_suite/clear_area)
"p" = (/obj/marker/map_node,/turf/dmm_suite/no_wall,/area/dmm_suite/clear_area)
"q" = (/obj/marker/objective_spawn,/turf/simulated/floor/colored/dirt/snow,/area/mission/prefab/boss/colossus)
"r" = (/obj/structure/interactive/vending/random,/turf/simulated/floor/plating,/area/mission/prefab/boss/colossus)
"s" = (/obj/marker/map_node,/turf/simulated/floor/ice,/area/mission/prefab/boss/colossus)
"t" = (/obj/marker/map_node/x3,/turf/simulated/floor/colored/dirt/snow,/area/mission/prefab/boss/colossus)
"u" = (/obj/marker/map_node/x3,/turf/simulated/floor/colored/snow,/area/mission/prefab/boss/colossus)
"v" = (/mob/living/simple/colossus,/turf/simulated/floor/ice,/area/mission/prefab/boss/colossus)
"w" = (/obj/marker/lobby,/turf/simulated/floor/ice,/area/mission/prefab/boss/colossus)
"x" = (/obj/marker/map_node,/turf/simulated/floor/colored/snow,/area/mission/prefab/boss/colossus)
"y" = (/obj/marker/map_node/x5,/turf/simulated/floor/snow_plating,/area/mission/prefab/boss/colossus)
"z" = (/obj/marker/smart_clear_turf,/turf/dmm_suite/no_wall,/area/dmm_suite/clear_area)

(1,1,1) = {"
nnnnnnnnnopozponnnnnnnnnnnnnnnnn
naaaaaaaaabaabaaaaaaaaaaaaaaaaan
naccccccadedfedaccccccccccccccan
nacgggggaddddddagggggggggggggcan
nacgggggadeddedagggghgiiiigggcan
nacgjjjgaabaabaaggiiiiiiiaaaaaan
nacgkjjggglmmlqgggiiiiiiiadfdran
nacgjjjjgggmggmmmggiiiiisbeddebp
nacgjjjjgggmggghmmmmgiiiiaddddaz
nacggggggggmgggggggmmtmmmaddddao
naaaaaaggummgiiiiggggjjjlbeddebp
nafddragggmgiiiiiiggjjjjmaddddan
pbedddaggmmgiiiviiigjjjjmaaaaaan
pbedddaggmggiiiwiiigjjjjmggggcan
zaddddagmmgggiiiiigggjjjmggggcan
oadddeblmgggggiiiggggggmgggggcan
oadddeblmmmgggggggggggmmgggggcan
zaddddagggtmmmmgggggmtmggguggcan
pbedddagggggggmmggmmmggggggggcan
pbedddagggggjjjmtmmggggggggggcan
nadddfaggggjjjjjmggggcccccgggcan
naaaaaagggjjjjjjmggggcccccgggcan
nacgggggghjjjjjgmggggcccccgggcan
nacgggggggggjjggmggggcccccgggcan
nacgkjjggggggxgglggggcccycgggcan
nacgjjjggggaabaabaaggcccccgggcan
nacgjjjjgggadddfddaggcccccgggcan
nacgjjjjjggaddddddaggcccccgggcan
nacgggghgggaddddddaggggggggggcan
nacccccccccaddddddacccccccccccan
naaaaaaaaaaaabaabaaaaaaaaaaaaaan
nnnnnnnnnnnnnpozponnnnnnnnnnnnnn
"}
