//MAP CONVERTED BY dmm2tgm.py THIS HEADER COMMENT PREVENTS RECONVERSION, DO NOT REMOVE
"a" = (
/turf/simulated/wall/metal/reinforced,
/area/dmm_suite/clear_area)
"b" = (
/obj/structure/interactive/door/airlock/external,
/turf/simulated/floor/plating,
/area/dmm_suite/clear_area)
"c" = (
/turf/simulated/floor/snow_plating,
/area/dmm_suite/clear_area)
"d" = (
/turf/simulated/floor/plating,
/area/dmm_suite/clear_area)
"e" = (
/obj/structure/interactive/crate/chest/filled,
/turf/simulated/floor/plating,
/area/dmm_suite/clear_area)
"f" = (
/turf/simulated/floor/colored/snow,
/area/dmm_suite/clear_area)
"g" = (
/turf/simulated/floor/ice,
/area/dmm_suite/clear_area)
"h" = (
/obj/structure/scenery/grass/snow,
/turf/simulated/floor/colored/snow,
/area/dmm_suite/clear_area)
"i" = (
/turf/simulated/floor/colored/dirt/snow,
/area/dmm_suite/clear_area)
"j" = (
/obj/structure/interactive/vending/random,
/turf/simulated/floor/plating,
/area/dmm_suite/clear_area)
"k" = (
/mob/living/simple/colossus,
/turf/simulated/floor/ice,
/area/dmm_suite/clear_area)
"l" = (
/obj/marker/lobby,
/turf/simulated/floor/ice,
/area/dmm_suite/clear_area)
"m" = (
/obj/marker/objective_spawn,
/turf/simulated/floor/colored/dirt/snow,
/area/dmm_suite/clear_area)

(1,1,1) = {"
a
a
a
a
a
a
a
a
a
a
a
a
b
b
a
a
a
a
b
b
a
a
a
a
a
a
a
a
a
a
a
a
"}
(2,1,1) = {"
a
c
c
c
c
c
c
c
c
c
a
e
d
d
d
d
d
d
d
d
d
a
c
c
c
c
c
c
c
c
c
a
"}
(3,1,1) = {"
a
c
f
f
f
f
f
f
f
f
a
d
d
d
d
d
d
d
d
d
d
a
f
f
f
f
f
f
f
f
c
a
"}
(4,1,1) = {"
a
c
f
f
h
h
h
f
f
f
a
d
d
d
d
d
d
d
d
d
d
a
f
f
f
f
h
h
f
f
c
a
"}
(5,1,1) = {"
a
c
f
f
h
h
h
h
h
f
a
d
d
d
d
d
d
d
d
d
d
a
f
f
h
h
h
h
h
f
c
a
"}
(6,1,1) = {"
a
c
f
f
h
h
h
h
h
f
a
j
d
d
d
d
d
d
d
d
e
a
f
f
h
h
h
h
h
f
c
a
"}
(7,1,1) = {"
a
c
f
f
h
h
h
h
h
f
a
a
a
a
a
b
b
a
a
a
a
a
f
f
h
h
h
h
h
f
c
a
"}
(8,1,1) = {"
a
c
f
f
f
f
f
h
h
f
f
f
f
f
f
i
i
f
f
f
f
f
f
f
f
f
h
h
h
f
c
a
"}
(9,1,1) = {"
a
a
a
a
a
a
f
f
f
f
f
f
f
f
i
i
i
f
f
f
f
f
f
f
f
f
f
h
h
f
c
a
"}
(10,1,1) = {"
a
d
d
d
d
a
f
f
f
f
f
f
i
i
i
f
i
f
f
f
f
f
f
f
f
f
f
f
f
f
c
a
"}
(11,1,1) = {"
b
d
d
d
d
b
i
f
f
f
i
i
i
f
f
f
i
i
f
f
f
h
h
f
f
f
f
f
f
f
c
a
"}
(12,1,1) = {"
a
d
d
d
d
a
i
i
i
i
i
f
f
f
f
f
f
i
f
f
h
h
h
f
f
a
a
a
a
a
a
a
"}
(13,1,1) = {"
a
e
d
d
d
a
i
f
f
f
f
g
g
g
f
f
f
i
f
h
h
h
h
h
f
a
d
d
d
d
d
a
"}
(14,1,1) = {"
b
d
d
d
d
b
i
f
f
f
g
g
g
g
g
f
f
i
f
h
h
h
h
h
f
b
d
d
d
d
d
b
"}
(15,1,1) = {"
a
d
d
d
d
a
m
i
f
f
g
g
g
g
g
g
f
i
i
h
h
h
h
f
f
a
d
d
d
d
d
a
"}
(16,1,1) = {"
a
a
a
a
a
a
f
i
f
f
g
g
k
l
g
g
f
f
i
i
h
h
f
f
f
a
e
d
d
d
d
a
"}
(17,1,1) = {"
a
c
f
f
f
f
f
i
i
f
g
g
g
g
g
g
f
f
f
i
i
i
i
i
i
b
d
d
d
d
d
b
"}
(18,1,1) = {"
a
c
f
f
f
f
f
f
i
f
f
g
g
g
g
f
f
f
f
i
f
f
f
f
f
a
d
d
d
d
d
a
"}
(19,1,1) = {"
a
c
f
f
f
g
g
f
i
f
f
f
g
g
f
f
f
f
i
i
f
f
f
f
f
a
a
a
a
a
a
a
"}
(20,1,1) = {"
a
c
f
f
f
g
g
g
i
i
f
f
f
f
f
f
f
f
i
f
f
f
f
f
f
f
f
f
f
f
c
a
"}
(21,1,1) = {"
a
c
f
f
g
g
g
g
f
i
f
h
h
h
f
f
f
i
i
f
f
f
f
f
f
f
f
f
f
f
c
a
"}
(22,1,1) = {"
a
c
f
f
g
g
g
g
g
i
h
h
h
h
h
f
f
i
f
f
c
c
c
c
c
c
c
c
f
f
c
a
"}
(23,1,1) = {"
a
c
f
g
g
g
g
g
g
i
h
h
h
h
h
f
i
i
f
f
c
c
c
c
c
c
c
c
f
f
c
a
"}
(24,1,1) = {"
a
c
f
g
g
g
g
g
g
i
h
h
h
h
h
i
i
f
f
f
c
c
c
c
c
c
c
c
f
f
c
a
"}
(25,1,1) = {"
a
c
f
g
g
g
g
g
g
i
f
h
h
h
i
i
f
f
f
f
c
c
c
c
c
c
c
c
f
f
c
a
"}
(26,1,1) = {"
a
c
f
g
g
g
g
g
g
i
i
i
i
i
i
f
f
f
f
f
c
c
c
c
c
c
c
c
f
f
c
a
"}
(27,1,1) = {"
a
c
f
g
g
a
a
b
a
a
b
a
a
f
f
f
f
f
f
f
c
c
c
c
c
c
c
c
f
f
c
a
"}
(28,1,1) = {"
a
c
f
f
g
a
d
d
d
d
d
d
a
f
f
f
f
f
f
f
f
f
f
f
f
f
f
f
f
f
c
a
"}
(29,1,1) = {"
a
c
f
f
f
a
e
d
d
d
d
d
a
f
f
f
f
f
f
f
f
f
f
f
f
f
f
f
f
f
c
a
"}
(30,1,1) = {"
a
c
f
f
f
a
d
d
d
d
d
d
a
f
f
f
f
f
f
f
f
f
f
f
f
f
f
f
f
f
c
a
"}
(31,1,1) = {"
a
c
c
c
c
a
j
d
d
d
d
d
a
c
c
c
c
c
c
c
c
c
c
c
c
c
c
c
c
c
c
a
"}
(32,1,1) = {"
a
a
a
a
a
a
a
b
a
a
b
a
a
a
a
a
a
a
a
a
a
a
a
a
a
a
a
a
a
a
a
a
"}
