//MAP CONVERTED BY dmm2tgm.py THIS HEADER COMMENT PREVENTS RECONVERSION, DO NOT REMOVE
"a" = (
/turf/simulated/floor/colored/snow,
/area)
"b" = (
/turf/simulated/wall/metal/reinforced,
/area)
"c" = (
/turf/simulated/floor/snow_plating,
/area)
"d" = (
/turf/simulated/floor/plating,
/area)
"e" = (
/turf/simulated/floor/ice,
/area)
"f" = (
/obj/structure/interactive/door/airlock/external,
/turf/simulated/floor/plating,
/area)
"g" = (
/obj/structure/scenery/grass/snow,
/turf/simulated/floor/colored/snow,
/area)
"h" = (
/turf/simulated/floor/colored/dirt/snow,
/area)
"i" = (
/mob/living/simple/ash_drake,
/turf/simulated/floor/ice,
/area)

(1,1,1) = {"
b
b
b
b
b
b
b
b
b
b
b
b
f
f
b
b
b
b
f
f
b
b
b
b
b
b
b
b
b
b
b
b
"}
(2,1,1) = {"
b
c
c
c
c
c
c
c
c
c
b
d
d
d
d
d
d
d
d
d
d
b
c
c
c
c
c
c
c
c
c
b
"}
(3,1,1) = {"
b
c
a
a
a
a
a
a
a
a
b
d
d
d
d
d
d
d
d
d
d
b
a
a
a
a
a
a
a
a
c
b
"}
(4,1,1) = {"
b
c
a
a
g
g
g
a
a
a
b
d
d
d
d
d
d
d
d
d
d
b
a
a
a
a
g
g
a
a
c
b
"}
(5,1,1) = {"
b
c
a
a
g
g
g
g
g
a
b
d
d
d
d
d
d
d
d
d
d
b
a
a
g
g
g
g
g
a
c
b
"}
(6,1,1) = {"
b
c
a
a
g
g
g
g
g
a
b
d
d
d
d
d
d
d
d
d
d
b
a
a
g
g
g
g
g
a
c
b
"}
(7,1,1) = {"
b
c
a
a
g
g
g
g
g
a
b
b
b
b
b
f
f
b
b
b
b
b
a
a
g
g
g
g
g
a
c
b
"}
(8,1,1) = {"
b
c
a
a
a
a
a
g
g
a
a
a
a
a
a
h
h
a
a
a
a
a
a
a
a
a
g
g
g
a
c
b
"}
(9,1,1) = {"
b
b
b
b
b
b
a
a
a
a
a
a
a
a
h
h
h
a
a
a
a
a
a
a
a
a
a
g
g
a
c
b
"}
(10,1,1) = {"
b
d
d
d
d
b
a
a
a
a
a
a
h
h
h
a
h
a
a
a
a
a
a
a
a
a
a
a
a
a
c
b
"}
(11,1,1) = {"
f
d
d
d
d
f
h
a
a
a
h
h
h
a
a
a
h
h
a
a
a
g
g
a
a
a
a
a
a
a
c
b
"}
(12,1,1) = {"
b
d
d
d
d
b
h
h
h
h
h
a
a
a
a
a
a
h
a
a
g
g
g
a
a
b
b
b
b
b
b
b
"}
(13,1,1) = {"
b
d
d
d
d
b
h
a
a
a
a
e
e
e
a
a
a
h
a
g
g
g
g
g
a
b
d
d
d
d
d
b
"}
(14,1,1) = {"
f
d
d
d
d
f
h
a
a
a
e
e
e
e
e
a
a
h
a
g
g
g
g
g
a
f
d
d
d
d
d
f
"}
(15,1,1) = {"
b
d
d
d
d
b
h
h
a
a
e
e
e
e
e
e
a
h
h
g
g
g
g
a
a
b
d
d
d
d
d
b
"}
(16,1,1) = {"
b
b
b
b
b
b
a
h
a
a
e
e
i
e
e
e
a
a
h
h
g
g
a
a
a
b
d
d
d
d
d
b
"}
(17,1,1) = {"
b
c
a
a
a
a
a
h
h
a
e
e
e
e
e
e
a
a
a
h
h
h
h
h
h
f
d
d
d
d
d
f
"}
(18,1,1) = {"
b
c
a
a
a
a
a
a
h
a
a
e
e
e
e
a
a
a
a
h
a
a
a
a
a
b
d
d
d
d
d
b
"}
(19,1,1) = {"
b
c
a
a
a
e
e
a
h
a
a
a
e
e
a
a
a
a
h
h
a
a
a
a
a
b
b
b
b
b
b
b
"}
(20,1,1) = {"
b
c
a
a
a
e
e
e
h
h
a
a
a
a
a
a
a
a
h
a
a
a
a
a
a
a
a
a
a
a
c
b
"}
(21,1,1) = {"
b
c
a
a
e
e
e
e
a
h
a
g
g
g
a
a
a
h
h
a
a
a
a
a
a
a
a
a
a
a
c
b
"}
(22,1,1) = {"
b
c
a
a
e
e
e
e
e
h
g
g
g
g
g
a
a
h
a
a
c
c
c
c
c
c
c
c
a
a
c
b
"}
(23,1,1) = {"
b
c
a
e
e
e
e
e
e
h
g
g
g
g
g
a
h
h
a
a
c
c
c
c
c
c
c
c
a
a
c
b
"}
(24,1,1) = {"
b
c
a
e
e
e
e
e
e
h
g
g
g
g
g
h
h
a
a
a
c
c
c
c
c
c
c
c
a
a
c
b
"}
(25,1,1) = {"
b
c
a
e
e
e
e
e
e
h
a
g
g
g
h
h
a
a
a
a
c
c
c
c
c
c
c
c
a
a
c
b
"}
(26,1,1) = {"
b
c
a
e
e
e
e
e
e
h
h
h
h
h
h
a
a
a
a
a
c
c
c
c
c
c
c
c
a
a
c
b
"}
(27,1,1) = {"
b
c
a
e
e
b
b
f
b
b
f
b
b
a
a
a
a
a
a
a
c
c
c
c
c
c
c
c
a
a
c
b
"}
(28,1,1) = {"
b
c
a
a
e
b
d
d
d
d
d
d
b
a
a
a
a
a
a
a
a
a
a
a
a
a
a
a
a
a
c
b
"}
(29,1,1) = {"
b
c
a
a
a
b
d
d
d
d
d
d
b
a
a
a
a
a
a
a
a
a
a
a
a
a
a
a
a
a
c
b
"}
(30,1,1) = {"
b
c
a
a
a
b
d
d
d
d
d
d
b
a
a
a
a
a
a
a
a
a
a
a
a
a
a
a
a
a
c
b
"}
(31,1,1) = {"
b
c
c
c
c
b
d
d
d
d
d
d
b
c
c
c
c
c
c
c
c
c
c
c
c
c
c
c
c
c
c
b
"}
(32,1,1) = {"
b
b
b
b
b
b
b
f
b
b
f
b
b
b
b
b
b
b
b
b
b
b
b
b
b
b
b
b
b
b
b
b
"}
