//MAP CONVERTED BY dmm2tgm.py THIS HEADER COMMENT PREVENTS RECONVERSION, DO NOT REMOVE
"a" = (
/turf/simulated/wall/boss,
/area/mission/prefab/boss/leaper)
"b" = (
/turf/dmm_suite/no_wall,
/area/mission/prefab/boss/leaper)
"c" = (
/obj/marker/smart_clear_turf,
/turf/dmm_suite/no_wall,
/area/mission/prefab/boss/leaper)
"d" = (
/obj/structure/interactive/crate/chest/filled,
/turf/dmm_suite/no_wall,
/area/mission/prefab/boss/leaper)
"e" = (
/turf/dmm_suite/clear_turf,
/area/mission/prefab/boss/leaper)
"f" = (
/turf/simulated/liquid/water/river/jungle,
/area/mission/prefab/boss/leaper)
"g" = (
/obj/marker/map_node,
/turf/dmm_suite/no_wall,
/area/mission/prefab/boss/leaper)
"h" = (
/obj/marker/objective_spawn,
/turf/dmm_suite/no_wall,
/area/mission/prefab/boss/leaper)
"i" = (
/mob/living/simple/leaper,
/turf/dmm_suite/no_wall,
/area/mission/prefab/boss/leaper)
"j" = (
/obj/marker/map_node/x3,
/turf/dmm_suite/no_wall,
/area/mission/prefab/boss/leaper)

(1,1,1) = {"
a
a
a
a
a
a
a
a
a
a
c
b
b
b
a
a
a
a
a
a
a
a
a
a
a
a
a
a
a
a
a
a
"}
(2,1,1) = {"
a
d
b
b
f
f
f
e
e
e
b
b
g
b
e
e
e
e
e
e
e
e
f
f
e
e
e
b
b
b
d
a
"}
(3,1,1) = {"
a
b
b
b
f
f
f
e
e
e
b
b
b
b
e
e
e
f
f
e
e
e
f
f
f
e
e
e
b
b
b
a
"}
(4,1,1) = {"
a
b
b
e
f
f
f
f
f
e
e
b
b
b
e
e
f
f
f
f
e
f
f
f
f
f
e
e
e
b
b
a
"}
(5,1,1) = {"
a
b
e
e
f
f
f
f
f
e
e
e
b
b
e
f
f
f
f
f
f
f
f
f
f
f
f
f
e
e
b
a
"}
(6,1,1) = {"
a
e
f
f
f
f
f
f
f
e
e
e
b
b
b
f
f
f
f
f
f
f
f
f
f
f
f
f
f
f
b
a
"}
(7,1,1) = {"
a
f
f
f
f
f
f
f
f
f
f
e
e
b
b
e
f
f
f
f
f
f
f
e
f
f
f
f
f
f
f
a
"}
(8,1,1) = {"
a
f
f
f
f
f
f
f
f
f
f
f
e
g
b
e
e
f
f
f
f
f
e
e
e
e
e
f
f
f
e
a
"}
(9,1,1) = {"
a
f
f
f
e
f
f
f
f
f
f
f
e
b
b
e
e
f
f
f
f
f
e
e
e
e
e
e
e
e
e
b
"}
(10,1,1) = {"
a
e
e
e
e
e
e
f
f
f
f
f
e
b
b
e
e
f
f
f
f
f
e
e
e
e
e
e
e
b
b
b
"}
(11,1,1) = {"
a
e
e
e
e
e
e
f
f
f
f
e
e
b
b
e
e
e
e
f
f
e
e
e
e
e
e
b
g
b
b
g
"}
(12,1,1) = {"
b
b
b
e
e
e
e
e
e
e
e
e
b
g
b
b
b
e
e
e
e
e
e
e
b
b
b
b
b
b
b
b
"}
(13,1,1) = {"
b
b
g
b
b
b
b
e
e
e
e
b
b
b
b
b
b
b
e
e
e
b
b
b
b
b
g
b
b
b
e
b
"}
(14,1,1) = {"
c
b
b
b
b
b
g
b
b
e
b
b
b
b
b
b
b
b
b
b
b
b
g
b
b
b
b
b
e
e
e
b
"}
(15,1,1) = {"
b
e
e
b
b
b
b
b
b
b
g
b
b
i
j
b
b
g
b
b
b
b
b
b
e
e
e
e
e
f
f
a
"}
(16,1,1) = {"
b
e
e
e
e
b
b
b
b
b
b
b
b
b
b
b
b
b
b
b
b
b
e
e
e
e
f
f
f
f
f
a
"}
(17,1,1) = {"
a
e
e
e
e
f
f
f
f
b
b
h
b
b
b
b
b
b
e
e
e
e
e
e
e
f
f
f
f
f
f
a
"}
(18,1,1) = {"
a
e
e
e
f
f
f
f
f
f
b
b
b
b
b
b
b
e
e
e
e
e
e
f
f
f
f
f
f
f
f
a
"}
(19,1,1) = {"
a
e
e
e
f
f
f
f
f
f
e
b
b
b
g
b
e
e
e
e
f
f
f
f
f
f
f
f
f
f
f
a
"}
(20,1,1) = {"
a
e
f
f
f
f
f
f
f
f
e
e
e
b
b
b
b
e
e
f
f
f
f
f
f
f
f
f
f
f
f
a
"}
(21,1,1) = {"
a
e
f
f
f
f
f
f
f
f
f
e
e
e
b
b
b
b
e
e
f
f
f
f
f
f
f
f
f
f
f
a
"}
(22,1,1) = {"
a
e
f
f
f
f
f
f
f
f
f
e
e
e
b
b
b
b
b
e
e
e
f
f
f
f
f
f
f
f
f
a
"}
(23,1,1) = {"
a
e
f
f
f
f
f
f
f
f
f
f
e
e
e
b
b
b
b
b
b
e
e
f
f
f
f
f
f
f
f
a
"}
(24,1,1) = {"
a
e
f
f
f
f
f
f
f
f
f
f
f
e
e
e
b
b
g
b
b
b
e
e
f
f
f
f
f
f
f
a
"}
(25,1,1) = {"
a
e
f
f
f
f
f
f
f
f
f
f
f
f
f
e
e
b
b
b
b
b
b
e
e
f
f
f
f
f
f
a
"}
(26,1,1) = {"
a
e
e
f
f
f
f
f
f
f
f
f
f
f
f
e
e
b
b
b
b
b
b
e
e
e
f
f
f
f
f
a
"}
(27,1,1) = {"
a
b
e
e
f
f
f
f
f
f
f
f
f
f
f
f
e
e
b
b
b
g
b
b
e
e
e
f
f
f
f
a
"}
(28,1,1) = {"
a
b
e
e
e
f
f
f
f
f
f
f
f
f
f
f
e
e
e
b
b
b
b
b
b
e
e
e
f
f
f
a
"}
(29,1,1) = {"
a
b
b
e
e
e
e
f
f
f
f
f
f
f
f
f
f
e
e
e
b
b
b
b
b
b
e
e
f
f
f
a
"}
(30,1,1) = {"
a
b
b
b
e
e
e
e
e
e
f
f
f
f
f
f
f
f
e
e
e
e
b
g
b
b
e
e
f
b
b
a
"}
(31,1,1) = {"
a
d
b
b
b
b
e
e
e
e
e
e
f
f
f
f
f
f
f
e
e
e
b
b
b
b
b
b
b
b
d
a
"}
(32,1,1) = {"
a
a
a
a
a
a
a
a
a
a
a
a
a
a
a
a
a
a
a
a
a
a
a
c
g
b
b
a
a
a
a
a
"}
