//MAP CONVERTED BY dmm2tgm.py THIS HEADER COMMENT PREVENTS RECONVERSION, DO NOT REMOVE
"a" = (
/turf/simulated/wall/boss,
/area/dmm_suite/clear_area)
"b" = (
/turf/dmm_suite/no_wall,
/area/dmm_suite/clear_area)
"c" = (
/turf/dmm_suite/clear_turf,
/area/dmm_suite/clear_area)
"d" = (
/mob/living/simple/leaper,
/turf/dmm_suite/no_wall,
/area/dmm_suite/clear_area)
"e" = (
/obj/marker/map_node/x3,
/turf/dmm_suite/no_wall,
/area/dmm_suite/clear_area)
"f" = (
/obj/marker/objective_spawn,
/turf/dmm_suite/no_wall,
/area/dmm_suite/clear_area)
"g" = (
/turf/simulated/liquid/water/river/jungle,
/area/dmm_suite/clear_area)
"h" = (
/obj/marker/map_node,
/turf/dmm_suite/no_wall,
/area/dmm_suite/clear_area)
"i" = (
/obj/marker/smart_clear_turf,
/turf/dmm_suite/no_wall,
/area/dmm_suite/clear_area)
"j" = (
/obj/structure/interactive/crate/chest/filled,
/turf/dmm_suite/no_wall,
/area/dmm_suite/clear_area)

(1,1,1) = {"
a
a
a
a
a
a
a
a
a
a
i
b
b
b
a
a
a
a
a
a
a
a
a
a
a
a
a
a
a
a
a
a
"}
(2,1,1) = {"
a
j
b
b
g
g
g
c
c
c
b
b
h
b
c
c
c
c
c
c
c
c
g
g
c
c
c
b
b
b
j
a
"}
(3,1,1) = {"
a
b
b
b
g
g
g
c
c
c
b
b
b
b
c
c
c
g
g
c
c
c
g
g
g
c
c
c
b
b
b
a
"}
(4,1,1) = {"
a
b
b
c
g
g
g
g
g
c
c
b
b
b
c
c
g
g
g
g
c
g
g
g
g
g
c
c
c
b
b
a
"}
(5,1,1) = {"
a
b
c
c
g
g
g
g
g
c
c
c
b
b
c
g
g
g
g
g
g
g
g
g
g
g
g
g
c
c
b
a
"}
(6,1,1) = {"
a
c
g
g
g
g
g
g
g
c
c
c
b
b
b
g
g
g
g
g
g
g
g
g
g
g
g
g
g
g
b
a
"}
(7,1,1) = {"
a
g
g
g
g
g
g
g
g
g
g
c
c
b
b
c
g
g
g
g
g
g
g
c
g
g
g
g
g
g
g
a
"}
(8,1,1) = {"
a
g
g
g
g
g
g
g
g
g
g
g
c
h
b
c
c
g
g
g
g
g
c
c
c
c
c
g
g
g
c
a
"}
(9,1,1) = {"
a
g
g
g
c
g
g
g
g
g
g
g
c
b
b
c
c
g
g
g
g
g
c
c
c
c
c
c
c
c
c
b
"}
(10,1,1) = {"
a
c
c
c
c
c
c
g
g
g
g
g
c
b
b
c
c
g
g
g
g
g
c
c
c
c
c
c
c
b
b
b
"}
(11,1,1) = {"
a
c
c
c
c
c
c
g
g
g
g
c
c
b
b
c
c
c
c
g
g
c
c
c
c
c
c
b
h
b
b
h
"}
(12,1,1) = {"
b
b
b
c
c
c
c
c
c
c
c
c
b
h
b
b
b
c
c
c
c
c
c
c
b
b
b
b
b
b
b
b
"}
(13,1,1) = {"
b
b
h
b
b
b
b
c
c
c
c
b
b
b
b
b
b
b
c
c
c
b
b
b
b
b
h
b
b
b
c
b
"}
(14,1,1) = {"
i
b
b
b
b
b
h
b
b
c
b
b
b
b
b
b
b
b
b
b
b
b
h
b
b
b
b
b
c
c
c
b
"}
(15,1,1) = {"
b
c
c
b
b
b
b
b
b
b
h
b
b
d
e
b
b
h
b
b
b
b
b
b
c
c
c
c
c
g
g
a
"}
(16,1,1) = {"
b
c
c
c
c
b
b
b
b
b
b
b
b
b
b
b
b
b
b
b
b
b
c
c
c
c
g
g
g
g
g
a
"}
(17,1,1) = {"
a
c
c
c
c
g
g
g
g
b
b
f
b
b
b
b
b
b
c
c
c
c
c
c
c
g
g
g
g
g
g
a
"}
(18,1,1) = {"
a
c
c
c
g
g
g
g
g
g
b
b
b
b
b
b
b
c
c
c
c
c
c
g
g
g
g
g
g
g
g
a
"}
(19,1,1) = {"
a
c
c
c
g
g
g
g
g
g
c
b
b
b
h
b
c
c
c
c
g
g
g
g
g
g
g
g
g
g
g
a
"}
(20,1,1) = {"
a
c
g
g
g
g
g
g
g
g
c
c
c
b
b
b
b
c
c
g
g
g
g
g
g
g
g
g
g
g
g
a
"}
(21,1,1) = {"
a
c
g
g
g
g
g
g
g
g
g
c
c
c
b
b
b
b
c
c
g
g
g
g
g
g
g
g
g
g
g
a
"}
(22,1,1) = {"
a
c
g
g
g
g
g
g
g
g
g
c
c
c
b
b
b
b
b
c
c
c
g
g
g
g
g
g
g
g
g
a
"}
(23,1,1) = {"
a
c
g
g
g
g
g
g
g
g
g
g
c
c
c
b
b
b
b
b
b
c
c
g
g
g
g
g
g
g
g
a
"}
(24,1,1) = {"
a
c
g
g
g
g
g
g
g
g
g
g
g
c
c
c
b
b
h
b
b
b
c
c
g
g
g
g
g
g
g
a
"}
(25,1,1) = {"
a
c
g
g
g
g
g
g
g
g
g
g
g
g
g
c
c
b
b
b
b
b
b
c
c
g
g
g
g
g
g
a
"}
(26,1,1) = {"
a
c
c
g
g
g
g
g
g
g
g
g
g
g
g
c
c
b
b
b
b
b
b
c
c
c
g
g
g
g
g
a
"}
(27,1,1) = {"
a
b
c
c
g
g
g
g
g
g
g
g
g
g
g
g
c
c
b
b
b
h
b
b
c
c
c
g
g
g
g
a
"}
(28,1,1) = {"
a
b
c
c
c
g
g
g
g
g
g
g
g
g
g
g
c
c
c
b
b
b
b
b
b
c
c
c
g
g
g
a
"}
(29,1,1) = {"
a
b
b
c
c
c
c
g
g
g
g
g
g
g
g
g
g
c
c
c
b
b
b
b
b
b
c
c
g
g
g
a
"}
(30,1,1) = {"
a
b
b
b
c
c
c
c
c
c
g
g
g
g
g
g
g
g
c
c
c
c
b
h
b
b
c
c
g
b
b
a
"}
(31,1,1) = {"
a
j
b
b
b
b
c
c
c
c
c
c
g
g
g
g
g
g
g
c
c
c
b
b
b
b
b
b
b
b
j
a
"}
(32,1,1) = {"
a
a
a
a
a
a
a
a
a
a
a
a
a
a
a
a
a
a
a
a
a
a
a
i
h
b
b
a
a
a
a
a
"}
