"a" = (/turf/simulated/wall/boss,/area/mission/prefab/boss/herald)
"b" = (/turf/dmm_suite/no_wall,/area/mission/prefab/boss/herald)
"c" = (/obj/marker/smart_clear_turf,/turf/dmm_suite/no_wall,/area/mission/prefab/boss/herald)
"d" = (/obj/marker/map_node/x2,/turf/dmm_suite/no_wall,/area/mission/prefab/boss/herald)
"e" = (/turf/dmm_suite/clear_turf,/area/mission/prefab/boss/herald)
"f" = (/obj/structure/interactive/crate/chest/filled,/turf/dmm_suite/clear_turf,/area/mission/prefab/boss/herald)
"g" = (/obj/marker/objective_spawn,/turf/dmm_suite/no_wall,/area/mission/prefab/boss/herald)
"h" = (/mob/living/simple/herald,/turf/dmm_suite/no_wall,/area/mission/prefab/boss/herald)
"i" = (/obj/marker/lobby,/turf/dmm_suite/no_wall,/area/mission/prefab/boss/herald)

(1,1,1) = {"
aabcbaaaaaaaaaaaaaaaaaaaaaabcbaa
aabdbaaaaaaaaaaaaaaaaaaaaaabdbaa
bbbbbbbbbbbbbbbbbbbbbbbbbbbbbbbb
cdbdbbdbbbdbbbbbbbbbbdbbbdbbdbdc
bbbbbbbbbbbbbbbbbbbbbbbbbbbbbbbb
aabbbaaaeeeeeeeeeeeeeeeeaaabbbaa
aabdbaaaeeeeeeeeeeeeeeeeaaabdbaa
aabbbaaaeeeeeeeeeeeeeeeeaaabbbaa
aabbbefeeeeeeeeeeeeeeeeeefebbbaa
aabbbeeeeeeeeeeeeeeeeeeeeeebbbaa
aabdbeeeeeeeeeeeeeeeeeeeeeebdbaa
aabbbeeeeeeeeeeeeeeeeeeeeeebbbaa
aabbbeeeeeeeeebbbeeeeeeeeeebbbaa
aabbbeeeeeeeebbgbbeeeeeeeeebbbaa
aabbbeeeeeeeebbhbbeeeeeeeeebbbaa
aabdbeeeeeeeebbibbeeeeeeeeebdbaa
aabbbeeeeeeeeebbbeeeeeeeeeebbbaa
aabbbeeeeeeeeeeeeeeeeeeeeeebbbaa
aabbbeeeeeeeeeeeeeeeeeeeeeebbbaa
aabbbeeeeeeeeeeeeeeeeeeeeeebbbaa
aabdbeeeeeeeeeeeeeeeeeeeeeebdbaa
aabbbeeeeeeeeeeeeeeeeeeeeeebbbaa
aabbbeeeeeeeeeeeeeeeeeeeeeebbbaa
aabbbefeeeeeeeeeeeeeeeeeefebbbaa
aabbbaaaeeeeeeeeeeeeeeeeaaabbbaa
aabdbaaaeeeeeeeeeeeeeeeeaaabdbaa
aabbbaaaeeeeeeeeeeeeeeeeaaabbbaa
bbbbbbbbbbbbbbbbbbbbbbbbbbbbbbbb
cdbdbbdbbbdbbbbbbbbbbdbbbdbbdbdc
bbbbbbbbbbbbbbbbbbbbbbbbbbbbbbbb
aabdbaaaaaaaaaaaaaaaaaaaaaabdbaa
aabcbaaaaaaaaaaaaaaaaaaaaaabcbaa
"}
