//MAP CONVERTED BY dmm2tgm.py THIS HEADER COMMENT PREVENTS RECONVERSION, DO NOT REMOVE
"a" = (
/turf/simulated/wall/boss,
/area/mission/prefab/boss/herald)
"b" = (
/turf/dmm_suite/no_wall,
/area/mission/prefab/boss/herald)
"c" = (
/obj/marker/smart_clear_turf,
/turf/dmm_suite/no_wall,
/area/mission/prefab/boss/herald)
"d" = (
/obj/marker/map_node/x2,
/turf/dmm_suite/no_wall,
/area/mission/prefab/boss/herald)
"e" = (
/turf/dmm_suite/clear_turf,
/area/mission/prefab/boss/herald)
"f" = (
/obj/structure/interactive/crate/chest/filled,
/turf/dmm_suite/clear_turf,
/area/mission/prefab/boss/herald)
"g" = (
/obj/marker/objective_spawn,
/turf/dmm_suite/no_wall,
/area/mission/prefab/boss/herald)
"h" = (
/mob/living/simple/herald,
/turf/dmm_suite/no_wall,
/area/mission/prefab/boss/herald)
"i" = (
/obj/marker/lobby,
/turf/dmm_suite/no_wall,
/area/mission/prefab/boss/herald)

(1,1,1) = {"
a
a
b
c
b
a
a
a
a
a
a
a
a
a
a
a
a
a
a
a
a
a
a
a
a
a
a
b
c
b
a
a
"}
(2,1,1) = {"
a
a
b
d
b
a
a
a
a
a
a
a
a
a
a
a
a
a
a
a
a
a
a
a
a
a
a
b
d
b
a
a
"}
(3,1,1) = {"
b
b
b
b
b
b
b
b
b
b
b
b
b
b
b
b
b
b
b
b
b
b
b
b
b
b
b
b
b
b
b
b
"}
(4,1,1) = {"
c
d
b
d
b
b
d
b
b
b
d
b
b
b
b
d
b
b
b
b
d
b
b
b
b
d
b
b
d
b
d
c
"}
(5,1,1) = {"
b
b
b
b
b
b
b
b
b
b
b
b
b
b
b
b
b
b
b
b
b
b
b
b
b
b
b
b
b
b
b
b
"}
(6,1,1) = {"
a
a
b
b
b
a
a
a
e
e
e
e
e
e
e
e
e
e
e
e
e
e
e
e
a
a
a
b
b
b
a
a
"}
(7,1,1) = {"
a
a
b
d
b
a
a
a
f
e
e
e
e
e
e
e
e
e
e
e
e
e
e
f
a
a
a
b
d
b
a
a
"}
(8,1,1) = {"
a
a
b
b
b
a
a
a
e
e
e
e
e
e
e
e
e
e
e
e
e
e
e
e
a
a
a
b
b
b
a
a
"}
(9,1,1) = {"
a
a
b
b
b
e
e
e
e
e
e
e
e
e
e
e
e
e
e
e
e
e
e
e
e
e
e
b
b
b
a
a
"}
(10,1,1) = {"
a
a
b
b
b
e
e
e
e
e
e
e
e
e
e
e
e
e
e
e
e
e
e
e
e
e
e
b
b
b
a
a
"}
(11,1,1) = {"
a
a
b
d
b
e
e
e
e
e
e
e
e
e
e
e
e
e
e
e
e
e
e
e
e
e
e
b
d
b
a
a
"}
(12,1,1) = {"
a
a
b
b
b
e
e
e
e
e
e
e
e
e
e
e
e
e
e
e
e
e
e
e
e
e
e
b
b
b
a
a
"}
(13,1,1) = {"
a
a
b
b
b
e
e
e
e
e
e
e
e
e
e
e
e
e
e
e
e
e
e
e
e
e
e
b
b
b
a
a
"}
(14,1,1) = {"
a
a
b
b
b
e
e
e
e
e
e
e
e
b
b
b
e
e
e
e
e
e
e
e
e
e
e
b
b
b
a
a
"}
(15,1,1) = {"
a
a
b
b
b
e
e
e
e
e
e
e
b
b
b
b
b
e
e
e
e
e
e
e
e
e
e
b
b
b
a
a
"}
(16,1,1) = {"
a
a
b
b
b
e
e
e
e
e
e
e
b
g
h
i
b
e
e
e
e
e
e
e
e
e
e
b
b
b
a
a
"}
(17,1,1) = {"
a
a
b
b
b
e
e
e
e
e
e
e
b
b
b
b
b
e
e
e
e
e
e
e
e
e
e
b
b
b
a
a
"}
(18,1,1) = {"
a
a
b
b
b
e
e
e
e
e
e
e
e
b
b
b
e
e
e
e
e
e
e
e
e
e
e
b
b
b
a
a
"}
(19,1,1) = {"
a
a
b
b
b
e
e
e
e
e
e
e
e
e
e
e
e
e
e
e
e
e
e
e
e
e
e
b
b
b
a
a
"}
(20,1,1) = {"
a
a
b
b
b
e
e
e
e
e
e
e
e
e
e
e
e
e
e
e
e
e
e
e
e
e
e
b
b
b
a
a
"}
(21,1,1) = {"
a
a
b
b
b
e
e
e
e
e
e
e
e
e
e
e
e
e
e
e
e
e
e
e
e
e
e
b
b
b
a
a
"}
(22,1,1) = {"
a
a
b
d
b
e
e
e
e
e
e
e
e
e
e
e
e
e
e
e
e
e
e
e
e
e
e
b
d
b
a
a
"}
(23,1,1) = {"
a
a
b
b
b
e
e
e
e
e
e
e
e
e
e
e
e
e
e
e
e
e
e
e
e
e
e
b
b
b
a
a
"}
(24,1,1) = {"
a
a
b
b
b
e
e
e
e
e
e
e
e
e
e
e
e
e
e
e
e
e
e
e
e
e
e
b
b
b
a
a
"}
(25,1,1) = {"
a
a
b
b
b
a
a
a
e
e
e
e
e
e
e
e
e
e
e
e
e
e
e
e
a
a
a
b
b
b
a
a
"}
(26,1,1) = {"
a
a
b
d
b
a
a
a
f
e
e
e
e
e
e
e
e
e
e
e
e
e
e
f
a
a
a
b
d
b
a
a
"}
(27,1,1) = {"
a
a
b
b
b
a
a
a
e
e
e
e
e
e
e
e
e
e
e
e
e
e
e
e
a
a
a
b
b
b
a
a
"}
(28,1,1) = {"
b
b
b
b
b
b
b
b
b
b
b
b
b
b
b
b
b
b
b
b
b
b
b
b
b
b
b
b
b
b
b
b
"}
(29,1,1) = {"
c
d
b
d
b
b
d
b
b
b
d
b
b
b
b
d
b
b
b
b
d
b
b
b
b
d
b
b
d
b
d
c
"}
(30,1,1) = {"
b
b
b
b
b
b
b
b
b
b
b
b
b
b
b
b
b
b
b
b
b
b
b
b
b
b
b
b
b
b
b
b
"}
(31,1,1) = {"
a
a
b
d
b
a
a
a
a
a
a
a
a
a
a
a
a
a
a
a
a
a
a
a
a
a
a
b
d
b
a
a
"}
(32,1,1) = {"
a
a
b
c
b
a
a
a
a
a
a
a
a
a
a
a
a
a
a
a
a
a
a
a
a
a
a
b
c
b
a
a
"}
