//MAP CONVERTED BY dmm2tgm.py THIS HEADER COMMENT PREVENTS RECONVERSION, DO NOT REMOVE
"a" = (
/turf/simulated/wall/boss,
/area/dmm_suite/clear_area)
"b" = (
/turf/simulated/floor/colored/ash/rocky,
/area/dmm_suite/clear_area)
"c" = (
/mob/living/simple/herald,
/turf/simulated/floor/colored/ash/rocky,
/area/dmm_suite/clear_area)
"d" = (
/obj/marker/lobby,
/turf/simulated/floor/colored/ash/rocky,
/area/dmm_suite/clear_area)
"e" = (
/obj/marker/objective_spawn,
/turf/simulated/floor/colored/ash/rocky,
/area/dmm_suite/clear_area)
"f" = (
/obj/marker/smart_clear_turf,
/turf/simulated/floor/colored/ash/rocky,
/area/dmm_suite/clear_area)
"g" = (
/obj/marker/map_node/x2,
/turf/simulated/floor/colored/ash/rocky,
/area/dmm_suite/clear_area)
"y" = (
/obj/structure/interactive/crate/chest/filled,
/turf/simulated/floor/colored/ash/rocky,
/area/dmm_suite/clear_area)

(1,1,1) = {"
a
a
b
f
b
a
a
a
a
a
a
a
a
a
a
a
a
a
a
a
a
a
a
a
a
a
a
b
f
b
a
a
"}
(2,1,1) = {"
a
a
b
g
b
a
a
a
a
a
a
a
a
a
a
a
a
a
a
a
a
a
a
a
a
a
a
b
g
b
a
a
"}
(3,1,1) = {"
b
b
b
b
b
b
b
b
b
b
b
b
b
b
b
b
b
b
b
b
b
b
b
b
b
b
b
b
b
b
b
b
"}
(4,1,1) = {"
f
g
b
g
b
b
g
b
b
b
g
b
b
b
b
g
b
b
b
b
g
b
b
b
b
g
b
b
g
b
g
f
"}
(5,1,1) = {"
b
b
b
b
b
b
b
b
b
b
b
b
b
b
b
b
b
b
b
b
b
b
b
b
b
b
b
b
b
b
b
b
"}
(6,1,1) = {"
a
a
b
b
b
a
a
a
b
b
b
b
b
b
b
b
b
b
b
b
b
b
b
b
a
a
a
b
b
b
a
a
"}
(7,1,1) = {"
a
a
b
g
b
a
a
a
y
b
b
b
b
b
b
b
b
b
b
b
b
b
b
y
a
a
a
b
g
b
a
a
"}
(8,1,1) = {"
a
a
b
b
b
a
a
a
b
b
b
b
b
b
b
b
b
b
b
b
b
b
b
b
a
a
a
b
b
b
a
a
"}
(9,1,1) = {"
a
a
b
b
b
b
b
b
b
b
b
b
b
b
b
b
b
b
b
b
b
b
b
b
b
b
b
b
b
b
a
a
"}
(10,1,1) = {"
a
a
b
b
b
b
b
b
b
b
b
b
b
b
b
b
b
b
b
b
b
b
b
b
b
b
b
b
b
b
a
a
"}
(11,1,1) = {"
a
a
b
g
b
b
b
b
b
b
b
b
b
b
b
b
b
b
b
b
b
b
b
b
b
b
b
b
g
b
a
a
"}
(12,1,1) = {"
a
a
b
b
b
b
b
b
b
b
b
b
b
b
b
b
b
b
b
b
b
b
b
b
b
b
b
b
b
b
a
a
"}
(13,1,1) = {"
a
a
b
b
b
b
b
b
b
b
b
b
b
b
b
b
b
b
b
b
b
b
b
b
b
b
b
b
b
b
a
a
"}
(14,1,1) = {"
a
a
b
b
b
b
b
b
b
b
b
b
b
b
b
b
b
b
b
b
b
b
b
b
b
b
b
b
b
b
a
a
"}
(15,1,1) = {"
a
a
b
b
b
b
b
b
b
b
b
b
b
b
b
b
b
b
b
b
b
b
b
b
b
b
b
b
b
b
a
a
"}
(16,1,1) = {"
a
a
b
b
b
b
b
b
b
b
b
b
b
e
c
d
b
b
b
b
b
b
b
b
b
b
b
b
b
b
a
a
"}
(17,1,1) = {"
a
a
b
b
b
b
b
b
b
b
b
b
b
b
b
b
b
b
b
b
b
b
b
b
b
b
b
b
b
b
a
a
"}
(18,1,1) = {"
a
a
b
b
b
b
b
b
b
b
b
b
b
b
b
b
b
b
b
b
b
b
b
b
b
b
b
b
b
b
a
a
"}
(19,1,1) = {"
a
a
b
b
b
b
b
b
b
b
b
b
b
b
b
b
b
b
b
b
b
b
b
b
b
b
b
b
b
b
a
a
"}
(20,1,1) = {"
a
a
b
b
b
b
b
b
b
b
b
b
b
b
b
b
b
b
b
b
b
b
b
b
b
b
b
b
b
b
a
a
"}
(21,1,1) = {"
a
a
b
b
b
b
b
b
b
b
b
b
b
b
b
b
b
b
b
b
b
b
b
b
b
b
b
b
b
b
a
a
"}
(22,1,1) = {"
a
a
b
g
b
b
b
b
b
b
b
b
b
b
b
b
b
b
b
b
b
b
b
b
b
b
b
b
g
b
a
a
"}
(23,1,1) = {"
a
a
b
b
b
b
b
b
b
b
b
b
b
b
b
b
b
b
b
b
b
b
b
b
b
b
b
b
b
b
a
a
"}
(24,1,1) = {"
a
a
b
b
b
b
b
b
b
b
b
b
b
b
b
b
b
b
b
b
b
b
b
b
b
b
b
b
b
b
a
a
"}
(25,1,1) = {"
a
a
b
b
b
a
a
a
b
b
b
b
b
b
b
b
b
b
b
b
b
b
b
b
a
a
a
b
b
b
a
a
"}
(26,1,1) = {"
a
a
b
g
b
a
a
a
y
b
b
b
b
b
b
b
b
b
b
b
b
b
b
y
a
a
a
b
g
b
a
a
"}
(27,1,1) = {"
a
a
b
b
b
a
a
a
b
b
b
b
b
b
b
b
b
b
b
b
b
b
b
b
a
a
a
b
b
b
a
a
"}
(28,1,1) = {"
b
b
b
b
b
b
b
b
b
b
b
b
b
b
b
b
b
b
b
b
b
b
b
b
b
b
b
b
b
b
b
b
"}
(29,1,1) = {"
f
g
b
g
b
b
g
b
b
b
g
b
b
b
b
g
b
b
b
b
g
b
b
b
b
g
b
b
g
b
g
f
"}
(30,1,1) = {"
b
b
b
b
b
b
b
b
b
b
b
b
b
b
b
b
b
b
b
b
b
b
b
b
b
b
b
b
b
b
b
b
"}
(31,1,1) = {"
a
a
b
g
b
a
a
a
a
a
a
a
a
a
a
a
a
a
a
a
a
a
a
a
a
a
a
b
g
b
a
a
"}
(32,1,1) = {"
a
a
b
f
b
a
a
a
a
a
a
a
a
a
a
a
a
a
a
a
a
a
a
a
a
a
a
b
f
b
a
a
"}
