"a" = (/turf/dmm_suite/clear_turf,/area/dmm_suite/clear_area)
"b" = (/turf/simulated/wall/hierophant,/area/dmm_suite/clear_area)
"c" = (/turf/simulated/floor/tile/dark/single,/area/dmm_suite/clear_area)
"d" = (/turf/simulated/floor/hierophant,/area/dmm_suite/clear_area)
"e" = (/mob/living/simple/hierophant,/turf/simulated/floor/hierophant,/area/dmm_suite/clear_area)

(1,1,1) = {"
aaaaaaaaaaaaaaaaaaaaaaaaaaaaaaaa
aaaaaacccccccccccccccccccaaaaaaa
aacccccbbdddbbcccbbdddbbcccccaaa
aacbbbbbbdddbbbbbbbdddbbbbbbcaaa
aacbbbbbbdddbbbbbbbdddbbbbbbcaaa
aacbbbddddddbbdddbbddddddbbbcaaa
accbbdddddddddddddddddddddbbccaa
acbbbdddddddddddddddddddddbbbcaa
acbbbdddddddddddddddddddddbbbcaa
acdddddddbbbdddddddbbbdddddddcaa
acdddddddbbbdddddddbbbdddddddcaa
acdddddddbbbdddddddbbbdddddddcaa
acbbbbdddddddddddddddddddbbbbcaa
acbbbbdddddddddddddddddddbbbbcaa
accbbdddddddddddddddddddddbbccaa
accbbddddddddddeddddddddddbbccaa
accbbdddddddddddddddddddddbbccaa
acbbbbdddddddddddddddddddbbbbcaa
acbbbbdddddddddddddddddddbbbbcaa
acdddddddbbbdddddddbbbdddddddcaa
acdddddddbbbdddddddbbbdddddddcaa
acdddddddbbbdddddddbbbdddddddcaa
acbbbdddddddddddddddddddddbbbcaa
acbbbdddddddddddddddddddddbbbcaa
accbbdddddddddddddddddddddbbccaa
aacbbbddddddbbdddbbddddddbbbcaaa
aacbbbbbbdddbbbbbbbdddbbbbbbcaaa
aacbbbbbbdddbbbbbbbdddbbbbbbcaaa
aacccccbbdddbbcccbbdddbbcccccaaa
aaaaaacccccccccccccccccccaaaaaaa
aaaaaaaaaaaaaaaaaaaaaaaaaaaaaaaa
aaaaaaaaaaaaaaaaaaaaaaaaaaaaaaaa
"}
