"a" = (/turf/simulated/wall/metal,/area/horde/station/cryo)
"b" = (/obj/structure/interactive/door/airlock/station/private,/turf/simulated/floor/tile/grey,/area/horde/station/cryo)
"c" = (/obj/structure/interactive/vendor/autolocker,/turf/simulated/floor/tile/grey,/area/horde/station/cryo)
"d" = (/turf/simulated/floor/tile/grey,/area/horde/station/cryo)
"e" = (/obj/structure/smooth/table/reinforced,/obj/structure/interactive/computer/console/old/chargen_job,/turf/simulated/floor/tile/grey,/area/horde/station/cryo)
"f" = (/obj/structure/interactive/lighting/tube{icon_state = "tube_light"; dir = 8},/turf/simulated/floor/tile/grey,/area/horde/station/cryo)
"g" = (/obj/structure/interactive/chair{icon_state = "chair"; dir = 1},/turf/simulated/floor/tile/grey,/area/horde/station/cryo)
"h" = (/obj/structure/interactive/bed/sleeper/cryo,/turf/simulated/floor/tile/grey,/area/horde/station/cryo)

(1,1,1) = {"
aabaa
addea
afdga
ahdca
aaaaa
"}
