"a" = (/turf/simulated/wall/metal,/area/interior/ship/dorm)
"b" = (/obj/structure/interactive/bed/sleeper/cryo,/turf/simulated/floor/tile/grey,/area/interior/ship/dorm)
"d" = (/turf/simulated/floor/tile/grey,/area/interior/ship/dorm)
"e" = (/obj/structure/smooth/table/reinforced,/obj/structure/interactive/computer/console/old/station_job,/turf/simulated/floor/tile/grey,/area/interior/ship/dorm)
"f" = (/obj/structure/interactive/door/airlock/station/private,/obj/structure/interactive/disposals/pipe{icon_state = "pipe"; dir = 8},/turf/simulated/floor/tile/grey,/area/interior/ship/dorm)
"h" = (/obj/structure/interactive/chair{icon_state = "chair"; dir = 1},/turf/simulated/floor/tile/grey,/area/interior/ship/dorm)
"i" = (/obj/structure/interactive/disposals/machine/chute,/obj/structure/interactive/disposals/pipe/ending{icon_state = "pipe-t"; dir = 1},/turf/simulated/floor/tile/grey,/area/interior/ship/dorm)

(1,1,1) = {"
aaaaaaaaaa
aeddddddia
ahdddddddf
addbdbdbda
aaaaaaaaaa
"}
