"a" = (/turf/simulated/wall/metal,/area/interior/ship/dorm)
"b" = (/obj/structure/interactive/door/airlock/station/private,/obj/structure/interactive/disposals/pipe,/turf/simulated/floor/tile/grey,/area/interior/ship/dorm)
"c" = (/obj/structure/interactive/disposals/machine/chute,/obj/structure/interactive/disposals/pipe/ending,/turf/simulated/floor/tile/grey,/area/interior/ship/dorm)
"d" = (/obj/structure/interactive/vendor/autolocker,/turf/simulated/floor/tile/grey,/area/interior/ship/dorm)
"e" = (/obj/structure/interactive/disposals/pipe,/turf/simulated/floor/tile/grey,/area/interior/ship/dorm)
"f" = (/obj/structure/smooth/table/reinforced,/obj/structure/interactive/computer/console/old/station_job,/turf/simulated/floor/tile/grey,/area/interior/ship/dorm)
"g" = (/obj/structure/interactive/disposals/pipe{icon_state = "pipe"; dir = 5},/obj/structure/interactive/lighting/tube{icon_state = "tube_light"; dir = 8},/turf/simulated/floor/tile/grey,/area/interior/ship/dorm)
"h" = (/obj/structure/interactive/disposals/pipe{icon_state = "pipe"; dir = 4},/turf/simulated/floor/tile/grey,/area/interior/ship/dorm)
"i" = (/obj/structure/interactive/disposals/pipe{icon_state = "pipe"; dir = 9},/turf/simulated/floor/tile/grey,/area/interior/ship/dorm)
"j" = (/obj/structure/interactive/chair{icon_state = "chair"; dir = 1},/turf/simulated/floor/tile/grey,/area/interior/ship/dorm)
"k" = (/obj/structure/interactive/bed/sleeper/cryo,/turf/simulated/floor/tile/grey,/area/interior/ship/dorm)
"l" = (/turf/simulated/floor/tile/grey,/area/interior/ship/dorm)

(1,1,1) = {"
aaabaa
acdefa
aghija
aklkla
aaaaaa
"}
