//MAP CONVERTED BY dmm2tgm.py THIS HEADER COMMENT PREVENTS RECONVERSION, DO NOT REMOVE
"aa" = (
/turf/dmm_suite/clear_turf,
/area/dmm_suite/clear_area)
"ab" = (
/turf/dmm_suite/no_wall,
/area/dmm_suite/clear_area)
"ac" = (
/obj/marker/map_node,
/turf/dmm_suite/no_wall,
/area/dmm_suite/clear_area)
"ad" = (
/turf/simulated/wall/metal/shuttle/off_white,
/area/mission/prefab/misc/golem/right)
"ae" = (
/obj/structure/interactive/door/airlock/shuttle,
/turf/simulated/floor/tile/shuttle/black,
/area/mission/prefab/misc/golem/right)
"af" = (
/obj/structure/interactive/storage/trash_pile,
/turf/dmm_suite/clear_turf,
/area/dmm_suite/clear_area)
"ag" = (
/turf/simulated/floor/tile/shuttle/black,
/area/mission/prefab/misc/golem/right)
"ah" = (
/obj/marker/map_node,
/turf/simulated/floor/tile/shuttle/black,
/area/mission/prefab/misc/golem/right)
"ai" = (
/obj/structure/interactive/mining_brace{
	dir = 4
	},
/turf/simulated/floor/tile/shuttle/black,
/area/mission/prefab/misc/golem/right)
"aj" = (
/obj/structure/interactive/mining_drill,
/turf/simulated/floor/tile/shuttle/black,
/area/mission/prefab/misc/golem/right)
"ak" = (
/obj/structure/interactive/mining_brace{
	dir = 8
	},
/turf/simulated/floor/tile/shuttle/black,
/area/mission/prefab/misc/golem/right)
"al" = (
/obj/structure/table/reinforced,
/obj/item/clothing/head/helmet/welding,
/turf/simulated/floor/tile/shuttle/black,
/area/mission/prefab/misc/golem/right)
"am" = (
/obj/structure/table/reinforced,
/obj/item/storage/bags/mining,
/obj/item/storage/bags/mining,
/turf/simulated/floor/tile/shuttle/black,
/area/mission/prefab/misc/golem/right)
"an" = (
/obj/structure/table/reinforced,
/obj/item/weapon/melee/tool/pickaxe,
/obj/item/weapon/melee/tool/pickaxe,
/obj/structure/interactive/wire/green,
/turf/simulated/floor/tile/shuttle/black,
/area/mission/prefab/misc/golem/right)
"ao" = (
/obj/structure/table/reinforced,
/obj/item/flare,
/obj/item/flare,
/obj/item/flare,
/obj/item/flare,
/obj/item/flare,
/turf/simulated/floor/tile/shuttle/black,
/area/mission/prefab/misc/golem/right)
"ap" = (
/obj/structure/interactive/crate/coffin,
/turf/simulated/floor/tile/shuttle/black,
/area/mission/prefab/misc/golem/right)
"aq" = (
/turf/simulated/floor/plating/shuttle,
/area/mission/prefab/misc/golem/right)
"ar" = (
/turf/simulated/floor/tile/shuttle/purple,
/area/mission/prefab/misc/golem/right)
"as" = (
/obj/marker/map_node,
/turf/simulated/floor/tile/shuttle/purple,
/area/mission/prefab/misc/golem/right)
"at" = (
/obj/structure/interactive/crate/coffin,
/turf/simulated/floor/tile/shuttle/purple,
/area/mission/prefab/misc/golem/right)
"au" = (
/obj/structure/interactive/door/airlock/shuttle,
/turf/simulated/floor/tile/shuttle,
/area/mission/prefab/misc/golem/right)
"av" = (
/turf/simulated/wall/metal/shuttle/off_white,
/area/mission/prefab/misc/golem/center)
"aw" = (
/obj/structure/interactive/door/airlock/shuttle,
/turf/simulated/floor/tile/shuttle,
/area/mission/prefab/misc/golem/center)
"ax" = (
/obj/structure/interactive/computer/arcade/bubbletwist,
/turf/simulated/floor/tile/shuttle,
/area/mission/prefab/misc/golem/right)
"ay" = (
/obj/structure/interactive/wire/yellow,
/obj/structure/interactive/solar_panel,
/turf/simulated/floor/plating/shuttle,
/area/mission/prefab/misc/golem/right)
"az" = (
/turf/simulated/floor/tile/shuttle,
/area/mission/prefab/misc/golem/right)
"aA" = (
/obj/marker/map_node,
/turf/simulated/floor/tile/shuttle,
/area/mission/prefab/misc/golem/right)
"aB" = (
/obj/structure/interactive/lighting/fixture/tube/station{
	dir = 1;
	icon_state = "preview"
	},
/turf/simulated/floor/tile/shuttle,
/area/mission/prefab/misc/golem/right)
"aC" = (
/obj/marker/map_node,
/turf/simulated/floor/tile/shuttle/purple,
/area/mission/prefab/misc/golem/center)
"aD" = (
/obj/structure/table/reinforced,
/obj/item/clothing/mask/gas/mining,
/obj/item/clothing/mask/gas/mining,
/obj/item/clothing/mask/gas/mining,
/turf/simulated/floor/tile/shuttle/purple,
/area/mission/prefab/misc/golem/center)
"aE" = (
/obj/structure/interactive/lighting/fixture/tube/station,
/obj/structure/table/reinforced,
/obj/item/weapon/ranged/energy/fed/plasma_cutter,
/turf/simulated/floor/tile/shuttle/purple,
/area/mission/prefab/misc/golem/center)
"aF" = (
/obj/structure/table/reinforced,
/obj/item/weapon/melee/tool/pickaxe,
/obj/item/weapon/melee/tool/pickaxe,
/obj/item/weapon/melee/tool/pickaxe,
/obj/item/flare,
/turf/simulated/floor/tile/shuttle/purple,
/area/mission/prefab/misc/golem/center)
"aG" = (
/obj/structure/table/reinforced,
/obj/item/weapon/ranged/energy/pump/kinetic_accelerator,
/turf/simulated/floor/tile/shuttle/purple,
/area/mission/prefab/misc/golem/center)
"aH" = (
/obj/structure/interactive/vending/mining/golem,
/turf/simulated/floor/tile/shuttle/purple,
/area/mission/prefab/misc/golem/center)
"aI" = (
/turf/simulated/wall/metal/shuttle/off_white,
/area/mission/prefab/misc/golem)
"aJ" = (
/obj/structure/interactive/power/apc,
/turf/simulated/wall/metal/shuttle/off_white,
/area/mission/prefab/misc/golem)
"aK" = (
/turf/simulated/floor/tile/shuttle,
/area/mission/prefab/misc/golem/center)
"aL" = (
/obj/marker/map_node/x2,
/turf/simulated/floor/tile/shuttle,
/area/mission/prefab/misc/golem/center)
"aM" = (
/obj/structure/interactive/lighting/fixture/tube/station{
	dir = 8;
	icon_state = "preview"
	},
/turf/simulated/floor/tile/shuttle,
/area/mission/prefab/misc/golem/center)
"aN" = (
/turf/simulated/floor/tile/shuttle/purple,
/area/mission/prefab/misc/golem/center)
"aO" = (
/obj/structure/table/reinforced,
/obj/item/storage/bags/mining,
/obj/item/storage/bags/mining,
/obj/item/storage/bags/mining,
/turf/simulated/floor/tile/shuttle/purple,
/area/mission/prefab/misc/golem/center)
"aP" = (
/obj/structure/interactive/lighting/fixture/tube/station/strong,
/turf/simulated/floor/tile/shuttle/purple,
/area/mission/prefab/misc/golem)
"aQ" = (
/turf/simulated/floor/tile/shuttle/purple,
/area/mission/prefab/misc/golem)
"aR" = (
/obj/structure/table/reinforced,
/turf/simulated/floor/tile/shuttle/purple,
/area/mission/prefab/misc/golem)
"aS" = (
/obj/structure/interactive/lighting/fixture/tube/station,
/obj/structure/table/reinforced,
/turf/simulated/floor/tile/shuttle/purple,
/area/mission/prefab/misc/golem)
"aT" = (
/obj/structure/table/reinforced,
/obj/structure/interactive/wire/green,
/turf/simulated/floor/tile/shuttle/purple,
/area/mission/prefab/misc/golem)
"aU" = (
/obj/structure/interactive/lighting/fixture/tube/station,
/turf/simulated/floor/tile/shuttle/purple,
/area/mission/prefab/misc/golem)
"aV" = (
/obj/structure/interactive/crate/necro,
/turf/simulated/floor/tile/shuttle/purple,
/area/mission/prefab/misc/golem/center)
"aW" = (
/obj/structure/interactive/wire/green,
/obj/structure/interactive/power/smes/industrial{
	icon_state = "smes_map";
	dir = 8
	},
/turf/simulated/floor/tile/shuttle,
/area/mission/prefab/misc/golem/right)
"aX" = (
/obj/structure/interactive/wire/green,
/turf/simulated/floor/tile/shuttle/purple,
/area/mission/prefab/misc/golem/right)
"aY" = (
/obj/marker/spawning/window/extra,
/turf/simulated/floor/plating/shuttle,
/area/mission/prefab/misc/golem)
"aZ" = (
/obj/marker/antag/golem,
/turf/simulated/floor/tile/shuttle,
/area/mission/prefab/misc/golem)
"ba" = (
/turf/simulated/floor/tile/shuttle,
/area/mission/prefab/misc/golem)
"bb" = (
/obj/structure/interactive/wire/green,
/turf/simulated/floor/tile/shuttle,
/area/mission/prefab/misc/golem)
"bc" = (
/obj/structure/interactive/door/airlock/shuttle,
/obj/structure/interactive/wire/green,
/turf/simulated/floor/tile/shuttle,
/area/mission/prefab/misc/golem/center)
"bd" = (
/obj/structure/interactive/wire/green,
/turf/simulated/floor/tile/shuttle,
/area/mission/prefab/misc/golem/center)
"be" = (
/obj/structure/interactive/lighting/fixture/tube/station,
/turf/simulated/floor/tile/shuttle,
/area/mission/prefab/misc/golem/center)
"bf" = (
/obj/structure/interactive/statue/director,
/turf/simulated/floor/plating/shuttle,
/area/mission/prefab/misc/golem)
"bg" = (
/obj/marker/objective_spawn,
/turf/simulated/floor/tile/shuttle,
/area/mission/prefab/misc/golem)
"bh" = (
/obj/marker/map_node/x3,
/turf/simulated/floor/tile/shuttle,
/area/mission/prefab/misc/golem)
"bi" = (
/obj/marker/map_node/x2,
/turf/simulated/floor/tile/shuttle,
/area/mission/prefab/misc/golem)
"bj" = (
/obj/marker/lobby,
/obj/marker/map_node/x2,
/obj/structure/interactive/wire/green,
/turf/simulated/floor/tile/shuttle,
/area/mission/prefab/misc/golem/center)
"bk" = (
/turf/simulated/wall/metal/shuttle/off_white,
/area/mission/prefab/misc/golem/left)
"bl" = (
/obj/structure/interactive/door/airlock/shuttle,
/obj/structure/interactive/wire/green,
/turf/simulated/wall/metal/shuttle/off_white,
/area/mission/prefab/misc/golem/left)
"bm" = (
/obj/marker/map_node/x2,
/turf/dmm_suite/no_wall,
/area/dmm_suite/clear_area)
"bn" = (
/obj/marker/map_node/x3,
/turf/simulated/floor/tile/shuttle,
/area/mission/prefab/misc/golem/center)
"bo" = (
/obj/structure/interactive/lighting/fixture/tube/station/strong{
	dir = 1;
	icon_state = "preview"
	},
/turf/simulated/floor/tile/shuttle/purple,
/area/mission/prefab/misc/golem)
"bp" = (
/obj/structure/interactive/lighting/fixture/tube/station{
	dir = 1;
	icon_state = "preview"
	},
/obj/structure/table/reinforced,
/turf/simulated/floor/tile/shuttle/purple,
/area/mission/prefab/misc/golem)
"bq" = (
/obj/structure/interactive/lighting/fixture/tube/station{
	dir = 1;
	icon_state = "preview"
	},
/turf/simulated/floor/tile/shuttle/purple,
/area/mission/prefab/misc/golem)
"br" = (
/obj/structure/interactive/lighting/fixture/tube/station{
	dir = 1;
	icon_state = "preview"
	},
/turf/simulated/floor/tile/shuttle/purple,
/area/mission/prefab/misc/golem/center)
"bs" = (
/obj/structure/interactive/storage/trash_pile,
/turf/dmm_suite/no_wall,
/area/dmm_suite/clear_area)
"bt" = (
/obj/structure/interactive/bed/sleeper/medical,
/turf/simulated/floor/tile/shuttle/purple,
/area/mission/prefab/misc/golem/center)
"bu" = (
/obj/structure/interactive/lighting/fixture/tube/station{
	dir = 1;
	icon_state = "preview"
	},
/turf/simulated/floor/tile/shuttle,
/area/mission/prefab/misc/golem/center)
"bv" = (
/obj/structure/table/reinforced,
/obj/item/clothing/glasses/medical_hud,
/turf/simulated/floor/tile/shuttle/purple,
/area/mission/prefab/misc/golem/center)
"bw" = (
/obj/structure/interactive/computer/console/medical{
	dir = 4
	},
/turf/simulated/floor/tile/shuttle,
/area/mission/prefab/misc/golem/center)
"bx" = (
/obj/structure/shuttle_engine/large{
	dir = 4
	},
/turf/simulated/floor/plating/shuttle,
/area/mission/prefab/misc/golem/right)
"by" = (
/obj/structure/interactive/vending/medical/basic{
	dir = 1;
	icon_state = "wallmed"
	},
/turf/simulated/wall/metal/shuttle/off_white,
/area/mission/prefab/misc/golem/center)
"bz" = (
/obj/structure/interactive/door/airlock/shuttle,
/turf/simulated/floor/tile/shuttle,
/area/mission/prefab/misc/golem/left)
"bA" = (
/obj/marker/map_node,
/turf/simulated/floor/tile/shuttle,
/area/mission/prefab/misc/golem/left)
"bB" = (
/obj/structure/interactive/vending/medical,
/turf/simulated/floor/tile/shuttle/purple,
/area/mission/prefab/misc/golem/center)
"bC" = (
/turf/simulated/floor/tile/shuttle,
/area/mission/prefab/misc/golem/left)
"bD" = (
/obj/structure/table/reinforced,
/obj/item/container/syringe/medipen/mining,
/obj/item/container/syringe/medipen/mining,
/turf/simulated/floor/tile/shuttle/purple,
/area/mission/prefab/misc/golem/center)
"bE" = (
/obj/structure/interactive/lighting/fixture/tube/station,
/turf/simulated/floor/tile/shuttle,
/area/mission/prefab/misc/golem/left)
"bF" = (
/mob/living/simple/bot/medibot,
/turf/simulated/floor/tile/shuttle,
/area/mission/prefab/misc/golem/center)
"bG" = (
/obj/structure/table/reinforced,
/turf/simulated/floor/tile/shuttle/purple,
/area/mission/prefab/misc/golem/center)
"bH" = (
/obj/structure/table/reinforced,
/obj/item/supply_crate/medicine,
/turf/simulated/floor/tile/shuttle/purple,
/area/mission/prefab/misc/golem/center)
"bI" = (
/obj/structure/interactive/lighting/fixture/tube/station{
	dir = 1;
	icon_state = "preview"
	},
/obj/structure/interactive/crate/medical,
/turf/simulated/floor/tile/shuttle/purple,
/area/mission/prefab/misc/golem/center)
"bJ" = (
/obj/structure/table/reinforced,
/obj/item/storage/kit/burn/filled,
/turf/simulated/floor/tile/shuttle/purple,
/area/mission/prefab/misc/golem/center)
"bK" = (
/obj/structure/table/reinforced,
/obj/item/storage/kit/brute,
/turf/simulated/floor/tile/shuttle/purple,
/area/mission/prefab/misc/golem/center)
"bL" = (
/obj/marker/map_node,
/obj/structure/interactive/wire/green,
/turf/simulated/floor/tile/shuttle,
/area/mission/prefab/misc/golem/right)
"bM" = (
/turf/simulated/floor/tile/shuttle/purple,
/area/mission/prefab/misc/golem/left)
"bN" = (
/obj/marker/map_node,
/turf/simulated/floor/tile/shuttle/purple,
/area/mission/prefab/misc/golem/left)
"bO" = (
/obj/structure/interactive/crate/coffin,
/turf/simulated/floor/tile/shuttle/purple,
/area/mission/prefab/misc/golem/left)
"bP" = (
/turf/simulated/floor/tile/shuttle/black,
/area/mission/prefab/misc/golem/left)
"bQ" = (
/obj/marker/map_node,
/turf/simulated/floor/tile/shuttle/black,
/area/mission/prefab/misc/golem/left)
"bR" = (
/obj/structure/interactive/mining_brace{
	dir = 4
	},
/turf/simulated/floor/tile/shuttle/black,
/area/mission/prefab/misc/golem/left)
"bS" = (
/obj/structure/interactive/mining_drill,
/turf/simulated/floor/tile/shuttle/black,
/area/mission/prefab/misc/golem/left)
"bT" = (
/obj/structure/interactive/mining_brace{
	dir = 8
	},
/turf/simulated/floor/tile/shuttle/black,
/area/mission/prefab/misc/golem/left)
"bU" = (
/obj/structure/table/reinforced,
/obj/item/flare,
/obj/item/flare,
/obj/item/flare,
/obj/item/flare,
/obj/item/flare,
/turf/simulated/floor/tile/shuttle/black,
/area/mission/prefab/misc/golem/left)
"bV" = (
/obj/structure/table/reinforced,
/turf/simulated/floor/tile/shuttle/black,
/area/mission/prefab/misc/golem/left)
"bW" = (
/obj/structure/table/reinforced,
/obj/item/clothing/head/helmet/welding,
/turf/simulated/floor/tile/shuttle/black,
/area/mission/prefab/misc/golem/left)
"bX" = (
/obj/structure/interactive/crate/coffin,
/turf/simulated/floor/tile/shuttle/black,
/area/mission/prefab/misc/golem/left)
"bY" = (
/obj/structure/interactive/door/airlock/shuttle,
/turf/simulated/floor/tile/shuttle/black,
/area/mission/prefab/misc/golem/left)
"bZ" = (
/obj/marker/map_node,
/obj/structure/interactive/wire/green,
/turf/simulated/floor/tile/shuttle/purple,
/area/mission/prefab/misc/golem/center)
"ca" = (
/obj/item/ball/soccer,
/obj/structure/interactive/wire/yellow,
/turf/simulated/floor/tile/shuttle,
/area/mission/prefab/misc/golem/right)
"cb" = (
/obj/structure/interactive/wire/yellow,
/turf/simulated/floor/tile/shuttle,
/area/mission/prefab/misc/golem/right)
"cc" = (
/obj/marker/map_node,
/obj/structure/interactive/wire/yellow,
/turf/simulated/floor/tile/shuttle,
/area/mission/prefab/misc/golem/right)
"cd" = (
/obj/marker/map_node,
/obj/structure/interactive/wire/yellow,
/turf/simulated/floor/plating/shuttle,
/area/mission/prefab/misc/golem/right)
"ce" = (
/obj/structure/interactive/door/airlock/shuttle,
/obj/structure/interactive/wire/yellow,
/turf/simulated/floor/tile/shuttle,
/area/mission/prefab/misc/golem/right)
"cf" = (
/obj/marker/map_node,
/obj/structure/interactive/wire/green,
/turf/simulated/floor/tile/shuttle/purple,
/area/mission/prefab/misc/golem/right)
"cg" = (
/obj/structure/interactive/wire/green,
/turf/simulated/floor/tile/shuttle/purple,
/area/mission/prefab/misc/golem/center)
"ch" = (
/obj/structure/interactive/lighting/fixture/tube/station,
/obj/structure/interactive/wire/green,
/turf/simulated/floor/tile/shuttle/purple,
/area/mission/prefab/misc/golem/center)
"ci" = (
/obj/structure/interactive/power/apc,
/turf/simulated/wall/metal/shuttle/off_white,
/area/mission/prefab/misc/golem/right)
"cj" = (
/obj/marker/map_node,
/obj/structure/interactive/wire/green,
/turf/simulated/floor/tile/shuttle,
/area/mission/prefab/misc/golem/left)
"ck" = (
/obj/structure/interactive/wire/green,
/turf/simulated/floor/tile/shuttle,
/area/mission/prefab/misc/golem/left)
"cl" = (
/obj/structure/interactive/lighting/fixture/tube/station{
	dir = 8;
	icon_state = "preview"
	},
/obj/structure/interactive/wire/green,
/turf/simulated/floor/tile/shuttle,
/area/mission/prefab/misc/golem/center)
"cm" = (
/obj/marker/map_node,
/obj/structure/interactive/wire/green,
/turf/simulated/floor/tile/shuttle/purple,
/area/mission/prefab/misc/golem/left)
"cn" = (
/obj/structure/interactive/wire/green,
/turf/simulated/floor/tile/shuttle/purple,
/area/mission/prefab/misc/golem/left)
"co" = (
/obj/structure/table/reinforced,
/obj/structure/interactive/wire/green,
/turf/simulated/floor/tile/shuttle/black,
/area/mission/prefab/misc/golem/left)
"cp" = (
/obj/structure/interactive/power/apc{
	icon_state = "apc";
	dir = 1
	},
/turf/simulated/wall/metal/shuttle/off_white,
/area/mission/prefab/misc/golem/left)
"cq" = (
/obj/structure/interactive/power/apc,
/turf/simulated/wall/metal/shuttle/off_white,
/area/mission/prefab/misc/golem/center)
"cr" = (
/turf/simulated/floor/plating/shuttle,
/area/mission/prefab/misc/golem/left)
"cs" = (
/obj/structure/shuttle_engine/large{
	dir = 4
	},
/turf/simulated/floor/plating/shuttle,
/area/mission/prefab/misc/golem/left)

(1,1,1) = {"
aa
aa
aa
aa
aa
aa
aa
aa
aa
aa
aa
aa
aa
aa
aa
aa
aa
aa
aa
aa
aa
aa
aa
aa
aa
aa
aa
aa
aa
aa
aa
aa
"}
(2,1,1) = {"
aa
aa
aa
aa
aa
aa
aa
aa
aa
aa
aa
aa
aa
aa
aa
aa
aa
aa
aa
aa
aa
aa
aa
aa
aa
aa
aa
aa
aa
aa
aa
aa
"}
(3,1,1) = {"
aa
aa
aa
aa
aa
aa
aa
aa
aa
aa
aa
aa
aa
aa
aa
aa
aa
aa
aa
aa
aa
aa
aa
aa
aa
aa
aa
aa
aa
aa
aa
aa
"}
(4,1,1) = {"
aa
aa
aa
aa
aa
aa
aa
aa
aa
aa
aa
aa
aa
aI
aI
aI
aI
aI
aI
aI
aa
aa
aa
aa
aa
aa
aa
aa
aa
aa
aa
aa
"}
(5,1,1) = {"
aa
aa
aa
aa
aa
aa
aa
aa
aa
aa
aa
aa
aa
aI
aP
aY
bf
aY
bo
aI
aa
aa
aa
aa
aa
aa
aa
aa
aa
aa
aa
aa
"}
(6,1,1) = {"
aa
aa
aa
aa
aa
aa
aa
aa
aa
aa
aa
aa
aa
aI
aQ
aY
aY
aY
aQ
aI
aa
aa
aa
aa
aa
aa
aa
aa
aa
aa
aa
aa
"}
(7,1,1) = {"
aa
aa
aa
aa
aa
aa
aa
aa
aa
aa
aa
aa
aa
aI
aR
aZ
ba
aZ
aR
aI
aa
aa
aa
aa
aa
aa
aa
aa
aa
aa
aa
aa
"}
(8,1,1) = {"
aa
aa
aa
aa
aa
aa
aa
aa
aa
aa
aa
aa
ab
aI
aR
aZ
bg
aZ
aR
aI
ab
aa
aa
aa
aa
aa
aa
aa
aa
aa
aa
aa
"}
(9,1,1) = {"
aa
aa
aa
aa
aa
aa
aa
aa
aa
aa
aa
ab
ab
aI
aR
aZ
bh
aZ
aR
aI
ab
ab
aa
aa
aa
aa
aa
aa
aa
aa
aa
aa
"}
(10,1,1) = {"
aa
aa
aa
aa
aa
aa
aa
aa
af
af
ay
ay
cd
aI
aS
aZ
ba
aZ
bp
aI
ac
ab
ab
aa
aa
aa
aa
aa
aa
aa
aa
aa
"}
(11,1,1) = {"
aa
aa
aa
aa
aa
aa
aa
ad
ad
ad
ad
ad
ce
aI
aR
ba
ba
ba
aR
aI
bz
bk
bk
bk
bk
bk
aa
aa
aa
aa
aa
aa
"}
(12,1,1) = {"
aa
aa
aa
aa
aa
aa
ab
ad
ag
ar
ad
ax
cc
aI
aR
ba
ba
ba
aR
aI
bA
bC
bk
bM
bP
bk
ab
aa
aa
aa
aa
aa
"}
(13,1,1) = {"
aa
aa
aa
aa
aa
ab
ac
ae
ah
ar
ad
ca
cb
aJ
aT
bb
ba
ba
aR
aI
bC
bC
bk
bM
bQ
bY
ac
ab
aa
aa
aa
aa
"}
(14,1,1) = {"
aa
aa
aa
aa
aa
aa
ab
ad
ai
ar
ad
cb
az
aI
aR
bb
bi
ba
aR
aI
bC
bC
bk
bM
bR
bk
ab
ab
aa
aa
aa
aa
"}
(15,1,1) = {"
aa
aa
aa
aa
aa
aa
aa
ad
aj
ar
ad
cb
aB
aI
aU
bb
ba
ba
bq
aI
bE
bC
bk
bM
bS
bk
ab
aa
aa
aa
aa
aa
"}
(16,1,1) = {"
aa
aa
aa
aa
aa
aa
aa
ad
ak
as
au
cc
aA
av
av
bc
aw
aw
av
av
bC
cj
bl
cm
bT
bk
aa
aa
aa
aa
aa
aa
"}
(17,1,1) = {"
aa
aa
aa
aa
aa
aa
aa
ad
al
ar
ad
cb
az
av
aV
bd
aK
aK
aN
av
bC
ck
bk
cn
bU
bk
aa
aa
aa
aa
aa
aa
"}
(18,1,1) = {"
aa
aa
aa
aa
aa
aa
aa
ad
am
ar
ad
aW
bL
bc
bZ
bd
bj
bd
bZ
bc
cj
ck
bk
cn
bV
bk
aa
aa
aa
aa
aa
aa
"}
(19,1,1) = {"
aa
aa
aa
aa
aa
aa
aa
ci
an
aX
av
av
av
av
ch
aK
aK
bd
br
av
av
av
av
cn
co
cp
aa
aa
aa
aa
aa
aa
"}
(20,1,1) = {"
aa
aa
aa
aa
aa
aa
aa
ad
ao
cf
bc
bZ
cg
cg
cg
aK
aK
bd
aN
bt
bB
bG
aw
bN
bW
bk
af
aa
aa
aa
aa
aa
"}
(21,1,1) = {"
aa
aa
aa
aa
aa
aa
aa
ad
ai
as
aw
aC
aK
aK
aK
aK
aK
bd
aK
aK
aK
bH
aw
bN
bR
bk
aa
aa
aa
aa
aa
aa
"}
(22,1,1) = {"
aa
aa
aa
aa
aa
aa
aa
ad
aj
ar
av
aD
aK
aK
aK
aK
bn
bd
aK
bw
aK
bG
av
bM
bS
bk
aa
aa
aa
aa
aa
aa
"}
(23,1,1) = {"
aa
aa
aa
aa
aa
aa
ab
ad
ak
ar
av
aE
aL
aK
aK
aK
aK
bd
aK
aK
aL
bI
av
bM
bT
bk
ab
aa
aa
aa
aa
aa
"}
(24,1,1) = {"
aa
aa
aa
aa
aa
ab
ac
ae
ah
ar
av
aF
aK
aK
aM
aK
aK
bd
cl
bd
aK
aN
by
bM
bQ
bY
ac
ab
aa
aa
aa
aa
"}
(25,1,1) = {"
aa
aa
aa
aa
aa
aa
ab
ad
ap
at
av
aG
aK
aK
av
aw
aw
aw
cq
bd
bF
bJ
av
bO
bX
bk
ab
ab
aa
aa
aa
aa
"}
(26,1,1) = {"
aa
aa
aa
aa
aa
aa
aa
ad
ap
at
av
aH
aH
aO
av
aK
aK
aK
av
bv
bD
bK
av
bO
bX
bk
ab
aa
aa
aa
aa
aa
"}
(27,1,1) = {"
aa
aa
aa
aa
aa
aa
aa
ad
ad
ad
av
av
av
av
av
be
aL
bu
av
av
av
av
av
bk
bk
bk
aa
aa
aa
aa
aa
aa
"}
(28,1,1) = {"
aa
aa
aa
aa
aa
aa
aa
ad
aq
bx
aq
bx
aq
bx
av
aK
aK
aK
av
cr
cs
cr
cs
cr
cs
bk
aa
aa
aa
aa
aa
aa
"}
(29,1,1) = {"
aa
aa
aa
aa
aa
aa
aa
ad
aq
aq
aq
aq
aq
aq
av
aw
aw
aw
av
cr
cr
cr
cr
cr
cr
bk
aa
aa
aa
aa
aa
aa
"}
(30,1,1) = {"
aa
aa
aa
aa
aa
aa
aa
aa
aa
aa
aa
aa
aa
ab
ab
ab
ab
ab
bs
ab
ab
aa
aa
aa
aa
aa
aa
aa
aa
aa
aa
aa
"}
(31,1,1) = {"
aa
aa
aa
aa
aa
aa
aa
aa
aa
aa
aa
aa
aa
aa
ab
ab
bm
ab
ab
ab
aa
aa
aa
aa
aa
aa
aa
aa
aa
aa
aa
aa
"}
(32,1,1) = {"
aa
aa
aa
aa
aa
aa
aa
aa
aa
aa
aa
aa
aa
aa
aa
ab
ab
ab
ab
aa
aa
aa
aa
aa
aa
aa
aa
aa
aa
aa
aa
aa
"}
