"aa" = (/turf/simulated/wall/brick/red/rev,/area/dmm_suite/clear_area)
"ab" = (/obj/marker/map_node,/turf/simulated/floor/colored/dirt,/area/dmm_suite/clear_area)
"ac" = (/turf/simulated/floor/colored/dirt,/area/dmm_suite/clear_area)
"ad" = (/obj/structure/scenery/flowers,/turf/simulated/floor/grass/jungle,/area/dmm_suite/clear_area)
"ae" = (/turf/simulated/floor/grass/jungle,/area/dmm_suite/clear_area)
"af" = (/obj/structure/interactive/tree/evergreen,/turf/simulated/floor/grass/jungle,/area/dmm_suite/clear_area)
"ag" = (/obj/marker/map_node,/turf/simulated/floor/grass/jungle,/area/dmm_suite/clear_area)
"ah" = (/obj/structure/scenery/rocks,/turf/simulated/floor/colored/dirt,/area/dmm_suite/clear_area)
"ai" = (/obj/structure/scenery/rocks,/obj/structure/interactive/crate/chest/filled,/turf/simulated/floor/colored/dirt,/area/dmm_suite/clear_area)
"aj" = (/obj/structure/interactive/tree/evergreen,/turf/simulated/floor/colored/dirt,/area/dmm_suite/clear_area)
"ak" = (/obj/structure/scenery/bush/grass,/turf/simulated/floor/grass/jungle,/area/dmm_suite/clear_area)
"al" = (/obj/structure/interactive/storage/trash_pile,/turf/simulated/floor/colored/dirt,/area/dmm_suite/clear_area)
"am" = (/obj/structure/scenery/rocks,/obj/marker/map_node,/turf/simulated/floor/colored/dirt,/area/dmm_suite/clear_area)
"an" = (/turf/simulated/wall/brick/red/dark/rev,/area/mission/prefab/misc/rev_base_3)
"ao" = (/obj/structure/interactive/solar_panel,/obj/structure/interactive/wire/yellow,/turf/simulated/floor/grass/jungle,/area/dmm_suite/clear_area)
"ap" = (/turf/simulated/wall/brick/red/dark/rev,/area/mission/prefab/misc/rev_base_1)
"aq" = (/obj/structure/interactive/shower,/turf/simulated/floor/brick/grey/dark,/area/mission/prefab/misc/rev_base_3)
"ar" = (/turf/simulated/floor/brick/grey/dark,/area/mission/prefab/misc/rev_base_3)
"as" = (/mob/living/advanced/npc/rev,/turf/simulated/floor/brick/grey/dark,/area/mission/prefab/misc/rev_base_3)
"at" = (/obj/structure/interactive/crate/trash,/turf/simulated/floor/brick/grey/dark,/area/mission/prefab/misc/rev_base_3)
"au" = (/obj/structure/interactive/crate/trash,/turf/simulated/floor/brick/grey/dark,/area/mission/prefab/misc/rev_base_1)
"aw" = (/obj/structure/interactive/vending/syndicate/medicine,/turf/simulated/floor/brick/grey/dark,/area/mission/prefab/misc/rev_base_1)
"ax" = (/obj/structure/interactive/vending/syndicate/attachment,/turf/simulated/floor/brick/grey/dark,/area/mission/prefab/misc/rev_base_1)
"ay" = (/obj/structure/interactive/lighting/fixture/bulb,/turf/simulated/floor/brick/grey/dark,/area/mission/prefab/misc/rev_base_1)
"az" = (/obj/structure/interactive/vending/syndicate/guns/rev,/turf/simulated/floor/brick/grey/dark,/area/mission/prefab/misc/rev_base_1)
"aA" = (/obj/structure/interactive/vending/syndicate/prize/rev,/obj/structure/interactive/lighting/fixture/bulb,/turf/simulated/floor/brick/grey/dark,/area/mission/prefab/misc/rev_base_1)
"aB" = (/obj/structure/interactive/restocker/ammo,/turf/simulated/floor/brick/grey/dark,/area/mission/prefab/misc/rev_base_1)
"aC" = (/obj/structure/interactive/lighting/fixture/bulb{dir = 4; icon_state = "preview"},/turf/simulated/floor/brick/grey/dark,/area/mission/prefab/misc/rev_base_3)
"aD" = (/obj/structure/interactive/misc/toilet{dir = 8; icon_state = "toilet"},/turf/simulated/floor/brick/grey/dark,/area/mission/prefab/misc/rev_base_3)
"aE" = (/obj/structure/interactive/wire/yellow,/turf/simulated/floor/grass/jungle,/area/dmm_suite/clear_area)
"aF" = (/turf/simulated/floor/brick/grey/dark,/area/mission/prefab/misc/rev_base_1)
"aG" = (/obj/structure/interactive/door/metal,/turf/simulated/floor/brick/grey/dark,/area/mission/prefab/misc/rev_base_1)
"aH" = (/obj/structure/interactive/misc/sink{dir = 8; icon_state = "sink"},/turf/simulated/floor/brick/grey/dark,/area/mission/prefab/misc/rev_base_3)
"aI" = (/obj/structure/interactive/lighting/fixture/bulb{dir = 8; icon_state = "preview"},/turf/simulated/floor/brick/grey/dark,/area/mission/prefab/misc/rev_base_3)
"aJ" = (/obj/structure/interactive/power/smes{icon_state = "smes_map"; dir = 1},/obj/structure/interactive/wire/green,/turf/simulated/floor/grass/jungle,/area/dmm_suite/clear_area)
"aK" = (/obj/structure/scenery/grass/lavender,/turf/simulated/floor/grass/jungle,/area/dmm_suite/clear_area)
"aL" = (/obj/structure/interactive/lighting/streetlamp,/turf/simulated/floor/grass/jungle,/area/dmm_suite/clear_area)
"aM" = (/obj/marker/map_node/x2,/turf/simulated/floor/colored/dirt,/area/dmm_suite/clear_area)
"aN" = (/mob/living/advanced/npc/rev{dir = 4; icon_state = "directional"},/turf/simulated/floor/brick/grey/dark,/area/mission/prefab/misc/rev_base_1)
"aO" = (/obj/marker/map_node,/turf/simulated/floor/brick/grey/dark,/area/mission/prefab/misc/rev_base_1)
"aP" = (/obj/structure/interactive/light_switch{dir = 8; icon_state = "setup"},/turf/simulated/wall/brick/red/dark/rev,/area/mission/prefab/misc/rev_base_1)
"aQ" = (/obj/marker/map_node,/obj/structure/interactive/wire/green,/turf/simulated/floor/brick/grey/dark,/area/mission/prefab/misc/rev_base_3)
"aR" = (/obj/structure/interactive/wire/green,/turf/simulated/floor/brick/grey/dark,/area/mission/prefab/misc/rev_base_3)
"aS" = (/obj/structure/scenery/grass/normal,/obj/structure/interactive/wire/green,/turf/simulated/floor/grass/jungle,/area/dmm_suite/clear_area)
"aT" = (/mob/living/advanced/npc/rev,/turf/simulated/floor/colored/dirt,/area/dmm_suite/clear_area)
"aU" = (/obj/structure/interactive/lighting/streetlamp,/turf/simulated/floor/colored/dirt,/area/dmm_suite/clear_area)
"aV" = (/obj/structure/interactive/lighting/fixture/bulb{dir = 4; icon_state = "preview"},/mob/living/advanced/npc/rev{dir = 4; icon_state = "directional"},/turf/simulated/floor/brick/grey/dark,/area/mission/prefab/misc/rev_base_1)
"aW" = (/obj/structure/interactive/lighting/fixture/bulb{dir = 8; icon_state = "preview"},/turf/simulated/floor/brick/grey/dark,/area/mission/prefab/misc/rev_base_1)
"aX" = (/obj/structure/interactive/light_switch{dir = 1; icon_state = "setup"},/turf/simulated/wall/brick/red/dark/rev,/area/mission/prefab/misc/rev_base_3)
"aY" = (/obj/structure/interactive/door/metal,/obj/structure/interactive/wire/green,/turf/simulated/floor/brick/grey/dark,/area/mission/prefab/misc/rev_base_3)
"aZ" = (/obj/structure/interactive/wire/green,/turf/simulated/floor/grass/jungle,/area/dmm_suite/clear_area)
"ba" = (/obj/structure/interactive/misc/mirror/cracked/chargen{pixel_x = 32},/obj/structure/interactive/misc/sink{dir = 4; icon_state = "sink"},/turf/simulated/floor/brick/grey/dark,/area/mission/prefab/misc/rev_base_1)
"bb" = (/obj/marker/map_node,/obj/structure/interactive/wire/green,/turf/simulated/floor/grass/jungle,/area/dmm_suite/clear_area)
"bc" = (/obj/structure/interactive/lighting/streetlamp,/obj/structure/interactive/wire/green,/turf/simulated/floor/grass/jungle,/area/dmm_suite/clear_area)
"bd" = (/obj/structure/interactive/chair{dir = 4; icon_state = "chair"},/mob/living/advanced/npc/rev{dir = 4; icon_state = "directional"},/turf/simulated/floor/brick/grey/dark,/area/mission/prefab/misc/rev_base_1)
"be" = (/obj/structure/interactive/chair{dir = 8; icon_state = "chair"},/turf/simulated/floor/brick/grey/dark,/area/mission/prefab/misc/rev_base_1)
"bf" = (/obj/structure/scenery/grass/normal,/turf/simulated/floor/grass/jungle,/area/dmm_suite/clear_area)
"bg" = (/obj/marker/lobby,/turf/simulated/floor/colored/dirt,/area/dmm_suite/clear_area)
"bh" = (/obj/structure/interactive/wire/green,/turf/simulated/floor/brick/grey/dark,/area/mission/prefab/misc/rev_base_1)
"bi" = (/obj/structure/interactive/chair{dir = 4; icon_state = "chair"},/turf/simulated/floor/brick/grey/dark,/area/mission/prefab/misc/rev_base_1)
"bj" = (/obj/structure/interactive/chair{dir = 8; icon_state = "chair"},/mob/living/advanced/npc/rev{dir = 8; icon_state = "directional"},/turf/simulated/floor/brick/grey/dark,/area/mission/prefab/misc/rev_base_1)
"bk" = (/turf/simulated/wall/wood/rev,/area/mission/prefab/misc/rev_base_2)
"bl" = (/obj/structure/interactive/lighting/fixture/bulb{dir = 4; icon_state = "preview"},/obj/structure/interactive/wire/green,/turf/simulated/floor/brick/grey/dark,/area/mission/prefab/misc/rev_base_1)
"bm" = (/obj/structure/interactive/storage/trash_pile,/turf/simulated/floor/grass/jungle,/area/dmm_suite/clear_area)
"bn" = (/obj/structure/interactive/crate/chest/filled,/turf/simulated/floor/wood/brown,/area/mission/prefab/misc/rev_base_2)
"bo" = (/obj/structure/interactive/crate/closet,/turf/simulated/floor/wood/brown,/area/mission/prefab/misc/rev_base_2)
"bp" = (/obj/structure/interactive/crate/closet,/obj/structure/interactive/lighting/fixture/bulb,/turf/simulated/floor/wood/brown,/area/mission/prefab/misc/rev_base_2)
"bq" = (/obj/structure/interactive/misc/tv,/turf/simulated/floor/wood/brown,/area/mission/prefab/misc/rev_base_2)
"br" = (/turf/simulated/floor/wood/brown,/area/mission/prefab/misc/rev_base_2)
"bs" = (/obj/structure/interactive/light_switch{dir = 4; icon_state = "setup"},/turf/simulated/wall/brick/red/dark/rev,/area/mission/prefab/misc/rev_base_1)
"bt" = (/obj/structure/interactive/lighting/fixture/bulb{dir = 4; icon_state = "preview"},/turf/simulated/floor/wood/brown,/area/mission/prefab/misc/rev_base_2)
"bu" = (/mob/living/advanced/npc/rev,/turf/simulated/floor/wood/brown,/area/mission/prefab/misc/rev_base_2)
"bv" = (/obj/structure/interactive/lighting/fixture/bulb{dir = 8; icon_state = "preview"},/turf/simulated/floor/wood/brown,/area/mission/prefab/misc/rev_base_2)
"bw" = (/obj/structure/interactive/wire/green,/turf/simulated/floor/colored/dirt,/area/dmm_suite/clear_area)
"bx" = (/obj/marker/map_node/x2,/obj/structure/interactive/wire/green,/turf/simulated/floor/colored/dirt,/area/dmm_suite/clear_area)
"by" = (/obj/marker/map_node,/obj/structure/interactive/wire/green,/turf/simulated/floor/colored/dirt,/area/dmm_suite/clear_area)
"bz" = (/obj/structure/interactive/door/metal,/obj/structure/interactive/wire/green,/turf/simulated/floor/brick/grey/dark,/area/mission/prefab/misc/rev_base_1)
"bA" = (/obj/marker/map_node,/obj/structure/interactive/wire/green,/turf/simulated/floor/brick/grey/dark,/area/mission/prefab/misc/rev_base_1)
"bB" = (/obj/marker/map_node,/turf/simulated/floor/wood/brown,/area/mission/prefab/misc/rev_base_2)
"bC" = (/obj/structure/interactive/lighting/fixture/bulb{dir = 1},/turf/simulated/floor/brick/grey/dark,/area/mission/prefab/misc/rev_base_1)
"bD" = (/obj/marker/objective_spawn,/turf/simulated/floor/brick/grey/dark,/area/mission/prefab/misc/rev_base_1)
"bE" = (/obj/structure/interactive/chair/stool/bar,/turf/simulated/floor/wood/brown,/area/mission/prefab/misc/rev_base_2)
"bF" = (/obj/structure/scenery/flowers,/obj/marker/map_node,/turf/simulated/floor/grass/jungle,/area/dmm_suite/clear_area)
"bG" = (/obj/structure/interactive/wire/green,/turf/simulated/floor/wood/brown,/area/mission/prefab/misc/rev_base_2)
"bH" = (/obj/structure/interactive/plant/wheat,/turf/simulated/floor/colored/dirt/soil,/area/dmm_suite/clear_area)
"bI" = (/turf/simulated/floor/colored/dirt/soil,/area/dmm_suite/clear_area)
"bJ" = (/obj/structure/interactive/crate/chest/filled,/turf/simulated/floor/grass/jungle,/area/dmm_suite/clear_area)
"bK" = (/obj/structure/interactive/chair/wood{dir = 4; icon_state = "wooden_chair"},/mob/living/advanced/npc/rev{dir = 4; icon_state = "directional"},/turf/simulated/floor/wood/brown,/area/mission/prefab/misc/rev_base_2)
"bL" = (/obj/structure/interactive/chair/wood{dir = 8; icon_state = "wooden_chair"},/turf/simulated/floor/wood/brown,/area/mission/prefab/misc/rev_base_2)
"bM" = (/obj/structure/interactive/light_switch{dir = 8; icon_state = "setup"},/turf/simulated/wall/wood/rev,/area/mission/prefab/misc/rev_base_2)
"bN" = (/obj/structure/interactive/tree/evergreen,/obj/structure/interactive/wire/green,/turf/simulated/floor/grass/jungle,/area/dmm_suite/clear_area)
"bO" = (/obj/structure/interactive/chair/wood{dir = 4; icon_state = "wooden_chair"},/turf/simulated/floor/wood/brown,/area/mission/prefab/misc/rev_base_2)
"bP" = (/obj/marker/map_node,/obj/structure/interactive/wire/green,/turf/simulated/floor/wood/brown,/area/mission/prefab/misc/rev_base_2)
"bQ" = (/obj/structure/interactive/door/wood,/obj/structure/interactive/wire/green,/turf/simulated/floor/wood/brown,/area/mission/prefab/misc/rev_base_2)
"bR" = (/obj/structure/interactive/potted_plant/bin,/turf/simulated/floor/wood/brown,/area/mission/prefab/misc/rev_base_2)
"bS" = (/obj/structure/interactive/chair/wood{dir = 1; icon_state = "wooden_chair"},/turf/simulated/floor/wood/brown,/area/mission/prefab/misc/rev_base_2)
"bT" = (/obj/structure/interactive/lighting/fixture/bulb{dir = 1},/turf/simulated/floor/wood/brown,/area/mission/prefab/misc/rev_base_2)
"bU" = (/obj/structure/interactive/crate/trash,/turf/simulated/floor/wood/brown,/area/mission/prefab/misc/rev_base_2)
"bV" = (/mob/living/advanced/npc/rev{dir = 8; icon_state = "directional"},/turf/simulated/floor/colored/dirt,/area/dmm_suite/clear_area)
"bW" = (/mob/living/advanced/npc/rev{dir = 4; icon_state = "directional"},/turf/simulated/floor/grass/jungle,/area/dmm_suite/clear_area)
"bX" = (/obj/marker/map_node/x2,/turf/simulated/floor/grass/jungle,/area/dmm_suite/clear_area)
"bY" = (/obj/structure/interactive/barricade,/mob/living/advanced/npc/rev,/turf/simulated/floor/colored/dirt,/area/dmm_suite/clear_area)
"bZ" = (/turf/dmm_suite/clear_turf,/area/dmm_suite/clear_area)
"ca" = (/turf/dmm_suite/no_wall,/area/dmm_suite/clear_area)
"cb" = (/obj/marker/map_node/x3,/turf/dmm_suite/no_wall,/area/dmm_suite/clear_area)

(1,1,1) = {"
aaaaaaaaaaaaaaaaaaaaaaaaaaaaaaaaaaaaaaaaaaaaaaaaaaaaaaaaaaaaaaaa
aaabacacacabacacacacacabacadaeaeafagacacacabacacabacahahahahaiaa
aaacacacacaeaeaeajacaeakakakaeaeagabacacacacalalalacacabacahamaa
aaacacananananananaeakaoaoakaeacacalapapapapapapapapapapapacahaa
aaacacanaqarasatanafakaoaoaeafacacalapauaFawaxayazaAaFaBapacahaa
aaabacanaCararaDanaEaEaEaeaeacacacalapaFaFaFaFaFaFaFaFaFaGalabaa
aaacacanaHararaIanaJaKaLacacacaMacacapaNaOaFaFaFaFaFaOaFaPalacaa
aaacaeanararaQaRanaSaeacacacaTacacaUapaVaFaFapapapaFaFaWapalacaa
aaacaeananaXaYananaZacacaMacacacacacapaNaFaFaFaFaFaFaFbaapacacaa
aaacafaLafaebbaZbcaZafacacacacaMacacapaFaFaFbdaFbeaFaFbaapacacaa
aaacacaeaeaeaebfaeaZaeacacacacbgacacapbhaOaFbiaFbeaFaObaapacabaa
aaabaeaKaeaeafaeadaZaZaZaSaZacaTacacapbhaFaFbiaFbjaFaFbaapalacaa
aaacaebkbkbkbkbkbkbkbkbkbkbcacacacaUapblaFaFaFaOaFaFaFaWapbmacaa
aaacaebkbnbobobpbqbrbrbrbkaZacacacacbsbhaFaFaFaFaFaFaFaFapbmaeaa
aaacaebkbtbrbrbrbubrbubvbkbwbwbxbwbybzbAaFaFaFaFaFaFaFaFapbmakaa
aaabaebkbrbBbrbrbrbrbBbrbkbwacacacaeapauaFbCaFbDaFbCaFaFapaeaeaa
aaacbmbkbrbEbEbEbEbEbEbEbkaZacacacaeapapapapapapapapapapapaebFaa
aaacbmbkbrbrbrbrbrbrbrbGbkaZacacacaKaebHbHbHbHbIbIbfaebJaeaeaeaa
aaaebmbkbrbKbrbrbrbLbrbGbMbNacacacaeaebIbHbHbHbHbIaeaKbfafaeacaa
aaagbmbkbtbObrbrbBbLbrbPbQbbacacaMaeaebHbHbIbIbHbIaeaeaeaeabacaa
aaaeaebkbRbrbSbSbSbrbTbUbkaeacacacacaeaeaeaeaeaeaeaeaeaeacacacaa
aaaeaebkbkbkbkbkbkbkbkbkbkaLacacacacaLaebfaeaeaeaeafaeacacacbVaa
aaacaeafaeaebfaLaeaeaeaeaeaeacacacacacaeaeafakaeaeaeacacacacacaa
aaabacaeaeaebWaeaeaeaebXakacacacacacacaMacacacacabacacacacabacaa
aaacacacacacabacacacacacacbYbYababbYbYacacacacacacacacacacacacaa
aaaaaaaaaaaaaaaaaaaaaaaaaaacacacacacacaaaaaaaaaaaaaaaaaaaaaaaaaa
bZbZbZbZbZbZbZbZbZcacacacacacacacacacacacacacabZbZbZbZbZbZbZbZbZ
bZbZbZbZbZbZbZcacacacacacacacacacacacacacacabZbZbZbZbZbZbZbZbZbZ
bZbZbZbZbZbZbZbZcacacacacacacacbcacacacacacacabZbZbZbZbZbZbZbZbZ
bZbZbZbZbZbZbZcacacacacacacacacacacacacacacacabZbZbZbZbZbZbZbZbZ
bZbZbZbZbZbZbZbZbZbZcacacacacacacacacacabZbZbZbZbZbZbZbZbZbZbZbZ
bZbZbZbZbZbZbZbZbZbZbZbZbZbZbZbZbZbZbZbZbZbZbZbZbZbZbZbZbZbZbZbZ
"}
