"a" = (/turf/dmm_suite/clear_turf,/area)
"b" = (/turf/simulated/floor/sidewalk,/area)
"c" = (/obj/decal/road_marking/solid_line,/turf/simulated/floor/road,/area)
"d" = (/turf/simulated/floor/road,/area)
"e" = (/obj/decal/road_marking/dotted_line,/turf/simulated/floor/road,/area)
"f" = (/obj/decal/road_marking/solid_line{icon_state = "1"; dir = 6},/turf/simulated/floor/road,/area)
"g" = (/obj/decal/road_marking/solid_line{icon_state = "1"; dir = 8},/turf/simulated/floor/road,/area)
"h" = (/obj/decal/road_marking/solid_line{icon_state = "1"; dir = 9},/turf/simulated/floor/road,/area)
"i" = (/obj/decal/road_marking/solid_line/yellow,/turf/simulated/floor/road,/area)
"j" = (/obj/decal/road_marking/solid_stop{icon_state = "1"; dir = 1},/turf/simulated/floor/road,/area)
"k" = (/obj/decal/road_marking/solid_cross{icon_state = "1"; dir = 4},/turf/simulated/floor/road,/area)
"l" = (/obj/structure/interactive/lighting/roadlamp{icon_state = "lamp"; dir = 4},/turf/simulated/floor/sidewalk,/area)
"m" = (/obj/decal/road_marking/solid_line{icon_state = "1"; dir = 10},/turf/simulated/floor/road,/area)
"n" = (/obj/decal/road_marking/solid_cross,/turf/simulated/floor/road,/area)
"o" = (/obj/structure/interactive/lighting/roadlamp{icon_state = "lamp"; dir = 8},/turf/simulated/floor/sidewalk,/area)
"p" = (/obj/marker/prefab/house,/turf/dmm_suite/clear_turf,/area)
"q" = (/obj/structure/interactive/stopsign{icon_state = "sign"; dir = 1},/turf/simulated/floor/sidewalk,/area)
"r" = (/obj/marker/prefab/yard,/turf/dmm_suite/clear_turf,/area)
"s" = (/obj/marker/prefab/house{icon_state = ""; dir = 1},/turf/dmm_suite/clear_turf,/area)
"t" = (/obj/marker/prefab/alley,/turf/dmm_suite/clear_turf,/area)
"u" = (/obj/structure/interactive/lighting/roadlamp,/turf/simulated/floor/sidewalk,/area)
"v" = (/obj/marker/prefab/alley{icon_state = "alley"; dir = 4},/turf/dmm_suite/clear_turf,/area)
"w" = (/obj/structure/interactive/stopsign{icon_state = "sign"; dir = 4},/turf/simulated/floor/sidewalk,/area)
"x" = (/obj/decal/road_marking/solid_line{icon_state = "1"; dir = 4},/turf/simulated/floor/road,/area)
"y" = (/obj/marker/prefab/alley{icon_state = "alley"; dir = 10},/turf/dmm_suite/clear_turf,/area)
"z" = (/obj/decal/road_marking/solid_stop{icon_state = "1"; dir = 4},/turf/simulated/floor/road,/area)
"A" = (/obj/decal/road_marking/dotted_line{icon_state = "1"; dir = 4},/turf/simulated/floor/road,/area)
"B" = (/obj/decal/road_marking/solid_line/yellow{icon_state = "1"; dir = 4},/turf/simulated/floor/road,/area)
"C" = (/turf/simulated/wall/brick/red,/area)
"D" = (/obj/structure/interactive/lighting/roadlamp{icon_state = "lamp"; dir = 1},/turf/simulated/floor/sidewalk,/area)
"E" = (/obj/structure/interactive/stopsign{icon_state = "sign"; dir = 8},/turf/simulated/floor/sidewalk,/area)
"F" = (/turf/simulated/floor/colored/dirt/path,/area)
"G" = (/obj/marker/prefab/alley{icon_state = "alley"; dir = 5},/turf/dmm_suite/clear_turf,/area)
"H" = (/obj/marker/prefab/small,/turf/dmm_suite/clear_turf,/area)
"I" = (/turf/dmm_suite/no_wall,/area)

(1,1,1) = {"
bbbbbbbbbbbbbbbbbbbbbbbbbbbbbcddeddcbaaaaaaaaaaaaaaaaaaaaaaaaaaa
bfxxxxxxxxxxxxxxxxxxxxxxxxxxxhddeddcbaaaaaaaaaaaaaaaaCCaaaaaaaaa
bcddddddddddddddddddddddddddddddeddcbaaaaaaaaaaaaaaaaFFaaaaaaaaa
bcddddddddddddddddddddddddddddddeddcbaaaaaaaaaaaaaaaaFFaaaaaaaaa
bcdddAAAAAAAAAAAAAAAAAAAAAAAAAAAdddcbaaaaaaaaaaaaaaaaFFaaaaaaaaa
bcddeddddddddddddddddddddddddddddddcbaaaaaaaaaaaaaaaaFFaaaaaaaaa
bcddeddddddddddddddddddddddddddddddcbaaaaaaaaaaaaaaaaFFaaaaaaaaa
bcddeddfxxxxxxxxxxxxxxxxxxxxxgggggghbaaaaaaaaaaaaaaaaFFaaaaaaaaa
bcddeddcbbbbbbbbbbbbbbbbbbbbbbbbbbbbbvaaaaaaavaaaaaaaCCyaaaaaaaa
bcddeddcbIaaaaaaaaaaaaaaaaIaaaaaaaaaaaaaaaaaaaaaaaaaaaaaaaaaaaaa
lcddeddcbIaaaaaaaaaaaaaaaaIaaaaaaaaaaIIIIIIIIIIIIIIIIIIaaaaaaaaa
bcddeddcbIaaaaaaaaaaaaaaaaIaaaaaaaaaaIaaaaaaaaaaaaaaaaIaaaaaaaaa
bcddeddcbIaaaaaaaaaaaaaaaaIaaaaaaaaaaIaaaaaaaaaaaaaaaaIaaaaaaaaa
bcddeddcbIaaaaaaaaaaaaaaaaIaaaaaaaaaaIaaaaaaaaaaaaaaaaIaaaaaaaaa
bcddeddcbIaaaaaaaaaaaaaaaaIaaaaaaaaaaIaaaaaaaaaaaaaaaaIaaaaaaaaa
bcddeddcbIaaaaaaaaaaaaaaaaIaaaaaaaaaaIaaaaaaaaaaaaaaaaIaaaaaaaaa
bcddeddcbIaaaaaaaaaaaaaaaaIataaaaaaaaIaaaaaaaaaaaaaaaaItaaaaaaaa
bcddeddcbIaaaaaaaaaaaaaaaaIaCFFFFFFCaIaaaaaaaaaaaaaaaaIaaaaaaaaa
bcddiddcbIaaaaaaaaaaaaaaaaIaCFFFFFFCaIaaaaaaaaaaaaaaaaIaaaaaaaaa
bcddiddcoIaaaaaaaaaaaaaaaaIaCFFFFFFCaIaaaaaaaaaaaaaaaaIaaaaaaaaa
bcddiddcbIaaaaaaaaaaaaaaaaIaaaaaaaaaaIaaaaaaaaaaaaaaaaIaaaaaaaaa
bcddiddcbIaaaaaaaaaaaaaaaaIaaaaaaaaaaIaaaaaaaaaaaaaaaaIaaaaaaaaa
bcddiddcbIaaaaaaaaaaaaaaaaIaaaaaaaaaaIaaaaaaaaaaaaaaaaIaaaaaaaaa
bcddiddcbIaaaaaaaaaaaaaaaaIaaaaaaaaaaIaaaaaaaaaaaaaaaaIaaaaaaaaa
bcddiddcbIsaaaaaaaaaaaaaaaIaaaaaaaaaaIaaaaaaaaaaaaaaaaItaaaaaaaa
bcddiddcbIIIIIIIIIIIIIIIIIIaaaaaaaaaaIaaaaaaaaaaaaaaaaICFFFFFFCa
qcddiddcbaaaaaaaaaaaaaaaaaaaaaaaaaaaaIpaaaaaaaaaaaaaaaICFFFFFFCa
ljjjjddcbaaaaaaaaaaaaaaaaaaataaaaaaaaIIFFFFFFFIIIIIIIIICFFFFFFCa
bnnnnnnnbbbbbbbbbbbubbbbbbbbbbbbbbbbbFFFFFFFFFFFFFaaaaabbbbbbbbb
xdddddddxxxxxxxxxxxxxxxxxxxxxxxxxxxmbFFFaaaaaFFFFFFFFFFbfggggggx
dddddddddddddddddddddddddddddddddddcbCCCCCCCCCCCCCCCCCCbcddddddd
dddddddddddddddddddddddddddddddddddcbCaaaaaaaaaaaaaaaaCbcddddddd
AAAAAAAAAAAAAAAAAAAAAAAAAAAAAAAAdddcbCaaaaaaaaaaaaaaaaCbcdddAAAA
ddddddddddddddddddddddddddddddddeddcbCaaaaaaaaaaaaaaaaCbcddedddd
ddddddddddddddddddddddddddddddddeddcbCaaaaaaaaaaaaaaaaCbcddedddd
xxxxxxxxxxxxxxxxxxxxxxxxxxxxxmddeddcbCaaaaaaaaaaaaaaaaCbcddeddfx
bbbbbbbbbbbDbbbbbbbbbbbbbbEDbcddeddcbCaaaaaaaaaaaaaaaaCbcddeddcb
aaaCFFFFFFCaaaaaaaaaaaaaaaaabcddeddcoCaaaaaaaaaaaaaaaaCbcddeddcb
aaaaaaaaaaaaaaaaaaaaaaaaaaaabcddeddcbCraaaaaaaraaaaaaaCbcddeddcb
aaaaaaaaaaaaaaaaaaaaaaaaaaaabcddeddcbIaaaaaaaaaaaaaaaaIbcddeddcb
aaaaaaaaaaaaaaaaaaaaaaaaaaaabcddeddcbIaaaaaaaaaaaaaaaaIbcddeddcb
aaaaaaaaaaaaaaaaaaaaaaaaaaaabcddeddcbIaaaaaaaaaaaaaaaaIbcddeddcb
aaaaaaaaaaaaaaaaaaaaaaaaaaaabcddeddcbIaaaaaaaaaaaaaaaaIbcddeddcb
aaaaaaaaaaaaaaaaaaaaaaaaaaaabcddeddcbIaaaaaaaaaaaaaaaaIbcddeddcb
aaaaaaaaaaaaaaaaaaaaaaaaaaaabcddeddcbIaaaaaaaaaaaaaaaaIbcddeddcb
aaaGaaaaaaavaaaaaaayaaaaaaaalcddeddcbIaaaaaaaaaaaaaaaaIbcddeddcb
aaIIIIIIIIIIIIIIIIIaaaaaaaaabcddeddcbIaaaaaaaaaaaaaaaaIbcddeddcb
aaIaaaaaaaaaaaaaaaIaaaaaaaaabcddeddcbIaaaaaaaaaaaaaaaaIbcddeddcb
aaIaaaaaaaaaaaaaaaIaaaaaaaaabcddeddcbIaaaaaaaaaaaaaaaaIbcddeddcb
aaIaaaaaaaaaaaaaaaIaaaaaaaaabcddeddcbIaaaaaaaaaaaaaaaaIbcddeddcb
aaIaaaaaaaaaaaaaaaIaaaaaaaaabcddeddcbIaaaaaaaaaaaaaaaaIbcddeddcb
aaIaaaaaaaaaaaaaaaIaaaaaaaaabcddeddcbIaaaaaaaaaaaaaaaaIbcddeddcb
aaIaaaaaaaaaaaaaaaIaaaaaaaaabcddeddcbIaaaaaaaaaaaaaaaaIbcddeddcb
aaIaaaaaaaaaaaaaaaItaaaaaaaabcddeddcoIaaaaaaaaaaaaaaaaIbcddeddcb
aaIaaaaaaaaaaaaaaaIaaaaaaaaCbcddeddcbIpaaaaaaaaaaaaaaaIbcddeddcb
aaIaaaaaaaaaaaaaaaIaaaaaaaaFbcddeddcbuwbbbbbbbbbbbbbbubbcddeddcb
aaIaaaaaaaaaaaaaaaIaaaaaaaaFbcddedddkzxxxxxxxxxxxxxxxxxxhddeddcb
aaIaaaaaaaaaaaaaaaIaaaaaaaaFbcddedddkzdddddddddddddddddddddeddcb
aaIaaaaaaaaaaaaaaaIaaaaaaaaFbcddedddkzdddddddddddddddddddddeddcb
aaIaaaaaaaaaaaaaaaIaaaaaaaaFbcddedddkzBBBBBBBBBAAAAAAAAAAAAdddcb
aaIaaaaaaaaaaaaaaaIaaaaaaaaFbcddedddkdddddddddddddddddddddddddcb
aaIHaaaaaaaaaaaaaaIGaaaaaaaCbcddedddkdddddddddddddddddddddddddcb
aaIIIIIIIIIIIIIIIIIaaaaaaaaabcddedddkxxxxxxxxxxxxxxxxxxxxxxxxxhb
aaaaaaaaaaaaaaaaaaaaaaaaaaaabcddeddcbbbbbbbbbDbbbbbbbbbbbbbbbbbb
"}
