"aa" = (/turf/simulated/wall/rock/desert,/area/dmm_suite/clear_area)
"ab" = (/turf/dmm_suite/no_wall,/area/dmm_suite/clear_area)
"ac" = (/obj/marker/map_node,/turf/simulated/floor/tile/dark/er,/area/mission/prefab/boss/canman/left_wing)
"ad" = (/turf/simulated/wall/metal/syndicate/reinforced,/area/dmm_suite/clear_area)
"ae" = (/obj/marker/spawning/window/reinforced/grilled,/turf/simulated/floor/plating/syndicate,/area/mission/prefab/boss/canman/containment)
"af" = (/obj/structure/interactive/barricade{icon_state = "metal"; dir = 1},/turf/simulated/floor/tile/morphing/red/dark,/area/mission/prefab/boss/canman/containment)
"ag" = (/turf/simulated/wall/metal/syndicate/reinforced,/area/mission/prefab/boss/canman/containment)
"ah" = (/obj/structure/interactive/crate/trash,/obj/marker/spawning/random/trash,/turf/simulated/floor/tile/morphing/red/dark,/area/mission/prefab/boss/canman/left_wing)
"ai" = (/obj/structure/interactive/lighting/fixture/tube/syndicate,/turf/simulated/floor/tile/morphing/red/dark,/area/mission/prefab/boss/canman/containment)
"aj" = (/turf/simulated/floor/plating/syndicate,/area/dmm_suite/clear_area)
"ak" = (/obj/structure/interactive/barbed_wire{icon_state = "wire"; dir = 1},/turf/simulated/floor/tile/morphing/red/dark,/area/mission/prefab/boss/canman/containment)
"al" = (/turf/simulated/wall/rock/desert,/area/mission/prefab/boss/canman/containment)
"am" = (/obj/structure/interactive/wire/red,/turf/simulated/floor/plating/syndicate,/area/mission/prefab/boss/canman/containment)
"an" = (/obj/structure/interactive/power/apc{icon_state = "apc"; dir = 8},/turf/simulated/wall/metal/syndicate/reinforced,/area/mission/prefab/boss/canman/containment)
"ao" = (/obj/structure/interactive/field_generator/active,/turf/simulated/floor/tile/morphing/red/dark,/area/mission/prefab/boss/canman/containment)
"ap" = (/obj/structure/interactive/atmospherics/scrubber,/turf/simulated/floor/tile/dark/er,/area/mission/prefab/boss/canman/containment)
"aq" = (/obj/structure/interactive/barricade{icon_state = "metal"; dir = 1},/turf/simulated/floor/tile/dark/er,/area/mission/prefab/boss/canman/containment)
"ar" = (/obj/structure/interactive/atmospherics/vent,/turf/simulated/floor/tile/dark/er,/area/mission/prefab/boss/canman/containment)
"as" = (/obj/structure/interactive/door/airlock/external/syndicate/locked,/obj/structure/interactive/atmospherics/fan,/obj/structure/interactive/wire/red,/turf/simulated/floor/plating/syndicate,/area/mission/prefab/boss/canman/containment)
"at" = (/obj/structure/interactive/wire/red,/turf/simulated/floor/tile/morphing/red/dark,/area/mission/prefab/boss/canman/containment)
"au" = (/obj/structure/interactive/wire/red,/turf/simulated/floor/tile/dark/er,/area/mission/prefab/boss/canman/containment)
"av" = (/obj/structure/interactive/lighting/fixture/tube/syndicate{icon_state = "preview"; dir = 1},/turf/simulated/floor/tile/morphing/red/dark,/area/mission/prefab/boss/canman/containment)
"aw" = (/obj/structure/interactive/lighting/fixture/tube/syndicate{icon_state = "preview"; dir = 1},/obj/structure/interactive/wire/red,/turf/simulated/floor/tile/morphing/red/dark,/area/mission/prefab/boss/canman/containment)
"ax" = (/obj/structure/interactive/wire/red,/turf/simulated/floor/tile,/area/mission/prefab/boss/canman/containment)
"ay" = (/turf/simulated/floor/tile,/area/mission/prefab/boss/canman/containment)
"az" = (/obj/structure/sign/shock,/turf/simulated/wall/metal/syndicate/reinforced,/area/mission/prefab/boss/canman/containment)
"aA" = (/obj/structure/interactive/wire/red,/turf/simulated/floor/tile/red/dark,/area/mission/prefab/boss/canman/containment)
"aB" = (/turf/simulated/floor/tile/red/dark,/area/mission/prefab/boss/canman/containment)
"aC" = (/turf/simulated/wall/rock/desert,/area/mission/prefab/boss/canman/cave)
"aD" = (/obj/marker/map_node,/turf/simulated/floor/plating/reinforced/dark,/area/mission/prefab/boss/canman/containment)
"aE" = (/obj/structure/interactive/door/airlock/external/syndicate/locked,/obj/structure/interactive/wire/red,/obj/structure/interactive/atmospherics/fan,/turf/simulated/floor/plating/syndicate,/area/mission/prefab/boss/canman/containment)
"aF" = (/obj/structure/interactive/emitter/active{icon_state = "emitter"; dir = 1},/obj/structure/interactive/wire/red,/turf/simulated/floor/tile/morphing/red/dark,/area/mission/prefab/boss/canman/containment)
"aG" = (/obj/structure/interactive/lighting/fixture/tube/syndicate,/turf/simulated/floor/plating/reinforced/dark,/area/mission/prefab/boss/canman/containment)
"aH" = (/obj/marker/map_node,/turf/simulated/floor/plating/syndicate,/area/mission/prefab/boss/canman/containment)
"aI" = (/obj/structure/interactive/lighting/fixture/tube/syndicate,/turf/simulated/floor/plating/syndicate,/area/mission/prefab/boss/canman/containment)
"aJ" = (/obj/structure/sign/no_smoking,/turf/simulated/wall/metal/syndicate/reinforced,/area/mission/prefab/boss/canman/left_wing)
"aK" = (/turf/simulated/wall/metal/syndicate/reinforced,/area/mission/prefab/boss/canman/left_wing)
"aL" = (/obj/structure/interactive/barricade{icon_state = "metal"; dir = 1},/obj/structure/interactive/lighting/fixture/tube/syndicate{icon_state = "preview"; dir = 4},/turf/simulated/floor/tile/morphing/red/dark,/area/mission/prefab/boss/canman/containment)
"aM" = (/obj/structure/interactive/barricade{icon_state = "metal"; dir = 1},/obj/structure/interactive/lighting/fixture/tube/syndicate{icon_state = "preview"; dir = 8},/turf/simulated/floor/tile/morphing/red/dark,/area/mission/prefab/boss/canman/containment)
"aN" = (/turf/simulated/wall/metal/syndicate/reinforced,/area/mission/prefab/boss/canman/right_wing)
"aO" = (/obj/structure/interactive/barbed_wire{icon_state = "wire"; dir = 1},/obj/marker/map_node,/turf/simulated/floor/tile/morphing/red/dark,/area/mission/prefab/boss/canman/containment)
"aP" = (/obj/structure/sign/no_smoking,/turf/simulated/wall/metal/syndicate/reinforced,/area/mission/prefab/boss/canman/right_wing)
"aQ" = (/obj/structure/interactive/fire_closet{icon_state = "extinguisher"; dir = 4},/turf/simulated/wall/metal/syndicate/reinforced,/area/mission/prefab/boss/canman/left_wing)
"aR" = (/obj/structure/interactive/atmospherics/vent,/turf/simulated/floor/tile/morphing/red/dark,/area/mission/prefab/boss/canman/left_wing)
"aS" = (/obj/structure/interactive/chair{icon_state = "chair"; dir = 4},/turf/simulated/floor/tile/morphing/red/dark,/area/mission/prefab/boss/canman/left_wing)
"aT" = (/obj/marker/spawning/window/reinforced/grilled,/turf/simulated/floor/plating/syndicate,/area/mission/prefab/boss/canman/left_wing)
"aU" = (/obj/structure/interactive/wire/red,/obj/marker/map_node,/turf/simulated/floor/plating/syndicate,/area/mission/prefab/boss/canman/containment)
"aV" = (/obj/marker/spawning/window/reinforced/grilled,/turf/simulated/floor/plating/syndicate,/area/mission/prefab/boss/canman/right_wing)
"aW" = (/obj/structure/sign/secure,/turf/simulated/wall/metal/syndicate/reinforced,/area/dmm_suite/clear_area)
"aX" = (/obj/structure/interactive/chair{icon_state = "chair"; dir = 8},/turf/simulated/floor/tile/morphing/red/dark,/area/mission/prefab/boss/canman/right_wing)
"aY" = (/obj/structure/interactive/atmospherics/vent,/turf/simulated/floor/tile/morphing/red/dark,/area/mission/prefab/boss/canman/right_wing)
"aZ" = (/turf/dmm_suite/no_wall,/area/mission/prefab/boss/canman/cave)
"ba" = (/obj/structure/interactive/wire/red,/obj/marker/map_node,/turf/simulated/floor/tile/morphing/red/dark,/area/mission/prefab/boss/canman/containment)
"bb" = (/turf/simulated/floor/plating/syndicate,/area/mission/prefab/boss/canman/cave)
"bc" = (/obj/structure/interactive/wire/red,/obj/marker/map_node,/turf/simulated/floor/tile,/area/mission/prefab/boss/canman/containment)
"bd" = (/obj/marker/map_node,/turf/simulated/floor/tile,/area/mission/prefab/boss/canman/containment)
"be" = (/obj/structure/interactive/fire_closet{icon_state = "extinguisher"; dir = 8},/turf/simulated/wall/metal/syndicate/reinforced,/area/mission/prefab/boss/canman/right_wing)
"bf" = (/obj/marker/map_node,/turf/simulated/floor/tile/morphing/red/dark,/area/mission/prefab/boss/canman/containment)
"bg" = (/obj/structure/interactive/lighting/fixture/tube/syndicate{icon_state = "preview"; dir = 4},/turf/simulated/floor/tile/morphing/red/dark,/area/mission/prefab/boss/canman/left_wing)
"bh" = (/obj/structure/interactive/chair{icon_state = "chair"; dir = 4},/turf/simulated/floor/tile/dark/er,/area/mission/prefab/boss/canman/left_wing)
"bi" = (/obj/structure/interactive/chair{icon_state = "chair"; dir = 8},/turf/simulated/floor/tile/dark/er,/area/mission/prefab/boss/canman/right_wing)
"bj" = (/obj/structure/interactive/lighting/fixture/tube/syndicate{icon_state = "preview"; dir = 8},/turf/simulated/floor/tile/morphing/red/dark,/area/mission/prefab/boss/canman/right_wing)
"bk" = (/turf/simulated/floor/tile/morphing/red/dark,/area/mission/prefab/boss/canman/containment)
"bl" = (/obj/structure/interactive/fence,/turf/simulated/floor/plating/syndicate,/area/dmm_suite/clear_area)
"bm" = (/obj/structure/interactive/fence/corner{icon_state = "corner"; dir = 10},/turf/simulated/floor/plating/syndicate,/area/dmm_suite/clear_area)
"bn" = (/obj/structure/interactive/fence{icon_state = "straight"; dir = 8},/turf/simulated/floor/plating/syndicate,/area/dmm_suite/clear_area)
"bo" = (/obj/structure/interactive/fence/door,/turf/simulated/floor/plating/syndicate,/area/dmm_suite/clear_area)
"bp" = (/obj/structure/interactive/fence/end{icon_state = "end"; dir = 8},/turf/simulated/floor/plating/syndicate,/area/dmm_suite/clear_area)
"bq" = (/obj/structure/interactive/fence/post{icon_state = "post"; dir = 8},/turf/simulated/floor/plating/syndicate,/area/dmm_suite/clear_area)
"br" = (/obj/structure/interactive/fence/end{icon_state = "end"; dir = 1},/turf/simulated/floor/plating/syndicate,/area/dmm_suite/clear_area)
"bs" = (/obj/structure/interactive/wire/yellow,/turf/simulated/floor/plating/syndicate,/area/dmm_suite/clear_area)
"bt" = (/obj/structure/interactive/wire/red,/turf/simulated/floor/plating/syndicate,/area/mission/prefab/boss/canman/cave)
"bu" = (/obj/structure/interactive/wire/yellow,/obj/structure/interactive/solar_panel,/turf/simulated/floor/plating/syndicate,/area/dmm_suite/clear_area)
"bv" = (/turf/simulated/floor/tile/morphing/red/dark,/area/mission/prefab/boss/canman/left_wing)
"bw" = (/turf/dmm_suite/clear_turf,/area/dmm_suite/clear_area)
"bx" = (/obj/marker/generation/turf/desert_wall,/turf/simulated/wall/rock/desert,/area/dmm_suite/clear_area)
"by" = (/obj/structure/interactive/wire/yellow,/turf/simulated/floor/plating/syndicate,/area/mission/prefab/boss/canman/cave)
"bz" = (/obj/structure/interactive/power/smes/industrial{icon_state = "smes_map"; dir = 8},/obj/structure/interactive/wire/red,/turf/simulated/floor/plating/syndicate,/area/mission/prefab/boss/canman/cave)
"bA" = (/turf/simulated/wall/metal/syndicate/reinforced,/area/mission/prefab/boss/canman/cave)
"bB" = (/obj/structure/interactive/chair{icon_state = "chair"; dir = 4},/obj/structure/interactive/atmospherics/scrubber,/turf/simulated/floor/tile/morphing/red/dark,/area/mission/prefab/boss/canman/left_wing)
"bC" = (/obj/structure/interactive/wire/yellow,/turf/dmm_suite/no_wall,/area/mission/prefab/boss/canman/cave)
"bD" = (/obj/structure/interactive/wire/yellow,/obj/structure/interactive/construction/grille,/turf/dmm_suite/no_wall,/area/mission/prefab/boss/canman/cave)
"bE" = (/turf/simulated/floor/tile/dark/er,/area/mission/prefab/boss/canman/containment)
"bF" = (/turf/simulated/floor/plating/reinforced/dark,/area/mission/prefab/boss/canman/containment)
"bG" = (/turf/simulated/floor/plating/syndicate,/area/mission/prefab/boss/canman/containment)
"bH" = (/mob/living/simple/can_man,/turf/simulated/floor/plating/reinforced/dark,/area/mission/prefab/boss/canman/containment)
"bI" = (/obj/structure/interactive/lighting/fixture/tube/syndicate{icon_state = "preview"; dir = 1},/turf/simulated/floor/plating/syndicate,/area/mission/prefab/boss/canman/containment)
"bJ" = (/obj/structure/interactive/fire_closet,/turf/simulated/wall/metal/syndicate/reinforced,/area/mission/prefab/boss/canman/containment)
"bK" = (/obj/structure/sign/secure,/turf/simulated/wall/metal/syndicate/reinforced,/area/mission/prefab/boss/canman/containment)
"bL" = (/obj/structure/interactive/door/airlock/external/syndicate/locked,/obj/structure/interactive/atmospherics/fan,/turf/simulated/floor/plating/syndicate,/area/mission/prefab/boss/canman/containment)
"bM" = (/turf/simulated/floor/tile/morphing/red/dark,/area/mission/prefab/boss/canman/right_wing)
"bN" = (/obj/structure/interactive/door/airlock/syndicate,/turf/simulated/floor/tile/morphing/red/dark,/area/mission/prefab/boss/canman/left_wing)
"bO" = (/obj/structure/interactive/power/apc,/turf/simulated/wall/metal/syndicate/reinforced,/area/mission/prefab/boss/canman/left_wing)
"bP" = (/obj/structure/interactive/power/apc,/turf/simulated/wall/metal/syndicate/reinforced,/area/mission/prefab/boss/canman/right_wing)
"bQ" = (/obj/structure/interactive/door/airlock/syndicate,/turf/simulated/floor/tile/morphing/red/dark,/area/mission/prefab/boss/canman/right_wing)
"bR" = (/obj/structure/interactive/crate/trash,/obj/marker/spawning/random/trash,/turf/simulated/floor/tile/morphing/red/dark,/area/mission/prefab/boss/canman/containment)
"bS" = (/obj/structure/interactive/wire/red,/turf/simulated/floor/tile/morphing/red/dark,/area/mission/prefab/boss/canman/left_wing)
"bT" = (/obj/structure/interactive/wire/red,/turf/simulated/floor/tile/morphing/red/dark,/area/mission/prefab/boss/canman/right_wing)
"bU" = (/turf/simulated/floor/tile/dark/er,/area/mission/prefab/boss/canman/left_wing)
"bV" = (/obj/structure/interactive/atmospherics/scrubber,/turf/simulated/floor/tile/dark/er,/area/mission/prefab/boss/canman/left_wing)
"bW" = (/obj/structure/interactive/lighting/fixture/tube/syndicate{icon_state = "preview"; dir = 8},/obj/structure/interactive/wire/red,/turf/simulated/floor/tile/morphing/red/dark,/area/mission/prefab/boss/canman/left_wing)
"bX" = (/obj/structure/interactive/lighting/fixture/bulb/red{icon_state = "preview"; dir = 1},/obj/structure/interactive/wire/red,/obj/marker/map_node,/turf/simulated/floor/plating/syndicate,/area/mission/prefab/boss/canman/containment)
"bY" = (/turf/simulated/wall/metal/syndicate/reinforced,/area/mission/prefab/boss/canman/lobby)
"bZ" = (/obj/structure/interactive/lighting/fixture/bulb/red{icon_state = "preview"; dir = 1},/obj/marker/map_node,/turf/simulated/floor/plating/syndicate,/area/mission/prefab/boss/canman/containment)
"ca" = (/obj/structure/interactive/door/airlock/external/syndicate/locked,/obj/structure/interactive/atmospherics/fan,/turf/simulated/floor/plating/syndicate,/area/mission/prefab/boss/canman/lobby)
"cb" = (/obj/structure/interactive/power/apc{icon_state = "apc"; dir = 1},/turf/simulated/wall/metal/syndicate/reinforced,/area/mission/prefab/boss/canman/lobby)
"cc" = (/obj/structure/interactive/lighting/fixture/tube/syndicate{icon_state = "preview"; dir = 4},/obj/structure/interactive/wire/red,/turf/simulated/floor/tile/morphing/red/dark,/area/mission/prefab/boss/canman/right_wing)
"cd" = (/obj/structure/interactive/atmospherics/scrubber,/turf/simulated/floor/tile/dark/er,/area/mission/prefab/boss/canman/right_wing)
"ce" = (/turf/simulated/floor/tile/dark/er,/area/mission/prefab/boss/canman/right_wing)
"cf" = (/turf/simulated/floor/tile/morphing/red/dark,/area/mission/prefab/boss/canman/lobby)
"cg" = (/obj/structure/interactive/barricade,/obj/structure/interactive/lighting/fixture/tube/syndicate,/turf/simulated/floor/tile/morphing/red/dark,/area/mission/prefab/boss/canman/lobby)
"ch" = (/obj/structure/interactive/wire/red,/obj/marker/map_node,/turf/simulated/floor/tile/dark/er,/area/mission/prefab/boss/canman/containment)
"ci" = (/turf/simulated/floor/tile/dark/er,/area/mission/prefab/boss/canman/lobby)
"cj" = (/obj/structure/interactive/wire/red,/turf/simulated/floor/tile/dark/er,/area/mission/prefab/boss/canman/lobby)
"ck" = (/obj/structure/interactive/atmospherics/vent,/turf/simulated/floor/tile/dark/er,/area/mission/prefab/boss/canman/lobby)
"cl" = (/obj/structure/interactive/door/airlock/syndicate,/obj/structure/interactive/wire/red,/turf/simulated/floor/tile/morphing/red/dark,/area/mission/prefab/boss/canman/left_wing)
"cm" = (/obj/structure/interactive/door/airlock/syndicate,/obj/structure/interactive/wire/red,/turf/simulated/floor/tile/morphing/red/dark,/area/mission/prefab/boss/canman/right_wing)
"cn" = (/obj/structure/interactive/atmospherics/vent,/turf/simulated/floor/tile/dark/er,/area/mission/prefab/boss/canman/left_wing)
"co" = (/obj/structure/interactive/lighting/fixture/tube/syndicate{icon_state = "preview"; dir = 8},/turf/simulated/floor/tile/morphing/red/dark,/area/mission/prefab/boss/canman/left_wing)
"cp" = (/obj/structure/interactive/atmospherics/scrubber,/obj/structure/interactive/wire/red,/turf/simulated/floor/tile/dark/er,/area/mission/prefab/boss/canman/lobby)
"cq" = (/obj/structure/interactive/lighting/fixture/tube/syndicate{icon_state = "preview"; dir = 4},/turf/simulated/floor/tile/morphing/red/dark,/area/mission/prefab/boss/canman/right_wing)
"cr" = (/obj/structure/interactive/atmospherics/vent,/turf/simulated/floor/tile/dark/er,/area/mission/prefab/boss/canman/right_wing)
"cs" = (/obj/structure/interactive/lighting/fixture/tube/syndicate{icon_state = "preview"; dir = 1},/obj/structure/interactive/wire/red,/turf/simulated/floor/tile/morphing/red/dark,/area/mission/prefab/boss/canman/lobby)
"ct" = (/obj/structure/interactive/lighting/fixture/tube/syndicate{icon_state = "preview"; dir = 1},/turf/simulated/floor/tile/morphing/red/dark,/area/mission/prefab/boss/canman/lobby)
"cu" = (/obj/structure/interactive/crate/trash,/obj/marker/spawning/random/trash,/turf/simulated/floor/tile/morphing/red/dark,/area/mission/prefab/boss/canman/right_wing)
"cv" = (/obj/structure/interactive/crate/trash,/obj/marker/spawning/random/trash,/turf/simulated/floor/tile/morphing/red/dark,/area/mission/prefab/boss/canman/lobby)
"cw" = (/obj/structure/interactive/fire_closet{icon_state = "extinguisher"; dir = 1},/turf/simulated/wall/metal/syndicate/reinforced,/area/mission/prefab/boss/canman/lobby)
"cx" = (/obj/structure/sign/secure,/turf/simulated/wall/metal/syndicate/reinforced,/area/mission/prefab/boss/canman/lobby)
"cy" = (/obj/structure/interactive/wire/red,/obj/marker/map_node,/turf/simulated/floor/tile/dark/er,/area/mission/prefab/boss/canman/lobby)
"cz" = (/obj/structure/interactive/barbed_wire{icon_state = "wire"; dir = 1},/turf/simulated/floor/plating/syndicate,/area/mission/prefab/boss/canman/lobby)
"cA" = (/obj/marker/map_node,/turf/simulated/floor/tile/dark/er,/area/mission/prefab/boss/canman/containment)
"cB" = (/obj/marker/map_node,/turf/simulated/floor/tile/morphing/red/dark,/area/mission/prefab/boss/canman/left_wing)
"cC" = (/obj/marker/map_node,/turf/simulated/floor/tile/morphing/red/dark,/area/mission/prefab/boss/canman/right_wing)
"cD" = (/obj/structure/interactive/wire/red,/obj/marker/map_node,/turf/simulated/floor/tile/morphing/red/dark,/area/mission/prefab/boss/canman/lobby)
"cE" = (/obj/marker/map_node,/turf/simulated/floor/tile/morphing/red/dark,/area/mission/prefab/boss/canman/lobby)
"cF" = (/obj/structure/interactive/wire/red,/obj/marker/map_node,/turf/simulated/floor/tile/morphing/red/dark,/area/mission/prefab/boss/canman/left_wing)
"cG" = (/obj/structure/interactive/wire/red,/obj/marker/map_node,/turf/simulated/floor/tile/morphing/red/dark,/area/mission/prefab/boss/canman/right_wing)
"cH" = (/obj/structure/interactive/barricade,/obj/marker/map_node,/turf/simulated/floor/plating/syndicate,/area/mission/prefab/boss/canman/lobby)
"cI" = (/obj/marker/map_node,/turf/dmm_suite/no_wall,/area/dmm_suite/clear_area)
"cJ" = (/obj/marker/map_node,/turf/simulated/floor/tile/dark/er,/area/mission/prefab/boss/canman/right_wing)
"cK" = (/obj/marker/smart_clear_turf/large,/obj/marker/map_node,/turf/dmm_suite/no_wall,/area/dmm_suite/clear_area)
"cL" = (/obj/structure/interactive/lighting/fixture/tube/syndicate{icon_state = "preview"; dir = 4},/obj/structure/table/steel/dark,/turf/simulated/floor/tile/morphing/red/dark,/area/mission/prefab/boss/canman/left_wing)
"cM" = (/obj/structure/table/steel/dark,/turf/simulated/floor/tile/morphing/red/dark,/area/mission/prefab/boss/canman/left_wing)
"cN" = (/obj/structure/table/steel/dark,/turf/simulated/floor/tile/morphing/red/dark,/area/mission/prefab/boss/canman/right_wing)
"cO" = (/obj/structure/interactive/lighting/fixture/tube/syndicate{icon_state = "preview"; dir = 8},/obj/structure/table/steel/dark,/turf/simulated/floor/tile/morphing/red/dark,/area/mission/prefab/boss/canman/right_wing)
"cP" = (/obj/structure/table/steel/dark,/obj/marker/spawning/random/dangerous,/turf/simulated/floor/tile/morphing/red/dark,/area/mission/prefab/boss/canman/right_wing)
"cQ" = (/obj/structure/table/steel/dark,/obj/marker/spawning/random/dangerous,/turf/simulated/floor/tile/morphing/red/dark,/area/mission/prefab/boss/canman/left_wing)
"cR" = (/obj/marker/spawning/random/maintenance,/turf/simulated/floor/plating/syndicate,/area/mission/prefab/boss/canman/containment)
"cS" = (/obj/marker/spawning/random/maintenance,/turf/simulated/floor/plating/syndicate,/area/dmm_suite/clear_area)
"cT" = (/obj/marker/mission_corpse,/turf/dmm_suite/no_wall,/area/dmm_suite/clear_area)
"cU" = (/obj/marker/lobby,/turf/simulated/floor/tile/red/dark,/area/mission/prefab/boss/canman/containment)

(1,1,1) = {"
aaaaaaaaaaaaaaaaaaaaaaaaaaaaaaaaaaaaaaaaaaaaaaaaaaaaaaaaaaaaaaaa
aaaaagagagagagagagagagagagagagagagagagagagagagagagagagagagagaaaa
aaaaagbkbEbFbFbFbFbFbFbFbFaGbGbGbGbGaIbGbGbFbFbFbFbFbFbEbkagaaaa
aaaaagbkbEbFbFbFbGbGbGbFbFbFbFbFbFbFbFbFbFbFbFbFbGbGbGbEbkagaaaa
aaaaagbkbEbFbFbGbGbFbFbGbGbFbFbHbGbGbFbGbFbGbGbFbFbGbFbEbkagaaaa
aaaaagbkbEaDbFbFbFbFaDbFbGbFbFaDaDbGbFbGbGaHbFbFbFbGaDbEbkagaaaa
aaaaagbkbEbGbGbFbGbFbFbFbFbFbFbGbGbGbGbFbGbGbFbFbGbGbGbEbkagaaaa
aaaaagbkbEbFbGbGbFbGbGbFbFbGbFbFbFbFbFbFbGbFbFbGbGbGbFbEbkagaaaa
aaaaagbkbEbFbGbFbFbGbFbFbGbIbFaDaHbGbIbGbFbFbFbGbFbGbFbEbkagaaaa
aaaaagbkbEbFbFbFbFbGbFagbJagbKbLbLbKagagagbFbFbGbFbFbGbEbkagaaaa
aaaaagagagagagagagagagagbkaiakaOaOakaibkagagagagagagagagagagaaaa
aCaCaZaCagalagamamamanaobkbEapaqaqarbEbkaoagcRcRcRagaaadaaaaaaaa
aCaCaZaCagagagaUbIaUasbaauauaxbcbdaybEbEbfbLaHbIaHagadadaaaaaaaa
aCaCaZaZaCalazamagagagbkbEbEayaAaBaBbEbEbkagagagbGagalaaaaaaaaaa
aCaCaZbbbtbXaEaUagaaagaFatauaxaxaxaxauataFagaaagaHbLbZajajaaaaaa
aCaCaZbybzagagaJaKaKaKagaLaqaBaAcUayaqaMagaNaNaNaPagagcSajaaaaaa
aCaCaZbybzbAaCaQaRaSaSaebkbEayaxayaybEbkaeaXaXaYbeaaadcSajaaaaaa
aCbCbCbybzbAbAaKbgbhaSaebkbEbEchcAbEbEbkaeaXbibjaNadadcSajaaaaaa
aCbDaCaZaZaCaCaKcBaSbBaebkbkaraubEapbkbkaeaXaXcCaNababababaaaaaa
aCbDaCaCaCaCaKaKbNaJaKbOagafaqaubEaqafagbPaNaPbQaNaNababaaaaaaaa
aCbDaCaCbAbAaKahcBbvbvbSagbRavbabaawatagbTcPcNcCbMaNadadaaaaaaaa
aCbDaCaCbAaCaKcLbUbUbVbWagbJagasbLagagagcccdcececOaNaaadaaaaaaaa
aCbDbAbAbAbAaKcQbUbUbUbSaTcfcgcDcEcgcfaVbTcecececNaNadadadadaaaa
aCbDbAaCaCaCaKcMbUbUbUbSaKcfcicjcickcfaNbTcecececNaNaaaaaaadaabw
aCbDbAbAbAbAaKcMacbUbUcFclcDcjcycycjcDcmcGcececJbMaNadadadadaabw
aCbDaCaCbAaCaKcLcnbUbUcoaKcfcpcicicicfaNcqcececrbjaNaaadaaaaaabw
aCbDaCaCbAbAaKcMbvbvbvbvaTcfcscEcEctcfaVcNcNcPbMcuaNadadaaaabwbw
brbsbubububuaKaKaKaKaKaKaKcvcbcacacwcfaNaNaNaNaNaNaNaaaaaabxbwbw
blajbubububuajaWaaadaaaaadbYcxcHcHcxbYadaaaaadaaadaaaaaaaabwbwbw
blajajajajajajadadadaaaaaaczczczczczczaaaaaaadadadaaaaaabwbwbwbw
bmbnbqbnbqbobpaaaabxaabwbwabcTababababababaaaaaaaaaaaabwbwbwbwbw
abababababababbwbwbwbwbwbwababcIcKabcTababababaabxaabwbwbwbwbwbw
"}
