"a" = (/turf/dmm_suite/clear_turf,/area/dmm_suite/clear_area)
"b" = (/turf/simulated/wall/brick/temple,/area/mission/prefab/boss/gabber)
"c" = (/turf/simulated/floor/colored/sand/desert/gabber,/area/mission/prefab/boss/gabber)
"d" = (/obj/structure/interactive/lighting/mounted_torch{icon_state = "torch"; dir = 4},/turf/simulated/wall/brick/temple,/area/mission/prefab/boss/gabber)
"e" = (/turf/simulated/floor/temple,/area/mission/prefab/boss/gabber)
"f" = (/obj/structure/interactive/lighting/mounted_torch{icon_state = "torch"; dir = 8},/turf/simulated/wall/brick/temple,/area/mission/prefab/boss/gabber)
"g" = (/obj/structure/carpet/red,/turf/simulated/floor/temple,/area/mission/prefab/boss/gabber)
"h" = (/mob/living/simple/gabber,/turf/simulated/floor/temple,/area/mission/prefab/boss/gabber)
"i" = (/obj/marker/smart_clear_turf/large,/turf/simulated/floor/temple,/area/mission/prefab/boss/gabber)
"j" = (/obj/structure/interactive/lighting/mounted_torch,/turf/simulated/wall/brick/temple,/area/mission/prefab/boss/gabber)
"k" = (/turf/simulated/wall/rock/desert,/area/dmm_suite/clear_area)
"l" = (/turf/simulated/floor/temple/jewel,/area/mission/prefab/boss/gabber)
"m" = (/obj/marker/generation/turf/desert_wall,/turf/simulated/wall/rock/desert,/area/dmm_suite/clear_area)
"n" = (/obj/structure/interactive/lighting/mounted_torch{icon_state = "torch"; dir = 1},/turf/simulated/wall/brick/temple,/area/mission/prefab/boss/gabber)
"o" = (/obj/marker/lobby,/turf/simulated/floor/temple/jewel,/area/mission/prefab/boss/gabber)

(1,1,1) = {"
aaakkkkkkkkmkkkkkkkkmkkkkkkkkaaa
aakkmkkbbbbbbbbbjbbbbbbbbbkkmkka
akkkkkkbcccccccccccccccccbkkkkkk
kkbbbbbdclllllllllllllllcfbbbbbk
kkbccccbcleeeeeeeeeeeeelcbccccbk
kkbclecccleggglllllgggelcccelcbk
kmdclecbeleggglehelgggelebcelcfm
kkbclecbelegggleeelgggelebcelcbk
kkbccccbeleggglllllgggelebccccbk
kkbbbcbdeleeeeeeeeeeeeelefbcbbbk
kkkkbccbelllllleeellllllebccbkkk
akmkbcccceeccclccclccceeccccbkma
akkkbccbceecbblbnblbbceecbccbkka
aakkbbbdceecfclllllcdceecfbbbkaa
aaakkkkbccccbccclcccbccccbkkkkaa
aaaakkkbbbbbbbdclcfbbbbbbbkkaaaa
aaakkkkkbcccccbclcbcccccbkkaaaaa
aakkkmkkbclllcbclcbclllcbkmkaaaa
akkkkkkkdclelcfclcdclelcfkkkkkkk
akbbbbbbbclllcbblbbclllcbbbbbbbk
akbcccccbcccccbclcbcccccbcccccbk
kkdclllcbbbcbbdclcfbbcbbbclllcfk
kkbclelccccccccclccccccccclelcbk
kkbclelllllllllllllllllllllelcbk
kkbclgggggggeeeeleeeeggggggglcbk
kmbclggggggglllllllllggggggglcbm
kkbclggggggglccclccclggggggglcbk
kkbclggggggglcfblbdclggggggglcbk
kkdclllllllllcbclcbclllllllllcfk
kkbcccccccccccdeoefcccccccccccbk
akbbbbbbbbbbbbbelebbbbbbbbbbbbbk
akkkkkkmkkkkkkjilijkkkkkkkmkkkkk
"}
