"a" = (/turf/dmm_suite/clear_turf,/area/dmm_suite/clear_area)
"b" = (/turf/dmm_suite/no_wall,/area/dmm_suite/clear_area)
"c" = (/turf/simulated/wall/brick/grey,/area/dmm_suite/clear_area)
"d" = (/obj/structure/interactive/door/wood,/turf/simulated/floor/brick/grey,/area/dmm_suite/clear_area)
"e" = (/obj/structure/carpet/brown,/turf/simulated/floor/brick/grey,/area/dmm_suite/clear_area)
"f" = (/mob/living/advanced/npc/goblin/warrior,/turf/simulated/floor/brick/grey,/area/dmm_suite/clear_area)
"g" = (/obj/structure/carpet/brown,/obj/marker/map_node/x3,/turf/simulated/floor/brick/grey,/area/dmm_suite/clear_area)
"h" = (/mob/living/advanced/npc/goblin/mage{icon_state = "directional"; dir = 8},/turf/simulated/floor/brick/grey,/area/dmm_suite/clear_area)
"i" = (/mob/living/advanced/npc/goblin/mage{icon_state = "directional"; dir = 4},/turf/simulated/floor/brick/grey,/area/dmm_suite/clear_area)
"j" = (/mob/living/advanced/npc/goblin/mage,/turf/simulated/floor/brick/grey,/area/dmm_suite/clear_area)
"k" = (/mob/living/advanced/npc/goblin/warrior{icon_state = "directional"; dir = 8},/turf/simulated/floor/brick/grey,/area/dmm_suite/clear_area)
"l" = (/obj/structure/interactive/lighting/mounted_torch{icon_state = "torch"; dir = 4},/turf/simulated/wall/brick/grey,/area/dmm_suite/clear_area)
"m" = (/turf/simulated/floor/brick/grey,/area/dmm_suite/clear_area)
"n" = (/obj/structure/carpet/brown,/obj/marker/map_node/x4,/turf/simulated/floor/brick/grey,/area/dmm_suite/clear_area)
"o" = (/obj/marker/objective_spawn,/turf/simulated/floor/brick/grey,/area/dmm_suite/clear_area)
"p" = (/obj/structure/carpet/brown,/obj/marker/map_node/x2,/turf/simulated/floor/brick/grey,/area/dmm_suite/clear_area)
"q" = (/obj/marker/map_node,/turf/simulated/floor/brick/grey,/area/dmm_suite/clear_area)
"r" = (/obj/marker/map_node,/turf/dmm_suite/no_wall,/area/dmm_suite/clear_area)
"s" = (/obj/marker/map_node/x2,/turf/dmm_suite/no_wall,/area/dmm_suite/clear_area)
"t" = (/obj/marker/map_node/x2,/turf/simulated/floor/brick/grey,/area/dmm_suite/clear_area)
"u" = (/obj/marker/map_node/x4,/turf/simulated/floor/brick/grey,/area/dmm_suite/clear_area)

(1,1,1) = {"
aaaaaaaaabbbaaaaaaaaaaaaaaaaaaaa
aaaaaaaaabsbaaaaaaaaaaaaaaaaaaaa
aaaaaccccdddcccccaaaaaaaaaaaaaaa
aaaaacmfmmtmmmmmccccccccccccaaaa
aaaaacmmmeeeeemmcmmmfmmmmmmcaaaa
aaaaacmmmeeeeemmcmeeeeeeeemcaaaa
aaaaacmmmeeeeemqdqegeeeegemcaaaa
acccccmmmmmmmmmhcmeeeeeeeemcaaaa
acmmmmmmmummmmmmcmmmmmmmmmmcaaaa
acmmmmeeeeeemmcccccccccccdcccaaa
acimmmeeeeeemmcimmmmjmmmmmmmcaaa
acmmmmeeeeeemqdqmeeeeeeeemmkcaaa
acmmqqmmmmmqqmcmmeeepeeeemtmcaaa
acccddcccccddccccmmmmmmmmmmmcaaa
acfmqqmmcmmqqmmocccdddcccmmmcaaa
acmeeeemlmmmmmmmcimmmmmmcmmmcaaa
acmeegemcmmmtmmqdqeepeemcmmmcaaa
acmeeeemcmmmfmmqdqeegeemcmtmcaaa
acmmqqmmcmmmqqmmcmeeeeemceeecaaa
acccddccccccddcccmeeeeekceeecaaa
aacmqqmmmmcmqqmfcmeeeeemccccccaa
aacmeeeeeqdqeeeqdqeegeemcmmmmcaa
aacieeeeeqdqegeqdqeeeeeqdqepmcaa
aacmeeneemcmeeemcmmqqmmmcmeekcaa
aacmeeeeemcmqqmmcccddccccmeemcaa
aacmeeeeekccddcccmmqqmmcmmeemcaa
aacmmmmmmmcbrrbcmeeeeemcmmeemcaa
aacccccccccbbbbcmeeegekcmmpemcaa
aaaaaaaaaaabbbbcmeeeeemcmmmmmcaa
aaaaaaaaabbbbbbcmmmmmmmcccccccaa
aaaaaaabbbbbbbbcccccccccaaaaaaaa
aaaaaaabbbbbbbbbbbbbbbbbaaaaaaaa
"}
