//MAP CONVERTED BY dmm2tgm.py THIS HEADER COMMENT PREVENTS RECONVERSION, DO NOT REMOVE
"a" = (
/turf/dmm_suite/clear_turf,
/area/dmm_suite/clear_area)
"b" = (
/turf/simulated/wall/brick/grey,
/area/dmm_suite/clear_area)
"c" = (
/obj/structure/carpet/red,
/turf/simulated/floor/brick/grey,
/area/dmm_suite/clear_area)
"d" = (
/obj/structure/interactive/door/wood,
/turf/simulated/floor/brick/grey,
/area/dmm_suite/clear_area)
"e" = (
/turf/simulated/floor/brick/grey,
/area/dmm_suite/clear_area)
"f" = (
/turf/dmm_suite/no_wall,
/area/dmm_suite/clear_area)
"g" = (
/obj/structure/interactive/crate/chest/filled,
/turf/simulated/floor/brick/grey,
/area/dmm_suite/clear_area)
"h" = (
/obj/structure/interactive/crate/chest/filled,
/turf/dmm_suite/no_wall,
/area/dmm_suite/clear_area)
"i" = (
/obj/structure/interactive/lighting/mounted_torch{
	dir = 4;
	icon_state = "torch"
	},
/turf/simulated/wall/brick/grey,
/area/dmm_suite/clear_area)
"j" = (
/obj/structure/carpet/red,
/mob/living/advanced/npc/goblin/warrior{
	dir = 1;
	icon_state = "directional"
	},
/turf/simulated/floor/brick/grey,
/area/dmm_suite/clear_area)
"k" = (
/obj/structure/interactive/lighting/mounted_torch{
	dir = 8;
	icon_state = "torch"
	},
/turf/simulated/wall/brick/grey,
/area/dmm_suite/clear_area)
"l" = (
/obj/structure/interactive/lighting/mounted_torch,
/turf/simulated/wall/brick/grey,
/area/dmm_suite/clear_area)
"m" = (
/obj/structure/carpet/red,
/mob/living/advanced/npc/goblin/mage{
	dir = 1;
	icon_state = "directional"
	},
/turf/simulated/floor/brick/grey,
/area/dmm_suite/clear_area)
"n" = (
/obj/structure/interactive/lighting/mounted_torch{
	dir = 1;
	icon_state = "torch"
	},
/turf/simulated/wall/brick/grey,
/area/dmm_suite/clear_area)
"o" = (
/obj/structure/carpet/red,
/mob/living/advanced/npc/goblin/mage,
/turf/simulated/floor/brick/grey,
/area/dmm_suite/clear_area)
"p" = (
/obj/structure/carpet/red,
/mob/living/advanced/npc/goblin/warrior,
/turf/simulated/floor/brick/grey,
/area/dmm_suite/clear_area)
"q" = (
/obj/structure/carpet/red,
/mob/living/advanced/npc/goblin/mage{
	dir = 8;
	icon_state = "directional"
	},
/turf/simulated/floor/brick/grey,
/area/dmm_suite/clear_area)
"r" = (
/mob/living/advanced/npc/goblin/warrior{
	dir = 8;
	icon_state = "directional"
	},
/turf/simulated/floor/brick/grey,
/area/dmm_suite/clear_area)
"s" = (
/obj/structure/carpet/red,
/mob/living/advanced/npc/goblin/warrior{
	dir = 8;
	icon_state = "directional"
	},
/turf/simulated/floor/brick/grey,
/area/dmm_suite/clear_area)
"t" = (
/obj/marker/map_node,
/turf/dmm_suite/no_wall,
/area/dmm_suite/clear_area)
"u" = (
/obj/marker/map_node,
/turf/simulated/floor/brick/grey,
/area/dmm_suite/clear_area)
"v" = (
/obj/marker/lobby,
/turf/simulated/floor/brick/grey,
/area/dmm_suite/clear_area)
"w" = (
/obj/marker/objective_spawn,
/turf/simulated/floor/brick/grey,
/area/dmm_suite/clear_area)
"x" = (
/obj/marker/map_node/x2,
/turf/dmm_suite/no_wall,
/area/dmm_suite/clear_area)
"y" = (
/obj/structure/carpet/red,
/obj/marker/map_node/x2,
/turf/simulated/floor/brick/grey,
/area/dmm_suite/clear_area)
"z" = (
/obj/marker/map_node/x2,
/turf/simulated/floor/brick/grey,
/area/dmm_suite/clear_area)
"A" = (
/obj/structure/carpet/red,
/obj/marker/map_node/x3,
/turf/simulated/floor/brick/grey,
/area/dmm_suite/clear_area)
"B" = (
/obj/structure/carpet/red,
/obj/marker/map_node/x3,
/mob/living/advanced/npc/goblin/warrior{
	dir = 1;
	icon_state = "directional"
	},
/turf/simulated/floor/brick/grey,
/area/dmm_suite/clear_area)

(1,1,1) = {"
a
a
a
a
a
a
a
a
a
a
a
a
a
a
a
a
a
a
a
a
a
a
a
a
a
a
f
f
f
f
a
a
"}
(2,1,1) = {"
a
a
a
a
a
a
a
a
a
a
a
a
a
a
a
a
a
a
a
a
a
a
a
a
a
a
f
f
x
f
a
a
"}
(3,1,1) = {"
a
a
a
a
a
a
a
a
a
a
a
a
a
a
a
a
a
a
a
a
a
a
a
a
a
a
f
f
f
f
a
a
"}
(4,1,1) = {"
a
a
a
a
a
a
a
a
a
a
a
a
a
a
a
a
a
b
b
b
i
b
b
b
b
f
f
f
f
f
f
a
"}
(5,1,1) = {"
a
a
a
a
a
a
a
a
a
a
a
a
a
a
a
a
a
b
e
e
e
e
e
e
b
f
f
f
f
f
f
f
"}
(6,1,1) = {"
a
a
a
a
a
a
a
a
a
a
a
a
a
a
a
a
a
b
e
c
c
c
c
e
b
f
f
f
f
f
f
f
"}
(7,1,1) = {"
a
a
a
a
a
a
a
a
a
a
a
a
a
a
a
a
a
b
e
c
c
p
c
u
d
t
f
x
f
f
x
f
"}
(8,1,1) = {"
a
a
a
a
a
a
a
a
a
a
a
a
a
a
a
a
a
b
g
c
o
A
c
u
d
t
f
f
f
f
f
f
"}
(9,1,1) = {"
a
a
a
a
a
a
a
a
a
a
a
a
a
a
a
a
a
l
e
c
c
c
c
e
b
f
f
f
f
f
f
f
"}
(10,1,1) = {"
a
a
a
a
a
b
b
i
b
b
b
b
i
b
b
b
b
b
e
c
c
p
c
e
b
f
f
f
f
f
f
a
"}
(11,1,1) = {"
a
a
a
a
a
b
e
e
e
e
e
e
e
e
e
e
e
e
e
c
c
c
c
e
b
i
b
b
b
b
b
a
"}
(12,1,1) = {"
f
f
f
f
f
b
e
c
c
c
c
c
c
e
e
z
e
e
e
c
c
c
c
e
e
e
e
e
e
e
b
a
"}
(13,1,1) = {"
f
f
f
f
f
b
e
c
c
c
c
m
c
e
e
e
e
e
e
y
c
c
y
e
e
e
e
e
e
e
b
a
"}
(14,1,1) = {"
f
f
f
f
t
d
u
c
j
c
A
c
c
e
e
e
e
e
e
e
e
v
e
e
c
s
c
A
c
e
n
a
"}
(15,1,1) = {"
f
x
f
f
t
d
u
c
c
c
c
c
c
e
b
b
b
k
b
b
b
g
e
e
c
c
c
c
c
e
b
a
"}
(16,1,1) = {"
f
f
f
f
f
b
e
c
c
c
j
c
c
e
b
f
f
f
f
f
b
e
e
z
c
c
c
c
c
e
b
a
"}
(17,1,1) = {"
f
f
f
f
f
b
g
c
c
c
c
c
c
e
b
h
f
f
f
f
b
e
e
e
c
c
c
c
c
e
b
a
"}
(18,1,1) = {"
f
f
f
f
f
b
e
e
e
e
e
e
e
e
b
f
f
f
f
f
l
e
e
r
c
c
c
c
c
e
b
a
"}
(19,1,1) = {"
a
a
a
a
a
b
b
b
b
b
k
b
b
b
b
f
f
f
f
f
b
e
e
e
c
c
c
c
c
e
b
a
"}
(20,1,1) = {"
a
a
a
a
a
a
a
a
a
a
a
a
a
a
a
f
f
f
f
f
b
e
e
e
q
c
c
c
c
e
b
a
"}
(21,1,1) = {"
a
a
a
a
a
a
a
a
a
a
a
a
a
a
a
b
b
b
i
b
b
e
e
e
c
c
c
A
c
e
b
a
"}
(22,1,1) = {"
a
a
a
a
a
a
a
a
a
a
a
a
a
a
a
b
e
e
e
w
e
e
e
e
e
e
e
e
e
e
n
a
"}
(23,1,1) = {"
a
a
a
a
a
a
a
a
a
a
a
a
a
a
a
b
e
e
e
e
e
e
e
e
e
e
e
e
e
e
b
a
"}
(24,1,1) = {"
a
a
a
a
a
a
a
f
f
f
f
f
f
f
f
b
g
e
c
c
c
c
c
j
c
e
e
b
b
b
b
a
"}
(25,1,1) = {"
a
a
a
a
f
f
f
f
f
f
f
x
f
f
t
d
u
e
c
c
c
c
c
c
c
e
e
n
a
a
a
a
"}
(26,1,1) = {"
a
a
f
f
f
x
f
f
f
f
f
f
f
f
t
d
u
e
c
B
c
c
c
c
c
e
e
b
a
a
a
a
"}
(27,1,1) = {"
a
a
f
f
f
f
f
f
f
f
f
f
f
f
f
l
e
e
c
c
c
c
c
c
A
e
e
b
a
a
a
a
"}
(28,1,1) = {"
a
f
f
f
f
f
f
a
a
a
a
a
a
a
a
b
e
e
c
c
c
c
m
c
c
e
e
b
a
a
a
a
"}
(29,1,1) = {"
a
f
f
f
f
f
f
a
a
a
a
a
a
a
a
b
e
e
e
e
e
e
e
e
e
e
e
b
a
a
a
a
"}
(30,1,1) = {"
f
f
x
f
f
f
a
a
a
a
a
a
a
a
a
b
b
k
b
b
b
b
b
b
b
k
b
b
a
a
a
a
"}
(31,1,1) = {"
f
f
f
f
f
f
a
a
a
a
a
a
a
a
a
a
a
a
a
a
a
a
a
a
a
a
a
a
a
a
a
a
"}
(32,1,1) = {"
f
f
f
f
a
a
a
a
a
a
a
a
a
a
a
a
a
a
a
a
a
a
a
a
a
a
a
a
a
a
a
a
"}
