//MAP CONVERTED BY dmm2tgm.py THIS HEADER COMMENT PREVENTS RECONVERSION, DO NOT REMOVE
"a" = (
/turf/dmm_suite/clear_turf,
/area)
"b" = (
/turf/simulated/wall/brick/grey,
/area)
"c" = (
/turf/simulated/floor/brick/grey,
/area)
"d" = (
/obj/structure/interactive/door/wood,
/turf/simulated/floor/brick/grey,
/area)
"e" = (
/obj/structure/smooth/table/wood/poor,
/turf/simulated/floor/brick/grey,
/area)
"f" = (
/turf/simulated/floor/carpet,
/area)
"g" = (
/obj/structure/interactive/lighting/mounted_torch{
	icon_state = "torch";
	dir = 8
	},
/turf/simulated/wall/brick/grey,
/area)
"h" = (
/obj/structure/interactive/lighting/mounted_torch{
	icon_state = "torch";
	dir = 4
	},
/turf/simulated/wall/brick/grey,
/area)
"i" = (
/obj/structure/interactive/lighting/mounted_torch,
/turf/simulated/wall/brick/grey,
/area)
"j" = (
/turf/dmm_suite/no_wall,
/area)
"k" = (
/obj/structure/interactive/crate/chest/filled,
/turf/simulated/floor/carpet,
/area)
"l" = (
/obj/structure/interactive/crate/chest/filled,
/turf/simulated/floor/brick/grey,
/area)
"m" = (
/mob/living/advanced/npc/goblin/mage{
	icon_state = "directional";
	dir = 8
	},
/turf/simulated/floor/carpet,
/area)
"n" = (
/mob/living/advanced/npc/goblin/warrior{
	icon_state = "directional";
	dir = 1
	},
/turf/simulated/floor/carpet,
/area)
"o" = (
/mob/living/advanced/npc/goblin/mage,
/turf/simulated/floor/brick/grey,
/area)
"p" = (
/mob/living/advanced/npc/goblin/warrior{
	icon_state = "directional";
	dir = 8
	},
/turf/simulated/floor/carpet,
/area)
"q" = (
/mob/living/advanced/npc/goblin/warrior,
/turf/simulated/floor/carpet,
/area)
"r" = (
/mob/living/advanced/npc/goblin/warrior{
	icon_state = "directional";
	dir = 8
	},
/turf/simulated/floor/brick/grey,
/area)
"s" = (
/mob/living/advanced/npc/goblin/mage{
	icon_state = "directional";
	dir = 8
	},
/turf/simulated/floor/brick/grey,
/area)

(1,1,1) = {"
a
a
a
a
a
a
a
a
a
a
a
a
a
a
j
j
j
j
a
a
a
a
a
a
a
a
a
a
a
a
a
a
"}
(2,1,1) = {"
a
a
a
a
a
a
a
a
a
a
a
a
a
a
j
j
j
j
a
a
a
a
a
a
a
a
a
a
a
a
a
a
"}
(3,1,1) = {"
a
a
a
a
a
a
a
a
a
a
a
a
a
a
j
j
j
j
a
a
a
a
a
a
a
a
a
a
a
a
a
a
"}
(4,1,1) = {"
a
a
a
a
a
a
a
a
a
a
a
a
a
a
j
j
j
j
a
a
a
a
a
a
a
a
a
a
a
a
a
a
"}
(5,1,1) = {"
a
a
a
a
a
a
a
a
a
a
a
a
a
j
j
j
j
j
j
a
a
a
a
a
a
a
a
a
a
a
a
a
"}
(6,1,1) = {"
a
a
a
a
a
a
a
a
a
a
a
a
a
b
b
d
d
h
b
a
a
a
a
a
a
a
a
a
a
a
a
a
"}
(7,1,1) = {"
a
a
a
a
a
a
a
a
a
a
a
a
a
b
e
c
c
c
b
a
a
a
a
a
a
a
a
a
a
a
a
a
"}
(8,1,1) = {"
a
a
a
a
a
a
a
a
a
a
a
a
a
b
e
c
c
c
b
b
b
h
b
b
b
b
a
a
a
a
a
a
"}
(9,1,1) = {"
a
a
a
a
a
a
a
a
a
a
a
a
a
b
l
p
f
c
b
e
e
e
e
e
e
b
j
j
a
a
a
a
"}
(10,1,1) = {"
a
a
a
a
a
a
b
b
b
h
b
b
b
i
c
f
f
r
b
c
c
c
c
c
c
b
j
j
j
a
a
a
"}
(11,1,1) = {"
a
a
a
a
a
a
b
e
e
e
e
c
c
c
c
f
f
c
d
c
o
f
f
f
c
b
j
j
j
j
j
j
"}
(12,1,1) = {"
a
a
a
a
a
j
b
c
c
c
c
c
o
c
c
f
f
c
d
c
c
f
f
q
c
d
j
j
j
j
j
j
"}
(13,1,1) = {"
a
a
a
a
j
j
d
c
f
n
f
f
c
c
c
c
c
c
i
l
c
f
f
f
c
d
j
j
j
j
j
j
"}
(14,1,1) = {"
j
a
a
j
j
j
d
c
f
f
f
n
c
b
h
d
d
g
b
e
c
f
q
f
c
b
j
j
j
j
j
j
"}
(15,1,1) = {"
j
j
j
j
j
j
b
c
c
c
c
c
c
b
c
c
c
e
b
e
c
f
f
f
c
b
j
j
j
a
a
a
"}
(16,1,1) = {"
j
j
j
j
j
j
b
c
e
e
e
e
e
b
l
c
c
e
b
e
c
c
c
c
c
b
j
j
a
a
a
a
"}
(17,1,1) = {"
j
a
a
a
j
j
b
b
b
g
h
b
b
i
c
f
f
c
b
b
h
d
b
g
b
b
a
a
a
a
a
a
"}
(18,1,1) = {"
a
a
a
a
a
j
b
e
c
c
c
c
c
b
c
q
f
c
b
l
c
c
c
b
a
a
a
a
a
a
a
a
"}
(19,1,1) = {"
a
a
a
a
a
a
b
e
c
f
f
f
c
d
c
f
f
c
b
c
f
f
c
b
a
a
a
a
a
a
a
a
"}
(20,1,1) = {"
a
a
a
a
a
a
b
c
c
f
m
f
c
d
c
c
c
s
d
c
f
p
e
b
a
a
a
a
a
a
a
a
"}
(21,1,1) = {"
a
a
a
a
a
a
i
c
c
c
c
c
c
b
e
e
e
c
b
c
c
e
e
b
a
a
a
a
a
a
a
a
"}
(22,1,1) = {"
a
a
b
b
b
b
b
c
c
c
b
b
b
b
b
b
b
b
b
b
g
b
b
b
a
a
a
a
a
a
a
a
"}
(23,1,1) = {"
a
a
b
e
e
c
c
c
c
c
b
a
a
a
a
a
a
a
a
a
a
a
a
a
a
a
a
a
a
a
a
a
"}
(24,1,1) = {"
a
a
b
k
f
c
f
f
f
c
b
a
a
a
a
a
a
a
a
a
a
a
a
a
a
a
a
a
a
a
a
a
"}
(25,1,1) = {"
a
a
b
f
f
c
f
m
f
c
b
a
a
a
a
a
a
a
a
a
a
a
a
a
a
a
a
a
a
a
a
a
"}
(26,1,1) = {"
a
a
b
e
e
c
c
c
c
c
b
a
a
a
a
a
a
a
a
a
a
a
a
a
a
a
a
a
a
a
a
a
"}
(27,1,1) = {"
a
a
b
b
b
b
b
g
b
b
b
a
a
a
a
a
a
a
a
a
a
a
a
a
a
a
a
a
a
a
a
a
"}
(28,1,1) = {"
a
a
a
a
a
a
a
a
a
a
a
a
a
a
a
a
a
a
a
a
a
a
a
a
a
a
a
a
a
a
a
a
"}
(29,1,1) = {"
a
a
a
a
a
a
a
a
a
a
a
a
a
a
a
a
a
a
a
a
a
a
a
a
a
a
a
a
a
a
a
a
"}
(30,1,1) = {"
a
a
a
a
a
a
a
a
a
a
a
a
a
a
a
a
a
a
a
a
a
a
a
a
a
a
a
a
a
a
a
a
"}
(31,1,1) = {"
a
a
a
a
a
a
a
a
a
a
a
a
a
a
a
a
a
a
a
a
a
a
a
a
a
a
a
a
a
a
a
a
"}
(32,1,1) = {"
a
a
a
a
a
a
a
a
a
a
a
a
a
a
a
a
a
a
a
a
a
a
a
a
a
a
a
a
a
a
a
a
"}
