//MAP CONVERTED BY dmm2tgm.py THIS HEADER COMMENT PREVENTS RECONVERSION, DO NOT REMOVE
"a" = (
/turf/dmm_suite/clear_turf,
/area/dmm_suite/clear_area)
"b" = (
/turf/simulated/wall/brick/grey,
/area/dmm_suite/clear_area)
"c" = (
/obj/structure/interactive/lighting/mounted_torch,
/turf/simulated/wall/brick/grey,
/area/dmm_suite/clear_area)
"d" = (
/turf/simulated/floor/brick/grey,
/area/dmm_suite/clear_area)
"e" = (
/obj/structure/interactive/crate/chest/filled,
/turf/simulated/floor/brick/grey,
/area/dmm_suite/clear_area)
"f" = (
/mob/living/advanced/npc/goblin/warrior{
	icon_state = "directional";
	dir = 8
	},
/turf/simulated/floor/brick/grey,
/area/dmm_suite/clear_area)
"g" = (
/obj/structure/interactive/door/wood,
/turf/simulated/floor/brick/grey,
/area/dmm_suite/clear_area)
"h" = (
/turf/dmm_suite/no_wall,
/area/dmm_suite/clear_area)
"i" = (
/mob/living/advanced/npc/goblin/mage,
/turf/simulated/floor/brick/grey,
/area/dmm_suite/clear_area)
"j" = (
/mob/living/advanced/npc/goblin/mage{
	icon_state = "directional";
	dir = 4
	},
/turf/simulated/floor/brick/grey,
/area/dmm_suite/clear_area)
"k" = (
/obj/structure/interactive/lighting/mounted_torch{
	icon_state = "torch";
	dir = 8
	},
/turf/simulated/wall/brick/grey,
/area/dmm_suite/clear_area)
"l" = (
/obj/structure/interactive/lighting/mounted_torch{
	icon_state = "torch";
	dir = 4
	},
/turf/simulated/wall/brick/grey,
/area/dmm_suite/clear_area)
"m" = (
/mob/living/advanced/npc/goblin/warrior,
/turf/simulated/floor/brick/grey,
/area/dmm_suite/clear_area)
"n" = (
/mob/living/advanced/npc/goblin/mage{
	icon_state = "directional";
	dir = 4
	},
/turf/dmm_suite/no_wall,
/area/dmm_suite/clear_area)
"o" = (
/turf/simulated/wall/wood/brown,
/area/dmm_suite/clear_area)
"p" = (
/obj/structure/interactive/crate/chest/filled,
/turf/simulated/floor/wood/brown,
/area/dmm_suite/clear_area)
"q" = (
/turf/simulated/floor/wood/brown,
/area/dmm_suite/clear_area)
"r" = (
/obj/structure/interactive/lighting/mounted_torch{
	icon_state = "torch";
	dir = 4
	},
/turf/simulated/wall/wood/brown,
/area/dmm_suite/clear_area)
"s" = (
/obj/structure/interactive/lighting/mounted_torch{
	icon_state = "torch";
	dir = 8
	},
/turf/simulated/wall/wood/brown,
/area/dmm_suite/clear_area)
"t" = (
/mob/living/advanced/npc/goblin/warrior{
	icon_state = "directional";
	dir = 1
	},
/turf/simulated/floor/brick/grey,
/area/dmm_suite/clear_area)
"u" = (
/obj/structure/interactive/door/wood,
/turf/simulated/floor/wood/brown,
/area/dmm_suite/clear_area)
"v" = (
/mob/living/advanced/npc/goblin/warrior{
	icon_state = "directional";
	dir = 1
	},
/turf/simulated/floor/wood/brown,
/area/dmm_suite/clear_area)
"w" = (
/mob/living/advanced/npc/goblin/warrior,
/turf/dmm_suite/no_wall,
/area/dmm_suite/clear_area)
"x" = (
/mob/living/advanced/npc/goblin/mage,
/turf/dmm_suite/no_wall,
/area/dmm_suite/clear_area)
"y" = (
/obj/structure/interactive/door/metal,
/turf/dmm_suite/no_wall,
/area/dmm_suite/clear_area)
"z" = (
/obj/marker/objective_spawn,
/turf/simulated/floor/wood/brown,
/area/dmm_suite/clear_area)

(1,1,1) = {"
a
a
a
a
a
a
a
a
a
a
a
a
a
a
a
a
a
a
a
a
a
a
a
a
a
a
a
a
a
a
a
a
"}
(2,1,1) = {"
a
b
b
b
b
b
b
b
b
l
b
b
b
b
b
b
b
b
b
b
b
b
l
b
b
b
b
b
l
b
b
a
"}
(3,1,1) = {"
a
b
d
d
d
d
d
d
d
d
d
d
d
d
d
m
d
d
d
d
d
d
d
d
d
d
d
d
d
d
b
a
"}
(4,1,1) = {"
a
b
d
d
d
j
d
b
b
g
b
b
b
b
b
b
b
b
b
b
b
b
b
b
b
d
d
d
d
d
b
a
"}
(5,1,1) = {"
a
b
d
d
d
d
d
b
h
h
h
n
h
h
h
h
h
h
h
h
h
h
h
h
b
d
d
d
j
d
b
a
"}
(6,1,1) = {"
a
b
e
d
d
d
d
b
h
h
h
h
h
h
h
h
h
h
h
h
h
h
h
h
g
d
d
d
d
d
b
a
"}
(7,1,1) = {"
a
b
d
d
d
d
d
b
h
h
h
h
h
b
b
l
b
b
l
b
b
h
h
h
b
e
d
d
d
d
b
a
"}
(8,1,1) = {"
a
b
d
b
b
k
b
b
h
h
h
h
h
b
e
d
d
d
d
d
b
h
h
h
b
b
k
b
b
d
b
a
"}
(9,1,1) = {"
a
b
d
b
h
h
h
h
h
h
h
h
h
b
d
d
d
d
d
t
b
h
h
h
h
h
h
h
b
d
b
a
"}
(10,1,1) = {"
a
c
d
g
h
h
h
h
h
h
h
h
h
b
d
d
d
d
d
d
g
h
h
h
h
h
h
h
g
d
b
a
"}
(11,1,1) = {"
a
b
d
b
h
h
h
h
h
h
h
h
h
b
d
d
d
d
d
d
b
h
h
h
h
h
h
h
b
d
b
h
"}
(12,1,1) = {"
a
b
d
b
h
h
h
h
h
h
h
h
h
b
b
k
b
b
k
b
b
h
h
h
h
h
w
h
b
b
b
h
"}
(13,1,1) = {"
a
b
d
b
h
h
h
h
h
h
h
h
h
h
h
h
h
h
h
h
h
h
h
h
h
h
h
h
h
b
h
h
"}
(14,1,1) = {"
a
b
d
b
h
h
h
h
h
h
h
h
h
h
h
h
h
h
h
h
h
h
h
h
h
h
h
h
h
b
h
h
"}
(15,1,1) = {"
a
b
d
b
h
h
h
h
h
h
h
h
h
h
h
h
h
h
h
h
h
h
h
h
w
h
h
h
h
y
h
h
"}
(16,1,1) = {"
a
b
f
b
h
h
b
b
l
b
g
l
b
h
h
h
h
h
h
h
h
h
h
h
h
h
x
h
h
y
h
h
"}
(17,1,1) = {"
a
b
d
b
h
h
b
d
d
d
d
d
b
h
h
h
h
h
h
h
h
h
h
h
h
h
h
h
h
y
h
h
"}
(18,1,1) = {"
a
b
d
b
h
h
b
m
d
d
d
d
b
h
o
o
r
o
o
o
u
o
o
h
h
h
w
h
h
y
h
h
"}
(19,1,1) = {"
a
b
d
b
h
h
b
d
d
d
d
d
b
h
o
p
q
q
q
q
q
q
o
h
h
h
h
h
h
b
h
h
"}
(20,1,1) = {"
a
b
d
b
h
h
b
e
d
d
f
d
b
h
o
z
q
q
q
q
q
q
o
h
h
h
h
h
h
b
h
h
"}
(21,1,1) = {"
a
b
d
b
h
h
b
b
k
b
b
b
b
h
o
q
q
q
q
q
q
v
o
h
h
h
h
h
b
b
b
h
"}
(22,1,1) = {"
a
b
d
b
h
h
h
h
h
h
h
h
h
h
o
q
q
q
q
q
q
q
o
h
h
h
h
h
b
d
b
a
"}
(23,1,1) = {"
a
c
d
g
h
h
h
h
h
h
h
h
h
h
o
q
q
q
q
q
q
q
o
h
h
h
h
h
g
d
b
a
"}
(24,1,1) = {"
a
b
d
b
h
h
h
h
h
h
h
h
h
h
o
o
s
o
o
o
s
o
o
h
h
h
h
h
b
d
b
a
"}
(25,1,1) = {"
a
b
d
b
b
l
b
b
h
h
h
h
h
h
h
h
h
h
h
h
h
h
h
h
b
b
l
b
b
d
b
a
"}
(26,1,1) = {"
a
b
d
d
d
d
d
b
h
h
h
h
h
h
h
h
h
h
h
h
h
h
h
h
b
e
d
d
d
d
b
a
"}
(27,1,1) = {"
a
b
d
d
d
d
d
b
h
h
h
h
h
h
h
h
h
h
h
h
h
h
h
h
g
d
d
d
d
d
b
a
"}
(28,1,1) = {"
a
b
d
d
i
d
d
b
h
h
h
h
h
h
h
h
h
h
h
h
h
h
h
h
b
d
i
d
d
d
b
a
"}
(29,1,1) = {"
a
b
d
d
d
d
d
b
b
g
b
b
b
b
b
b
b
b
b
b
b
b
b
b
b
d
d
d
d
d
b
a
"}
(30,1,1) = {"
a
b
e
d
d
d
d
d
d
d
d
d
d
d
d
d
m
d
d
d
d
d
d
d
d
d
d
d
d
d
b
a
"}
(31,1,1) = {"
a
b
b
b
b
b
b
b
b
k
b
b
b
b
b
b
b
b
b
b
b
b
k
b
b
b
b
b
k
b
b
a
"}
(32,1,1) = {"
a
a
a
a
a
a
a
a
a
a
a
a
a
a
a
a
a
a
a
a
a
a
a
a
a
a
a
a
a
a
a
a
"}
