//MAP CONVERTED BY dmm2tgm.py THIS HEADER COMMENT PREVENTS RECONVERSION, DO NOT REMOVE
"a" = (
/turf/dmm_suite/clear_turf,
/area/dmm_suite/clear_area)
"b" = (
/turf/simulated/floor/hierophant,
/area/dmm_suite/clear_area)
"c" = (
/turf/simulated/wall/hierophant,
/area/dmm_suite/clear_area)
"d" = (
/obj/marker/map_node/x2,
/turf/simulated/floor/hierophant,
/area/dmm_suite/clear_area)
"e" = (
/obj/marker/map_node/x3,
/turf/simulated/floor/hierophant,
/area/dmm_suite/clear_area)
"f" = (
/mob/living/simple/hierophant,
/turf/simulated/floor/hierophant,
/area/dmm_suite/clear_area)
"g" = (
/obj/marker/map_node,
/turf/simulated/floor/hierophant,
/area/dmm_suite/clear_area)
"h" = (
/turf/dmm_suite/no_wall,
/area/dmm_suite/clear_area)
"i" = (
/obj/marker/map_node,
/turf/dmm_suite/no_wall,
/area/dmm_suite/clear_area)

(1,1,1) = {"
a
a
a
a
a
a
a
a
a
a
a
a
a
a
h
h
h
h
h
a
a
a
a
a
a
a
a
a
a
a
a
a
"}
(2,1,1) = {"
a
a
a
a
a
a
a
a
a
a
a
a
a
a
h
h
h
h
h
a
a
a
a
a
a
a
a
a
a
a
a
a
"}
(3,1,1) = {"
a
a
a
a
a
a
a
a
a
a
a
a
a
a
h
h
h
h
h
a
a
a
a
a
a
a
a
a
a
a
a
a
"}
(4,1,1) = {"
a
a
a
a
a
a
a
a
a
a
a
a
a
a
h
h
h
h
h
a
a
a
a
a
a
a
a
a
a
a
a
a
"}
(5,1,1) = {"
a
a
a
a
a
a
a
a
a
a
a
a
a
a
h
i
h
i
h
a
a
a
a
a
a
a
a
a
a
a
a
a
"}
(6,1,1) = {"
a
a
a
a
a
a
a
a
a
a
a
a
a
a
h
b
b
b
h
a
a
a
a
a
a
a
a
a
a
a
a
a
"}
(7,1,1) = {"
a
a
a
a
a
a
a
a
a
a
a
a
a
a
h
b
c
b
h
a
a
a
a
a
a
a
a
a
a
a
a
a
"}
(8,1,1) = {"
a
a
a
a
a
a
a
a
a
a
a
a
a
a
h
g
g
g
h
a
a
a
a
a
a
a
a
a
a
a
a
a
"}
(9,1,1) = {"
a
a
a
a
a
a
a
a
a
c
c
c
c
c
c
c
b
c
c
c
c
c
c
c
a
a
a
a
a
a
a
a
"}
(10,1,1) = {"
a
a
a
a
a
a
a
a
a
c
b
b
b
b
b
b
b
b
b
b
b
b
b
c
a
a
a
a
a
a
a
a
"}
(11,1,1) = {"
a
a
a
a
a
a
a
a
a
c
b
b
b
b
b
b
d
b
b
b
b
b
b
c
a
a
a
a
a
a
a
a
"}
(12,1,1) = {"
a
a
a
a
a
a
a
a
a
c
b
b
e
b
b
b
b
b
b
b
e
b
b
c
a
a
a
a
a
a
a
a
"}
(13,1,1) = {"
a
a
a
a
a
a
a
a
a
c
b
b
b
b
b
b
b
b
b
b
b
b
b
c
a
a
a
a
a
a
a
a
"}
(14,1,1) = {"
h
h
h
h
h
h
h
h
h
c
b
b
b
b
b
b
b
b
b
b
b
b
b
c
h
h
h
h
h
h
h
h
"}
(15,1,1) = {"
h
h
h
h
h
i
b
b
g
c
b
b
b
b
b
b
b
b
b
b
b
b
b
c
g
b
b
i
h
h
h
h
"}
(16,1,1) = {"
h
h
h
h
h
h
b
c
g
b
b
d
b
b
b
b
f
b
b
b
b
d
b
b
g
c
b
h
h
h
h
h
"}
(17,1,1) = {"
h
h
h
h
h
i
b
b
g
c
b
b
b
b
b
b
b
b
b
b
b
b
b
c
g
b
b
i
h
h
h
h
"}
(18,1,1) = {"
h
h
h
h
h
h
h
h
h
c
b
b
b
b
b
b
b
b
b
b
b
b
b
c
h
h
h
h
h
h
h
h
"}
(19,1,1) = {"
a
a
a
a
a
a
a
a
a
c
b
b
b
b
b
b
b
b
b
b
b
b
b
c
a
a
a
a
a
a
a
a
"}
(20,1,1) = {"
a
a
a
a
a
a
a
a
a
c
b
b
e
b
b
b
b
b
b
b
e
b
b
c
a
a
a
a
a
a
a
a
"}
(21,1,1) = {"
a
a
a
a
a
a
a
a
a
c
b
b
b
b
b
b
d
b
b
b
b
b
b
c
a
a
a
a
a
a
a
a
"}
(22,1,1) = {"
a
a
a
a
a
a
a
a
a
c
b
b
b
b
b
b
b
b
b
b
b
b
b
c
a
a
a
a
a
a
a
a
"}
(23,1,1) = {"
a
a
a
a
a
a
a
a
a
c
c
c
c
c
c
c
b
c
c
c
c
c
c
c
a
a
a
a
a
a
a
a
"}
(24,1,1) = {"
a
a
a
a
a
a
a
a
a
a
a
a
a
a
h
g
g
g
h
a
a
a
a
a
a
a
a
a
a
a
a
a
"}
(25,1,1) = {"
a
a
a
a
a
a
a
a
a
a
a
a
a
a
h
b
c
b
h
a
a
a
a
a
a
a
a
a
a
a
a
a
"}
(26,1,1) = {"
a
a
a
a
a
a
a
a
a
a
a
a
a
a
h
b
b
b
h
a
a
a
a
a
a
a
a
a
a
a
a
a
"}
(27,1,1) = {"
a
a
a
a
a
a
a
a
a
a
a
a
a
a
h
i
h
i
h
a
a
a
a
a
a
a
a
a
a
a
a
a
"}
(28,1,1) = {"
a
a
a
a
a
a
a
a
a
a
a
a
a
a
h
h
h
h
h
a
a
a
a
a
a
a
a
a
a
a
a
a
"}
(29,1,1) = {"
a
a
a
a
a
a
a
a
a
a
a
a
a
a
h
h
h
h
h
a
a
a
a
a
a
a
a
a
a
a
a
a
"}
(30,1,1) = {"
a
a
a
a
a
a
a
a
a
a
a
a
a
a
h
h
h
h
h
a
a
a
a
a
a
a
a
a
a
a
a
a
"}
(31,1,1) = {"
a
a
a
a
a
a
a
a
a
a
a
a
a
a
h
h
h
h
h
a
a
a
a
a
a
a
a
a
a
a
a
a
"}
(32,1,1) = {"
a
a
a
a
a
a
a
a
a
a
a
a
a
a
h
h
h
h
h
a
a
a
a
a
a
a
a
a
a
a
a
a
"}
