"a" = (/turf/dmm_suite/clear_turf,/area/dmm_suite/clear_area)
"b" = (/turf/dmm_suite/no_wall,/area/dmm_suite/clear_area)
"c" = (/obj/marker/prefab/house/low_chance{icon_state = ""; dir = 4},/turf/dmm_suite/no_wall,/area/dmm_suite/clear_area)
"d" = (/obj/marker/prefab/house/low_chance{icon_state = ""; dir = 8},/turf/dmm_suite/no_wall,/area/dmm_suite/clear_area)
"h" = (/turf/simulated/floor/sidewalk,/area/dmm_suite/clear_area)
"i" = (/obj/decal/road_marking/solid_line,/turf/simulated/floor/road,/area/dmm_suite/clear_area)
"j" = (/turf/simulated/floor/road,/area/dmm_suite/clear_area)
"k" = (/obj/decal/road_marking/dotted_line,/turf/simulated/floor/road,/area/dmm_suite/clear_area)

(1,1,1) = {"
aaaaaaaaaaaaaaaaaaaaaaaaaaaahijjkjjihaaaaaaaaaaaaaaaaaaaaaaaaaaa
aaaaaaaaabbbbbbbbbbbbbbbbbbbhijjkjjihbbbbbbbbbbbbbbbbbbbaaaaaaaa
aaaaaaaaabbbbbbbbbbbbbbbbbbbhijjkjjihbbbbbbbbbbbbbbbbbbbaaaaaaaa
aaaaaaaaabbbbbbbbbbbbbbbbbbbhijjkjjihbbbbbbbbbbbbbbbbbbbaaaaaaaa
aaaaaaaaabbbbbbbbbbbbbbbbbbbhijjkjjihbbbbbbbbbbbbbbbbbbbaaaaaaaa
aaaaaaaaabbbbbbbbbbbbbbbbbbbhijjkjjihbbbbbbbbbbbbbbbbbbbaaaaaaaa
aaaaaaaaabbbbbbbbbbbbbbbbbbbhijjkjjihbbbbbbbbbbbbbbbbbbbaaaaaaaa
aaaaaaaaabbbbbbbbbbbbbbbbbbbhijjkjjihbbbbbbbbbbbbbbbbbbbaaaaaaaa
aaaaaaaaabbbbbbbbbbbbbbbbbbbhijjkjjihbbbbbbbbbbbbbbbbbbbaaaaaaaa
aaaaaaaaabbbbbbbbbbbbbbbbbbbhijjkjjihbbbbbbbbbbbbbbbbbbbaaaaaaaa
aaaaaaaaabbbbbbbbbbbbbbbbbbbhijjkjjihbbbbbbbbbbbbbbbbbbbaaaaaaaa
aaaaaaaaabbbbbbbbbbbbbbbbbbbhijjkjjihbbbbbbbbbbbbbbbbbbbaaaaaaaa
aaaaaaaaabbbbbbbbbbbbbbbbbbbhijjkjjihbbbbbbbbbbbbbbbbbbbaaaaaaaa
aaaaaaaaabbbbbbbbbbbbbbbbbbbhijjkjjihbbbbbbbbbbbbbbbbbbbaaaaaaaa
aaaaaaaaabbbbbbbbbbbbbbbbbbbhijjkjjihbbbbbbbbbbbbbbbbbbbaaaaaaaa
aaaaaaaaabbbbbbbbbbbbbbbbbbbhijjkjjihbbbbbbbbbbbbbbbbbbbaaaaaaaa
aaaaaaaaabbbbbbbbbbbbbbbbbbbhijjkjjihbbbbbbbbbbbbbbbbbbbaaaaaaaa
aaaaaaaaabbbbbbbbbbbbbbbbbbbhijjkjjihbbbbbbbbbbbbbbbbbbbaaaaaaaa
aaaaaaaaabbbbbbbbbbbbbbbbbbbhijjkjjihbbbbbbbbbbbbbbbbbbbaaaaaaaa
aaaaaaaaabbbcbbbbbbbbbbbbbbbhijjkjjihdbbbbbbbbbbbbbbbbbbaaaaaaaa
aaaaaaaaabbbbbbbbbbbbbbbbbbbhijjkjjihbbbbbbbbbbbbbbbbbbbaaaaaaaa
aaaaaaaaabbbbbbbbbbbbbbbbbbbhijjkjjihbbbbbbbbbbbbbbbbbbbaaaaaaaa
aaaaaaaaabbbbbbbbbbbbbbbbbbbhijjkjjihbbbbbbbbbbbbbbbbbbbaaaaaaaa
aaaaaaaaabbbbbbbbbbbbbbbbbbbhijjkjjihbbbbbbbbbbbbbbbbbbbaaaaaaaa
aaaaaaaaabbbbbbbbbbbbbbbbbbbhijjkjjihbbbbbbbbbbbbbbbbbbbaaaaaaaa
aaaaaaaaabbbbbbbbbbbbbbbbbbbhijjkjjihbbbbbbbbbbbbbbbbbbbaaaaaaaa
aaaaaaaaabbbbbbbbbbbbbbbbbbbhijjkjjihbbbbbbbbbbbbbbbbbbbaaaaaaaa
aaaaaaaaabbbbbbbbbbbbbbbbbbbhijjkjjihbbbbbbbbbbbbbbbbbbbaaaaaaaa
aaaaaaaaabbbbbbbbbbbbbbbbbbbhijjkjjihbbbbbbbbbbbbbbbbbbbaaaaaaaa
aaaaaaaaabbbbbbbbbbbbbbbbbbbhijjkjjihbbbbbbbbbbbbbbbbbbbaaaaaaaa
aaaaaaaaabbbbbbbbbbbbbbbbbbbhijjkjjihbbbbbbbbbbbbbbbbbbbaaaaaaaa
aaaaaaaaabbbbbbbbbbbbbbbbbbbhijjkjjihbbbbbbbbbbbbbbbbbbbaaaaaaaa
aaaaaaaaabbbbbbbbbbbbbbbbbbbhijjkjjihbbbbbbbbbbbbbbbbbbbaaaaaaaa
aaaaaaaaabbbbbbbbbbbbbbbbbbbhijjkjjihbbbbbbbbbbbbbbbbbbbaaaaaaaa
aaaaaaaaabbbbbbbbbbbbbbbbbbbhijjkjjihbbbbbbbbbbbbbbbbbbbaaaaaaaa
aaaaaaaaabbbbbbbbbbbbbbbbbbbhijjkjjihbbbbbbbbbbbbbbbbbbbaaaaaaaa
aaaaaaaaabbbbbbbbbbbbbbbbbbbhijjkjjihbbbbbbbbbbbbbbbbbbbaaaaaaaa
aaaaaaaaabbbbbbbbbbbbbbbbbbbhijjkjjihbbbbbbbbbbbbbbbbbbbaaaaaaaa
aaaaaaaaabbbbbbbbbbbbbbbbbbbhijjkjjihbbbbbbbbbbbbbbbbbbbaaaaaaaa
aaaaaaaaabbbcbbbbbbbbbbbbbbbhijjkjjihdbbbbbbbbbbbbbbbbbbaaaaaaaa
aaaaaaaaabbbbbbbbbbbbbbbbbbbhijjkjjihbbbbbbbbbbbbbbbbbbbaaaaaaaa
aaaaaaaaabbbbbbbbbbbbbbbbbbbhijjkjjihbbbbbbbbbbbbbbbbbbbaaaaaaaa
aaaaaaaaabbbbbbbbbbbbbbbbbbbhijjkjjihbbbbbbbbbbbbbbbbbbbaaaaaaaa
aaaaaaaaabbbbbbbbbbbbbbbbbbbhijjkjjihbbbbbbbbbbbbbbbbbbbaaaaaaaa
aaaaaaaaabbbbbbbbbbbbbbbbbbbhijjkjjihbbbbbbbbbbbbbbbbbbbaaaaaaaa
aaaaaaaaabbbbbbbbbbbbbbbbbbbhijjkjjihbbbbbbbbbbbbbbbbbbbaaaaaaaa
aaaaaaaaabbbbbbbbbbbbbbbbbbbhijjkjjihbbbbbbbbbbbbbbbbbbbaaaaaaaa
aaaaaaaaabbbbbbbbbbbbbbbbbbbhijjkjjihbbbbbbbbbbbbbbbbbbbaaaaaaaa
aaaaaaaaabbbbbbbbbbbbbbbbbbbhijjkjjihbbbbbbbbbbbbbbbbbbbaaaaaaaa
aaaaaaaaabbbbbbbbbbbbbbbbbbbhijjkjjihbbbbbbbbbbbbbbbbbbbaaaaaaaa
aaaaaaaaabbbbbbbbbbbbbbbbbbbhijjkjjihbbbbbbbbbbbbbbbbbbbaaaaaaaa
aaaaaaaaabbbbbbbbbbbbbbbbbbbhijjkjjihbbbbbbbbbbbbbbbbbbbaaaaaaaa
aaaaaaaaabbbbbbbbbbbbbbbbbbbhijjkjjihbbbbbbbbbbbbbbbbbbbaaaaaaaa
aaaaaaaaabbbbbbbbbbbbbbbbbbbhijjkjjihbbbbbbbbbbbbbbbbbbbaaaaaaaa
aaaaaaaaabbbbbbbbbbbbbbbbbbbhijjkjjihbbbbbbbbbbbbbbbbbbbaaaaaaaa
aaaaaaaaabbbbbbbbbbbbbbbbbbbhijjkjjihbbbbbbbbbbbbbbbbbbbaaaaaaaa
aaaaaaaaabbbbbbbbbbbbbbbbbbbhijjkjjihbbbbbbbbbbbbbbbbbbbaaaaaaaa
aaaaaaaaabbbbbbbbbbbbbbbbbbbhijjkjjihbbbbbbbbbbbbbbbbbbbaaaaaaaa
aaaaaaaaabbbbbbbbbbbbbbbbbbbhijjkjjihbbbbbbbbbbbbbbbbbbbaaaaaaaa
aaaaaaaaabbbcbbbbbbbbbbbbbbbhijjkjjihdbbbbbbbbbbbbbbbbbbaaaaaaaa
aaaaaaaaabbbbbbbbbbbbbbbbbbbhijjkjjihbbbbbbbbbbbbbbbbbbbaaaaaaaa
aaaaaaaaabbbbbbbbbbbbbbbbbbbhijjkjjihbbbbbbbbbbbbbbbbbbbaaaaaaaa
aaaaaaaaabbbbbbbbbbbbbbbbbbbhijjkjjihbbbbbbbbbbbbbbbbbbbaaaaaaaa
aaaaaaaaaaaaaaaaaaaaaaaaaaaahijjkjjihaaaaaaaaaaaaaaaaaaaaaaaaaaa
"}
