"a" = (/turf/dmm_suite/clear_turf,/area/dmm_suite/clear_area)
"b" = (/obj/structure/short_wall/wood/starting,/turf/dmm_suite/clear_turf,/area/dmm_suite/clear_area)
"c" = (/obj/structure/short_wall/wood,/turf/simulated/floor/wood/boat,/area/dmm_suite/clear_area)
"d" = (/turf/simulated/floor/wood/boat,/area/dmm_suite/clear_area)
"e" = (/turf/simulated/wall/wood/boat,/area/dmm_suite/clear_area)
"f" = (/turf/simulated/floor/stair/wood,/area/dmm_suite/clear_area)
"g" = (/turf/simulated/floor/wood/boat/starting,/area/dmm_suite/clear_area)
"h" = (/obj/structure/short_wall/wood/starting,/turf/simulated/floor/wood/boat/starting,/area/dmm_suite/clear_area)
"i" = (/turf/simulated/floor/stair/wood{icon_state = "stair";dir = 1},/area/dmm_suite/clear_area)
"j" = (/obj/structure/short_wall/wood/starting,/turf/simulated/floor/wood/boat,/area/dmm_suite/clear_area)
"k" = (/obj/structure/interactive/cannon{icon_state = "map";dir = 8},/obj/item/cannonball,/turf/simulated/floor/wood/boat,/area/dmm_suite/clear_area)
"l" = (/obj/structure/interactive/cannon{icon_state = "map";dir = 4},/obj/item/cannonball,/turf/simulated/floor/wood/boat,/area/dmm_suite/clear_area)
"m" = (/obj/structure/interactive/cannon{icon_state = "map";dir = 8},/obj/item/cannonball,/turf/simulated/floor/wood/boat/starting,/area/dmm_suite/clear_area)
"n" = (/obj/structure/interactive/cannon{icon_state = "map";dir = 4},/obj/item/cannonball,/turf/simulated/floor/wood/boat/starting,/area/dmm_suite/clear_area)
"o" = (/obj/structure/interactive/cannon,/obj/item/cannonball,/turf/simulated/floor/wood/boat/starting,/area/dmm_suite/clear_area)
"p" = (/obj/item/cannonball,/turf/simulated/floor/wood/boat,/area/dmm_suite/clear_area)
"q" = (/obj/item/cannon_fuse,/turf/simulated/floor/wood/boat,/area/dmm_suite/clear_area)
"r" = (/obj/item/cannon_fuse,/turf/simulated/floor/wood/boat/starting,/area/dmm_suite/clear_area)
"s" = (/obj/item/cannonball,/turf/simulated/floor/wood/boat/starting,/area/dmm_suite/clear_area)
"t" = (/mob/living/advanced/npc/pirate_crew/ranged{icon_state = "directional";dir = 1},/turf/simulated/floor/wood/boat,/area/dmm_suite/clear_area)
"u" = (/mob/living/advanced/npc/pirate_crew/ranged{icon_state = "directional";dir = 8},/turf/simulated/floor/wood/boat/starting,/area/dmm_suite/clear_area)
"v" = (/mob/living/advanced/npc/pirate_crew/ranged{icon_state = "directional";dir = 4},/turf/simulated/floor/wood/boat/starting,/area/dmm_suite/clear_area)
"w" = (/obj/item/cannonball,/mob/living/advanced/npc/pirate_crew/ranged{icon_state = "directional";dir = 4},/turf/simulated/floor/wood/boat,/area/dmm_suite/clear_area)
"x" = (/obj/item/cannonball,/mob/living/advanced/npc/pirate_crew/ranged{icon_state = "directional";dir = 8},/turf/simulated/floor/wood/boat,/area/dmm_suite/clear_area)
"y" = (/obj/item/cannon_fuse,/mob/living/advanced/npc/pirate_crew/ranged{icon_state = "directional";dir = 8},/turf/simulated/floor/wood/boat/starting,/area/dmm_suite/clear_area)
"z" = (/obj/item/cannonball,/mob/living/advanced/npc/pirate_crew/ranged{icon_state = "directional";dir = 4},/turf/simulated/floor/wood/boat/starting,/area/dmm_suite/clear_area)
"A" = (/mob/living/advanced/npc/pirate_crew/melee,/turf/simulated/floor/wood/boat,/area/dmm_suite/clear_area)
"B" = (/mob/living/advanced/npc/pirate_crew/melee,/turf/simulated/floor/wood/boat/starting,/area/dmm_suite/clear_area)
"C" = (/mob/living/advanced/npc/unique/pirate_captain,/turf/simulated/floor/wood/boat/starting,/area/dmm_suite/clear_area)
"D" = (/mob/living/advanced/npc/unique/pirate_mate,/turf/simulated/floor/wood/boat/starting,/area/dmm_suite/clear_area)
"E" = (/obj/structure/short_wall/wood/starting,/obj/marker/map_node,/turf/simulated/floor/wood/boat/starting,/area/dmm_suite/clear_area)
"F" = (/obj/marker/map_node,/turf/simulated/floor/wood/boat/starting,/area/dmm_suite/clear_area)
"G" = (/obj/marker/map_node,/turf/simulated/floor/wood/boat,/area/dmm_suite/clear_area)
"H" = (/obj/item/cannonball,/obj/marker/map_node,/turf/simulated/floor/wood/boat/starting,/area/dmm_suite/clear_area)

(1,1,1) = {"
aaaaaaaaaaaaaaaaaaaaaaaaaaaaaaaa
aaaaaaaaaaaaaaaaaaaaaaaaaaaaaaaa
aaaaaaaaaaaaacccccaaaaaaaaaaaaaa
aaaaaaaaaaaaactGdcaaaaaaaaaaaaaa
aaaaaaaaaaaaaeefeeaaaaaaaaaaaaaa
aaaaaaaaaaaeeegFgeeeaaaaaaaaaaaa
aaaaaaaaaaaegggggggeaaaaaaaaaaaa
aaaaaaaaaaaEggCgDggEaaaaaaaaaaaa
aaaaaaaaaaaEugggggvEaaaaaaaaaaaa
aaaaaaaaaaaegFgggFgeaaaaaaaaaaaa
aaaaaaaaaaaeeieeeieeaaaaaaaaaaaa
aaaaaaaaaaackGpqdGlcaaaaaaaaaaaa
aaaaaaaaaaacqdAdddwcaaaaaaaaaaaa
aaaaaaaaaaackdddddlcaaaaaaaaaaaa
aaaaaaaaaaacxddjqdpcaaaaaaaaaaaa
aaaaaaaaaaackGdddGlcaaaaaaaaaaaa
aaaaaaaaaaacqdddAdqcaaaaaaaaaaaa
aaaaaaaaaaackdqjddlcaaaaaaaaaaaa
aaaaaaaaaaacxdddddwcaaaaaaaaaaaa
aaaaaaaaaaackGqqpGlcaaaaaaaaaaaa
aaaaaaaaaaahhfhhhfhhaaaaaaaaaaaa
aaaaaaaaaaahrHgggFrhaaaaaaaaaaaa
aaaaaaaaaaahmggBggnhaaaaaaaaaaaa
aaaaaaaaaaahhsgFgghhaaaaaaaaaaaa
aaaaaaaaaaaahysggzhaaaaaaaaaaaaa
aaaaaaaaaaaahhorohhaaaaaaaaaaaaa
aaaaaaaaaaaaahhhhhaaaaaaaaaaaaaa
aaaaaaaaaaaaaaabaaaaaaaaaaaaaaaa
aaaaaaaaaaaaaaabaaaaaaaaaaaaaaaa
aaaaaaaaaaaaaaabaaaaaaaaaaaaaaaa
aaaaaaaaaaaaaaabaaaaaaaaaaaaaaaa
aaaaaaaaaaaaaaaaaaaaaaaaaaaaaaaa
"}
