//MAP CONVERTED BY dmm2tgm.py THIS HEADER COMMENT PREVENTS RECONVERSION, DO NOT REMOVE
"a" = (
/turf/dmm_suite/clear_turf,
/area/dmm_suite/clear_area)
"b" = (
/turf/dmm_suite/no_wall,
/area/dmm_suite/clear_area)
"c" = (
/turf/simulated/wall/brick/grey,
/area/dmm_suite/clear_area)
"d" = (
/obj/structure/interactive/door/wood,
/turf/simulated/floor/brick/grey,
/area/dmm_suite/clear_area)
"e" = (
/turf/simulated/floor/brick/grey,
/area/dmm_suite/clear_area)
"f" = (
/mob/living/advanced/npc/goblin/warrior,
/turf/simulated/floor/brick/grey,
/area/dmm_suite/clear_area)
"g" = (
/turf/simulated/floor/carpet,
/area/dmm_suite/clear_area)
"h" = (
/mob/living/advanced/npc/goblin/mage{
	icon_state = "directional";
	dir = 8
	},
/turf/simulated/floor/brick/grey,
/area/dmm_suite/clear_area)
"i" = (
/mob/living/advanced/npc/goblin/mage{
	icon_state = "directional";
	dir = 4
	},
/turf/simulated/floor/brick/grey,
/area/dmm_suite/clear_area)
"j" = (
/mob/living/advanced/npc/goblin/mage,
/turf/simulated/floor/brick/grey,
/area/dmm_suite/clear_area)
"k" = (
/mob/living/advanced/npc/goblin/warrior{
	icon_state = "directional";
	dir = 8
	},
/turf/simulated/floor/brick/grey,
/area/dmm_suite/clear_area)
"l" = (
/obj/structure/interactive/lighting/mounted_torch{
	icon_state = "torch";
	dir = 4
	},
/turf/simulated/wall/brick/grey,
/area/dmm_suite/clear_area)
"m" = (
/obj/structure/smooth/table/wood/poor,
/turf/simulated/floor/brick/grey,
/area/dmm_suite/clear_area)
"n" = (
/mob/living/advanced/npc/goblin/warrior,
/turf/simulated/floor/carpet,
/area/dmm_suite/clear_area)
"o" = (
/obj/marker/objective_spawn,
/turf/simulated/floor/brick/grey,
/area/dmm_suite/clear_area)

(1,1,1) = {"
a
a
a
a
a
a
a
a
a
a
a
a
a
a
a
a
a
a
a
a
a
a
a
a
a
a
a
a
a
a
a
a
"}
(2,1,1) = {"
a
a
a
a
a
a
a
c
c
c
c
c
c
c
c
c
c
c
c
c
a
a
a
a
a
a
a
a
a
a
a
a
"}
(3,1,1) = {"
a
a
a
a
a
a
a
c
e
e
i
e
e
c
f
e
e
e
e
c
c
c
c
c
c
c
c
c
a
a
a
a
"}
(4,1,1) = {"
a
a
a
a
a
a
a
c
e
g
g
g
e
c
e
g
g
g
e
c
e
e
i
e
e
e
e
c
a
a
a
a
"}
(5,1,1) = {"
a
a
a
a
a
a
a
c
e
g
g
g
e
d
e
g
g
g
e
d
e
g
g
g
g
g
e
c
a
a
a
a
"}
(6,1,1) = {"
a
a
c
c
c
c
c
c
e
g
g
g
e
d
e
g
g
g
e
d
e
g
g
g
g
g
e
c
a
a
a
a
"}
(7,1,1) = {"
a
a
c
e
e
e
e
e
e
g
g
g
e
c
e
g
g
g
e
c
e
g
g
g
g
g
e
c
a
a
a
a
"}
(8,1,1) = {"
a
a
c
f
g
g
g
g
e
g
g
g
e
c
e
e
e
e
e
c
e
g
g
g
g
g
e
c
a
a
b
b
"}
(9,1,1) = {"
a
a
c
e
g
g
g
g
e
e
e
e
e
c
c
l
c
c
c
c
e
g
g
g
g
g
e
c
a
a
b
b
"}
(10,1,1) = {"
b
b
d
e
g
g
g
g
e
g
g
g
e
c
e
m
m
m
m
c
e
e
e
e
e
k
e
c
a
b
b
b
"}
(11,1,1) = {"
b
b
d
e
g
g
g
g
e
g
g
g
e
c
e
e
e
e
e
c
c
d
d
e
c
c
c
c
a
b
b
b
"}
(12,1,1) = {"
b
b
d
e
g
g
g
g
e
g
g
g
e
d
e
g
g
g
e
c
e
e
e
e
e
c
b
b
b
b
b
b
"}
(13,1,1) = {"
a
a
c
e
g
g
g
g
e
g
g
g
e
d
e
g
g
n
e
d
e
g
g
g
e
d
b
b
b
b
b
b
"}
(14,1,1) = {"
a
a
c
e
g
g
g
g
e
e
e
e
e
c
e
g
g
g
e
d
e
g
g
g
e
d
b
b
b
b
b
b
"}
(15,1,1) = {"
a
a
c
e
g
g
g
g
e
c
c
d
c
c
e
e
e
e
e
c
e
g
g
g
e
c
b
b
b
b
b
b
"}
(16,1,1) = {"
a
a
c
e
e
e
e
h
e
c
i
e
e
c
o
e
e
e
e
c
f
e
e
e
e
c
c
c
c
c
c
b
"}
(17,1,1) = {"
a
a
c
c
c
c
d
c
c
c
e
e
e
c
c
c
d
d
c
c
c
d
d
c
c
c
e
e
e
e
c
b
"}
(18,1,1) = {"
a
a
a
c
e
e
e
e
e
c
e
e
e
e
c
i
e
e
e
e
e
e
e
e
c
e
g
g
g
e
c
b
"}
(19,1,1) = {"
a
a
a
c
e
g
g
g
e
c
e
g
g
e
c
e
g
g
g
g
g
g
g
e
c
e
g
g
g
e
c
b
"}
(20,1,1) = {"
a
a
a
c
e
g
g
g
e
c
e
g
g
e
d
e
g
g
g
g
g
g
g
e
d
e
g
g
g
e
c
b
"}
(21,1,1) = {"
a
a
a
c
f
g
g
g
e
c
j
g
g
e
d
e
g
g
g
g
g
g
g
e
d
e
g
g
g
e
c
b
"}
(22,1,1) = {"
a
a
a
c
e
g
g
g
e
c
e
g
g
e
d
e
g
g
g
g
g
g
g
e
c
e
g
g
g
e
c
b
"}
(23,1,1) = {"
a
a
a
c
e
g
g
g
e
c
e
g
g
e
c
e
g
g
g
g
g
g
g
e
c
e
e
k
e
e
c
b
"}
(24,1,1) = {"
a
a
a
c
e
g
g
g
e
c
e
e
e
e
c
e
e
e
e
k
e
e
e
e
c
c
c
c
c
c
c
b
"}
(25,1,1) = {"
a
a
a
c
e
g
g
g
e
c
e
e
e
e
c
c
c
c
c
c
c
c
d
c
c
e
e
e
e
c
a
a
"}
(26,1,1) = {"
a
a
a
c
e
g
g
g
e
d
e
e
e
e
e
e
e
g
g
g
c
e
e
e
e
e
g
g
e
c
a
a
"}
(27,1,1) = {"
a
a
a
c
e
e
e
e
e
c
e
e
e
e
e
e
e
g
g
g
c
e
g
g
g
e
g
g
e
c
a
a
"}
(28,1,1) = {"
a
a
a
c
c
c
c
c
c
c
e
k
e
e
e
e
e
g
g
g
c
e
g
g
g
e
g
g
e
c
a
a
"}
(29,1,1) = {"
a
a
a
a
a
a
a
a
a
c
c
c
c
c
c
c
c
c
c
c
c
e
e
k
e
e
e
e
e
c
a
a
"}
(30,1,1) = {"
a
a
a
a
a
a
a
a
a
a
a
a
a
a
a
a
a
a
a
a
c
c
c
c
c
c
c
c
c
c
a
a
"}
(31,1,1) = {"
a
a
a
a
a
a
a
a
a
a
a
a
a
a
a
a
a
a
a
a
a
a
a
a
a
a
a
a
a
a
a
a
"}
(32,1,1) = {"
a
a
a
a
a
a
a
a
a
a
a
a
a
a
a
a
a
a
a
a
a
a
a
a
a
a
a
a
a
a
a
a
"}
