//MAP CONVERTED BY dmm2tgm.py THIS HEADER COMMENT PREVENTS RECONVERSION, DO NOT REMOVE
"a" = (
/turf/dmm_suite/clear_turf,
/area/dmm_suite/clear_area)
"b" = (
/turf/simulated/wall/brick/grey,
/area/dmm_suite/clear_area)
"c" = (
/turf/simulated/floor/brick/grey,
/area/dmm_suite/clear_area)
"d" = (
/obj/structure/interactive/door/wood,
/turf/simulated/floor/brick/grey,
/area/dmm_suite/clear_area)
"e" = (
/obj/structure/smooth/table/wood/poor,
/turf/simulated/floor/brick/grey,
/area/dmm_suite/clear_area)
"f" = (
/turf/dmm_suite/no_wall,
/area/dmm_suite/clear_area)
"g" = (
/obj/structure/interactive/crate/chest/filled,
/turf/simulated/floor/brick/grey,
/area/dmm_suite/clear_area)
"h" = (
/obj/structure/interactive/crate/chest/filled,
/turf/dmm_suite/no_wall,
/area/dmm_suite/clear_area)
"i" = (
/obj/structure/interactive/lighting/mounted_torch{
	dir = 4;
	icon_state = "torch"
	},
/turf/simulated/wall/brick/grey,
/area/dmm_suite/clear_area)
"j" = (
/turf/simulated/floor/carpet,
/area/dmm_suite/clear_area)
"k" = (
/obj/structure/interactive/lighting/mounted_torch{
	dir = 8;
	icon_state = "torch"
	},
/turf/simulated/wall/brick/grey,
/area/dmm_suite/clear_area)
"l" = (
/obj/structure/interactive/lighting/mounted_torch,
/turf/simulated/wall/brick/grey,
/area/dmm_suite/clear_area)
"m" = (
/obj/structure/smooth/table/wood/poor,
/turf/simulated/floor/carpet,
/area/dmm_suite/clear_area)
"n" = (
/obj/structure/interactive/lighting/mounted_torch{
	dir = 1;
	icon_state = "torch"
	},
/turf/simulated/wall/brick/grey,
/area/dmm_suite/clear_area)
"o" = (
/mob/living/advanced/npc/goblin/warrior{
	dir = 1;
	icon_state = "directional"
	},
/turf/simulated/floor/carpet,
/area/dmm_suite/clear_area)
"p" = (
/mob/living/advanced/npc/goblin/warrior{
	dir = 1;
	icon_state = "directional"
	},
/turf/simulated/floor/brick/grey,
/area/dmm_suite/clear_area)
"q" = (
/mob/living/advanced/npc/goblin/warrior,
/turf/simulated/floor/carpet,
/area/dmm_suite/clear_area)
"r" = (
/mob/living/advanced/npc/goblin/warrior{
	dir = 8;
	icon_state = "directional"
	},
/turf/simulated/floor/brick/grey,
/area/dmm_suite/clear_area)
"s" = (
/mob/living/advanced/npc/goblin/mage{
	dir = 1;
	icon_state = "directional"
	},
/turf/simulated/floor/carpet,
/area/dmm_suite/clear_area)
"t" = (
/mob/living/advanced/npc/goblin/mage,
/turf/simulated/floor/carpet,
/area/dmm_suite/clear_area)
"u" = (
/mob/living/advanced/npc/goblin/mage{
	dir = 8;
	icon_state = "directional"
	},
/turf/simulated/floor/carpet,
/area/dmm_suite/clear_area)
"v" = (
/obj/marker/lobby,
/turf/simulated/floor/brick/grey,
/area/dmm_suite/clear_area)
"w" = (
/obj/marker/objective_spawn,
/turf/simulated/floor/brick/grey,
/area/dmm_suite/clear_area)

(1,1,1) = {"
a
a
a
a
a
a
a
a
a
a
a
a
a
a
a
a
a
a
a
a
a
a
a
a
a
a
f
f
f
f
a
a
"}
(2,1,1) = {"
a
a
a
a
a
a
a
a
a
a
a
a
a
a
a
a
a
a
a
a
a
a
a
a
a
a
f
f
f
f
a
a
"}
(3,1,1) = {"
a
a
a
a
a
a
a
a
a
a
a
a
a
a
a
a
a
a
a
a
a
a
a
a
a
a
f
f
f
f
a
a
"}
(4,1,1) = {"
a
a
a
a
a
a
a
a
a
a
a
a
a
a
a
a
a
b
b
b
i
b
b
b
b
f
f
f
f
f
f
a
"}
(5,1,1) = {"
a
a
a
a
a
a
a
a
a
a
a
a
a
a
a
a
a
b
e
c
c
c
e
e
b
f
f
f
f
f
f
f
"}
(6,1,1) = {"
a
a
a
a
a
a
a
a
a
a
a
a
a
a
a
a
a
b
e
c
c
c
c
c
b
f
f
f
f
f
f
f
"}
(7,1,1) = {"
a
a
a
a
a
a
a
a
a
a
a
a
a
a
a
a
a
b
e
c
j
q
c
c
d
f
f
f
f
f
f
f
"}
(8,1,1) = {"
a
a
a
a
a
a
a
a
a
a
a
a
a
a
a
a
a
b
g
c
t
j
c
c
d
f
f
f
f
f
f
f
"}
(9,1,1) = {"
a
a
a
a
a
a
a
a
a
a
a
a
a
a
a
a
a
l
c
c
j
j
c
c
b
f
f
f
f
f
f
f
"}
(10,1,1) = {"
a
a
a
a
a
b
b
i
b
b
b
b
i
b
b
b
b
b
c
c
j
q
c
c
b
f
f
f
f
f
f
a
"}
(11,1,1) = {"
a
a
a
a
a
b
e
e
e
e
c
c
c
c
e
e
e
c
c
c
j
j
c
c
b
i
b
b
b
b
b
a
"}
(12,1,1) = {"
f
f
f
f
f
b
e
c
c
c
c
c
c
c
c
c
c
c
c
c
j
j
c
c
c
c
c
c
e
e
b
a
"}
(13,1,1) = {"
f
f
f
f
f
b
c
c
j
j
j
s
j
c
j
j
j
j
j
c
c
c
c
c
c
c
c
c
c
e
b
a
"}
(14,1,1) = {"
f
f
f
f
f
d
c
c
o
j
j
j
j
c
j
j
j
j
j
c
c
v
c
c
c
r
c
c
c
c
n
a
"}
(15,1,1) = {"
f
f
f
f
f
d
c
c
j
j
j
j
j
c
b
b
b
k
b
b
b
g
c
c
j
j
j
j
j
c
b
a
"}
(16,1,1) = {"
f
f
f
f
f
b
c
c
j
j
o
j
j
c
b
f
f
f
f
f
b
e
c
c
j
m
m
m
j
c
b
a
"}
(17,1,1) = {"
f
f
f
f
f
b
g
c
c
c
c
c
c
c
b
h
f
f
f
f
b
e
c
c
j
m
m
m
j
c
b
a
"}
(18,1,1) = {"
f
f
f
f
f
b
e
e
e
e
e
e
e
e
b
f
f
f
f
f
l
e
c
r
j
m
m
m
j
c
b
a
"}
(19,1,1) = {"
a
a
a
a
a
b
b
b
b
b
k
b
b
b
b
f
f
f
f
f
b
e
c
c
j
m
m
m
j
c
b
a
"}
(20,1,1) = {"
a
a
a
a
a
a
a
a
a
a
a
a
a
a
a
f
f
f
f
f
b
e
c
c
u
j
j
j
j
c
b
a
"}
(21,1,1) = {"
a
a
a
a
a
a
a
a
a
a
a
a
a
a
a
b
b
b
i
b
b
c
c
c
c
c
c
c
c
c
b
a
"}
(22,1,1) = {"
a
a
a
a
a
a
a
a
a
a
a
a
a
a
a
b
e
e
e
w
c
c
c
c
c
c
c
c
c
c
n
a
"}
(23,1,1) = {"
a
a
a
a
a
a
a
a
a
a
a
a
a
a
a
b
e
c
c
c
c
c
c
c
c
c
c
c
c
c
b
a
"}
(24,1,1) = {"
a
a
a
a
a
a
a
f
f
f
f
f
f
f
f
b
g
c
c
c
c
c
c
p
c
c
c
b
b
b
b
a
"}
(25,1,1) = {"
a
a
a
a
f
f
f
f
f
f
f
f
f
f
f
d
c
c
c
c
j
j
j
j
j
j
c
n
a
a
a
a
"}
(26,1,1) = {"
a
a
f
f
f
f
f
f
f
f
f
f
f
f
f
d
c
c
c
p
j
m
m
m
m
j
c
b
a
a
a
a
"}
(27,1,1) = {"
a
a
f
f
f
f
f
f
f
f
f
f
f
f
f
l
c
c
c
c
j
m
m
m
m
j
c
b
a
a
a
a
"}
(28,1,1) = {"
a
f
f
f
f
f
f
a
a
a
a
a
a
a
a
b
c
c
c
c
j
j
s
j
j
j
c
b
a
a
a
a
"}
(29,1,1) = {"
a
f
f
f
f
f
f
a
a
a
a
a
a
a
a
b
c
c
c
c
c
c
c
c
c
c
c
b
a
a
a
a
"}
(30,1,1) = {"
f
f
f
f
f
f
a
a
a
a
a
a
a
a
a
b
b
k
b
b
b
b
b
b
b
k
b
b
a
a
a
a
"}
(31,1,1) = {"
f
f
f
f
f
f
a
a
a
a
a
a
a
a
a
a
a
a
a
a
a
a
a
a
a
a
a
a
a
a
a
a
"}
(32,1,1) = {"
f
f
f
f
a
a
a
a
a
a
a
a
a
a
a
a
a
a
a
a
a
a
a
a
a
a
a
a
a
a
a
a
"}
