"a" = (/turf/dmm_suite/clear_turf,/area/dmm_suite/clear_area)
"b" = (/obj/decal/road_marking/solid_line,/turf/simulated/floor/road,/area/dmm_suite/clear_area)
"c" = (/obj/decal/road_marking/solid_line/offset/yellow{icon_state = "1"; dir = 4},/turf/simulated/floor/road,/area/dmm_suite/clear_area)
"d" = (/obj/decal/road_marking/solid_line/offset/yellow{icon_state = "1"; dir = 8},/turf/simulated/floor/road,/area/dmm_suite/clear_area)
"e" = (/obj/decal/road_marking/solid_line{icon_state = "1"; dir = 4},/turf/simulated/floor/road,/area/dmm_suite/clear_area)
"f" = (/obj/decal/road_marking/solid_line/offset/yellow,/turf/simulated/floor/road,/area/dmm_suite/clear_area)
"g" = (/obj/decal/road_marking/solid_line/offset/yellow{icon_state = "1"; dir = 8},/obj/marker/map_node/x4,/turf/simulated/floor/road,/area/dmm_suite/clear_area)
"h" = (/obj/marker/prefab/yard,/turf/dmm_suite/clear_turf,/area/dmm_suite/clear_area)
"i" = (/obj/marker/prefab/house,/turf/dmm_suite/clear_turf,/area/dmm_suite/clear_area)
"j" = (/turf/simulated/floor/sidewalk,/area/dmm_suite/clear_area)
"k" = (/obj/structure/interactive/lighting/roadlamp,/turf/simulated/floor/sidewalk,/area/dmm_suite/clear_area)
"l" = (/obj/structure/interactive/stopsign{icon_state = "sign"; dir = 4},/turf/simulated/floor/sidewalk,/area/dmm_suite/clear_area)
"m" = (/turf/simulated/wall/brick/city,/area/dmm_suite/clear_area)
"n" = (/obj/decal/road_marking/solid_cross{icon_state = "1"; dir = 4},/turf/simulated/floor/road,/area/dmm_suite/clear_area)
"o" = (/obj/decal/road_marking/solid_stop{icon_state = "1"; dir = 4},/turf/simulated/floor/road,/area/dmm_suite/clear_area)
"p" = (/turf/simulated/floor/road,/area/dmm_suite/clear_area)
"q" = (/obj/decal/road_marking/solid_stop{icon_state = "1"; dir = 8},/turf/simulated/floor/road,/area/dmm_suite/clear_area)
"r" = (/obj/structure/interactive/lighting/roadlamp{icon_state = "lamp"; dir = 1},/turf/simulated/floor/sidewalk,/area/dmm_suite/clear_area)
"s" = (/obj/structure/interactive/stopsign{icon_state = "sign"; dir = 8},/turf/simulated/floor/sidewalk,/area/dmm_suite/clear_area)
"t" = (/obj/decal/road_marking/solid_cross,/turf/simulated/floor/road,/area/dmm_suite/clear_area)
"v" = (/obj/decal/road_marking/solid_stop,/turf/simulated/floor/road,/area/dmm_suite/clear_area)
"w" = (/obj/structure/interactive/lighting/roadlamp{icon_state = "lamp"; dir = 8},/turf/simulated/floor/sidewalk,/area/dmm_suite/clear_area)
"x" = (/obj/structure/interactive/stopsign,/turf/simulated/floor/sidewalk,/area/dmm_suite/clear_area)
"y" = (/obj/structure/interactive/lighting/roadlamp{icon_state = "lamp"; dir = 4},/turf/simulated/floor/sidewalk,/area/dmm_suite/clear_area)
"z" = (/obj/marker/prefab/house{icon_state = ""; dir = 1},/turf/dmm_suite/clear_turf,/area/dmm_suite/clear_area)
"B" = (/obj/marker/map_node/x4,/turf/simulated/floor/road,/area/dmm_suite/clear_area)
"C" = (/obj/decal/road_marking/dotted_line/half{icon_state = "1"; dir = 8},/turf/simulated/floor/road,/area/dmm_suite/clear_area)
"D" = (/obj/decal/road_marking/dotted_line/half{icon_state = "1"; dir = 4},/turf/simulated/floor/road,/area/dmm_suite/clear_area)
"E" = (/obj/marker/map_node/x4,/obj/decal/road_marking/dotted_line/half{icon_state = "1"; dir = 4},/turf/simulated/floor/road,/area/dmm_suite/clear_area)
"F" = (/obj/decal/road_marking/dotted_line/half,/turf/simulated/floor/road,/area/dmm_suite/clear_area)
"G" = (/obj/decal/road_marking/dotted_line/half{icon_state = "1"; dir = 1},/turf/simulated/floor/road,/area/dmm_suite/clear_area)
"H" = (/obj/marker/map_node/x4,/obj/decal/road_marking/dotted_line/half{icon_state = "1"; dir = 1},/turf/simulated/floor/road,/area/dmm_suite/clear_area)

(1,1,1) = {"
aaaaaaaaaaaaaaaaaaaaaaaaaaaaaaaaaaaaaaaaaaaaaaaaaaaaaaaaaaaaaaaa
aaaaaaaaaaaaaaaaaaaaaaaaaaaaaaaaaaaaaaaaaaaaaaaaaaaaaaaaaaaaaaaa
aaaaaaaaaaaaaaaaaaaaaaaaaaaaaaaaaaaaaaaaaaaaaaaaaaaaaaaaaaaaaaaa
aaaaaaaaaaaaaaaaaaaaaaaaaaaaaaaaaaaaaaaaaaaaaaaaaaaaaaaaaaaaaaaa
aaaaaaaaaaaaaaaaaaaaaaaaaaaaaaaaaaaaaaaaaaaaaaaaaaaaaaaaaaaaaaaa
aaaaaaaaaaaaaaaaaaaaaaaaaaaaaaaaaaaaaaaaaaaaaaaaaaaaaaaaaaaaaaaa
aaaaaaaaaaaaaaaaaaaaaaaaaaaaaaaaaaaaaaaaaaaaaaaaaaaaaaaaaaaaaaaa
aaaaaaaaaaaaaaaaaaaaaaaaaaaaaaaaaaaaaaaaaaaaaaaaaaaaaaaaaaaaaaaa
aaaaaaaaaaaaaaaaaaaaaaaaaaaaaaaaaaaaaaaaaaaaaaaaaaaaaaaaaaaaaaaa
aaaaaaaaaaaaaaaaaaaaaaaaaaaaaaaaaaaaaaaaaaaaaaaaaaaaaaaaaaaaaaaa
aaaaaaaaammmmmmmmmmmmmmmmmmmmmmmmmmmmmmmmmmmmmmmmmmmmmmaaaaaaaaa
aaaaaaaaamaaaaaaaaaaaaaaaaaaaaaaaaaaaaaaaaaaaaaaaaaaaamaaaaaaaaa
aaaaaaaaamaaaaaaaaaaaaaaaaaaaaaaaaaaaaaaaaaaaaaaaaaaaamaaaaaaaaa
aaaaaaaaamaaaaaaaaaaaaaaaaaaaaaaaaaaaaaaaaaaaaaaaaaaaamaaaaaaaaa
aaaaaaaaamaaaaaaaaaaaaaaaaaaaaaaaaaaaaaaaaaaaaaaaaaaaamaaaaaaaaa
aaaaaaaaamaaaaaaaaaaaaaaaaaaaaaaaaaaaaaaaaaaaaaaaaaaaamaaaaaaaaa
aaaaaaaaamaaaaaaaaaaaaaaaaaaaaaaaaaaaaaaaaaaaaaaaaaaaamaaaaaaaaa
aaaaaaaaamaaaaaaaaaaaaaaaaaaaaaaaaaaaaaaaaaaaaaaaaaaaamaaaaaaaaa
aaaaaaaaamaaaaaaaaaaaaaaaaaaaaaaaaaaaaaaaaaaaaaaaaaaaamaaaaaaaaa
aaaaaaaaamaaaaaaaaaaaaaaaaaaahaaaaaaaaaaaaaaaaaaaaaaaamaaaaaaaaa
aaaaaaaaamaaaaaaaaaaaaaaaaaaaaaaaaaaaaaaaaaaaaaaaaaaaamaaaaaaaaa
aaaaaaaaamaaaaaaaaaaaaaaaaaaaaaaaaaaaaaaaaaaaaaaaaaaaamaaaaaaaaa
aaaaaaaaamaaaaaaaaaaaaaaaaaaaaaaaaaaaaaaaaaaaaaaaaaaaamaaaaaaaaa
aaaaaaaaamaaaaaaaaaaaaaaaaaaaaaaaaaaaaaaaaaaaaaaaaaaaamaaaaaaaaa
aaaaaaaaamaaaaaaaaaaaaaaaaaaaaaaaaaaaaaaaaaaaaaaaaaaaamaaaaaaaaa
aaaaaaaaamaaaaaaaaaaaaaaaaaaaaaaaaaaaaaaaaaaaaaaaaaaaamaaaaaaaaa
aaaaaaaaamaaaaaaaaaaaaaaaaaaaaaaaaaaaaaaaaaaaaaaaaaaaamaaaaaaaaa
mmmmmmmmmmaiaaaaaaaaaaaaaaahaaaaaaaaaiaaaaaaaaaaaaaaaammmmmmmmmm
jjjjjjjjjjjjjjjjjjjkjjjjjjjjjjjjjjjjkljjjjjjjjjjjjjjjkjjjjjjjjjj
eeeeeeeeeeeeeeeeeeeeeeeeeeeeneeeeeenoeeeeeeeeeeeeeeeeeeeeeeeeeee
ppppppppppppppppppppppppppppnppppppnoppppppppppppppppppppppppppp
FFFFFFFFFFFFFFFFFFFFFFFFFFFpnppppppnocccccccccFFFFFFFFFFFFFFFFFF
GGGHGGGGGGHGGGGGGHddddddgddqnppBpppnpGHGGGGGGHGGGGGGHGGGGGGGHGGG
pppppppppppppppppppppppppppqnppppppnpppppppppppppppppppppppppppp
eeeeeeeeeeeeeeeeeeeeeeeeeeeqnppppppneeeeeeeeeeeeeeeeeeeeeeeeeeee
jjjjjjjjjjjrjjjjjjjjjjjjjjsrjttttttjjjjjjjjjjrjjjjjjjjjjjjjjjjjj
mmmmmmmmmmaaaaaaaaaaaaaaaaaajbppvvvwaaaaaaaaaaaaaaaaaammmmmmmmmm
aaaaaaaaamaaaaaaaaaaaaaaaaaajbpDfpbxaaaaaaaaaaaaaaaaaamaaaaaaaaa
aaaaaaaaamaaaaaaaaaaaaaaaaaajbpDfpbjaaaaaaaaaaaaaaaaaamaaaaaaaaa
aaaaaaaaamaaaaaaaaaaaaaaaaaajbpEfpbjaaaaaaaaaaaaaaaaaamaaaaaaaaa
aaaaaaaaamaaaaaaaaaaaaaaaaaajbpDfpbjaaaaaaaaaaaaaaaaaamaaaaaaaaa
aaaaaaaaamaaaaaaaaaaaaaaaaaajbpDfpbjaaaaaaaaaaaaaaaaaamaaaaaaaaa
aaaaaaaaamaaaaaaaaaaaaaaaaaajbpDfpbjaaaaaaaaaaaaaaaaaamaaaaaaaaa
aaaaaaaaamaaaaaaaaaaaaaaaaaajbpDfpbjaaaaaaaaaaaaaaaaaamaaaaaaaaa
aaaaaaaaamaaaaaaaaaaaaaaaaaajbpDfpbjaaaaaaaaaaaaaaaaaamaaaaaaaaa
aaaaaaaaamaaaaaaaaaaaaaaaaaaybpDCpbjaaaaaaaaaaaaaaaaaamaaaaaaaaa
aaaaaaaaamaaaaaaaaaaaaaaaaaajbpECpbjaaaaaaaaaaaaaaaaaamaaaaaaaaa
aaaaaaaaamaaaaaaaaaaaaaaaaaajbpDCpbjaaaaaaaaaaaaaaaaaamaaaaaaaaa
aaaaaaaaamaaaaaaaaaaaaaaaaaajbpDCpbjaaaaaaaaaaaaaaaaaamaaaaaaaaa
aaaaaaaaamaaaaaaaaaaaaaaaaaajbpDCpbjaaaaaaaaaaaaaaaaaamaaaaaaaaa
aaaaaaaaamaaaaaaaaaaaaaaaaaajbpDCpbjaaaaaaaaaaaaaaaaaamaaaaaaaaa
aaaaaaaaamazaaaaaaaaaaaaaaaajbpDCpbjazaaaaaaaaaaaaaaaamaaaaaaaaa
aaaaaaaaamaaaaaaaaaaaaaaaaaajbpDCpbjaaaaaaaaaaaaaaaaaamaaaaaaaaa
aaaaaaaaamaaaaaaaaaaaaaaaaaajbpECpbwaaaaaaaaaaaaaaaaaamaaaaaaaaa
aaaaaaaaamaaaaaaaaaaaaaaaaaajbpDCpbjaaaaaaaaaaaaaaaaaamaaaaaaaaa
aaaaaaaaamaaaaaaaaaaaaaaaaaajbpDCpbjaaaaaaaaaaaaaaaaaamaaaaaaaaa
aaaaaaaaamaaaaaaaaaaaaaaaaaajbpDCpbjaaaaaaaaaaaaaaaaaamaaaaaaaaa
aaaaaaaaamaaaaaaaaaaaaaaaaaajbpDCpbjaaaaaaaaaaaaaaaaaamaaaaaaaaa
aaaaaaaaamaaaaaaaaaaaaaaaaaajbpDCpbjaaaaaaaaaaaaaaaaaamaaaaaaaaa
aaaaaaaaamahaaaaaaahaaaaaaaajbpDCpbjahaaaaaaahaaaaaaaamaaaaaaaaa
aaaaaaaaammmmmmmmmmmmmmmmmmmjbpECpbjmmmmmmmmmmmmmmmmmmmaaaaaaaaa
aaaaaaaaaaaaaaaaaaaaaaaaaaamjbpDCpbjmaaaaaaaaaaaaaaaaaaaaaaaaaaa
aaaaaaaaaaaaaaaaaaaaaaaaaaamjbpDCpbjmaaaaaaaaaaaaaaaaaaaaaaaaaaa
aaaaaaaaaaaaaaaaaaaaaaaaaaamjbpDCpbjmaaaaaaaaaaaaaaaaaaaaaaaaaaa
"}
