//MAP CONVERTED BY dmm2tgm.py THIS HEADER COMMENT PREVENTS RECONVERSION, DO NOT REMOVE
"a" = (
/turf/dmm_suite/clear_turf,
/area/dmm_suite/clear_area)
"b" = (
/turf/simulated/wall/metal,
/area/mission/prefab/city/closed_02)
"c" = (
/turf/simulated/floor/plating,
/area/dmm_suite/clear_area)
"d" = (
/obj/structure/interactive/potted_plant/office,
/turf/simulated/floor/plating,
/area/mission/prefab/city/closed_02)
"e" = (
/turf/simulated/floor/plating,
/area/mission/prefab/city/closed_02)
"f" = (
/obj/structure/interactive/wire/green,
/turf/simulated/floor/plating,
/area/mission/prefab/city/closed_02)
"g" = (
/obj/structure/interactive/door/airlock/locked,
/obj/structure/interactive/wire/green,
/turf/simulated/floor/plating,
/area/mission/prefab/city/closed_02)
"h" = (
/obj/structure/interactive/crate/trash,
/turf/simulated/floor/plating,
/area/mission/prefab/city/closed_02)
"i" = (
/obj/structure/interactive/reagent_tank/rolly/ethanol,
/turf/simulated/floor/plating,
/area/mission/prefab/city/closed_02)
"j" = (
/obj/structure/interactive/chair{
	icon_state = "chair";
	dir = 8
	},
/turf/simulated/floor/plating,
/area/mission/prefab/city/closed_02)
"k" = (
/obj/structure/interactive/fence{
	icon_state = "straight";
	dir = 4
	},
/turf/dmm_suite/clear_turf,
/area/dmm_suite/clear_area)
"l" = (
/obj/structure/interactive/fence,
/turf/dmm_suite/clear_turf,
/area/dmm_suite/clear_area)
"m" = (
/obj/marker/spawning/random/maintenance,
/turf/simulated/floor/tile,
/area/mission/prefab/city/closed_02)
"n" = (
/turf/simulated/floor/tile,
/area/mission/prefab/city/closed_02)
"o" = (
/obj/structure/interactive/crate/engineering,
/turf/simulated/floor/plating,
/area/mission/prefab/city/closed_02)
"p" = (
/obj/structure/interactive/chair,
/turf/simulated/floor/plating,
/area/mission/prefab/city/closed_02)
"q" = (
/obj/structure/interactive/fence/corner,
/turf/dmm_suite/clear_turf,
/area/dmm_suite/clear_area)
"r" = (
/obj/structure/interactive/fence/corner{
	icon_state = "corner";
	dir = 10
	},
/turf/dmm_suite/clear_turf,
/area/dmm_suite/clear_area)
"s" = (
/obj/structure/interactive/fence/corner{
	icon_state = "corner";
	dir = 8
	},
/turf/dmm_suite/clear_turf,
/area/dmm_suite/clear_area)
"t" = (
/obj/structure/interactive/fence/corner{
	icon_state = "corner";
	dir = 4
	},
/turf/dmm_suite/clear_turf,
/area/dmm_suite/clear_area)
"u" = (
/obj/structure/interactive/fence/post{
	icon_state = "post";
	dir = 8
	},
/turf/dmm_suite/clear_turf,
/area/dmm_suite/clear_area)
"v" = (
/obj/structure/interactive/fence/door,
/turf/dmm_suite/clear_turf,
/area/dmm_suite/clear_area)
"w" = (
/obj/structure/interactive/fence/post,
/turf/dmm_suite/clear_turf,
/area/dmm_suite/clear_area)
"x" = (
/obj/structure/interactive/fire_closet,
/turf/simulated/wall/metal,
/area/mission/prefab/city/closed_02)
"y" = (
/obj/structure/interactive/crate/engineering,
/turf/simulated/floor/wood/brown,
/area/mission/prefab/city/closed_02)
"z" = (
/obj/marker/spawning/random/maintenance,
/turf/simulated/floor/plating,
/area/mission/prefab/city/closed_02)
"A" = (
/obj/structure/interactive/wire/green,
/turf/simulated/floor/plating,
/area/dmm_suite/clear_area)
"B" = (
/obj/marker/spawning/random/maintenance,
/turf/simulated/floor/wood/brown,
/area/mission/prefab/city/closed_02)
"C" = (
/obj/structure/table/wood,
/turf/simulated/floor/wood/brown,
/area/mission/prefab/city/closed_02)
"D" = (
/obj/marker/spawning/random/maintenance,
/turf/simulated/floor/plating,
/area/dmm_suite/clear_area)
"E" = (
/obj/structure/carpet/red,
/turf/simulated/floor/wood/brown,
/area/mission/prefab/city/closed_02)
"F" = (
/turf/simulated/floor/wood/brown,
/area/mission/prefab/city/closed_02)
"G" = (
/obj/marker/spawning/window,
/turf/simulated/floor/plating,
/area/mission/prefab/city/closed_02)
"H" = (
/obj/structure/interactive/ore_box,
/turf/simulated/floor/plating,
/area/mission/prefab/city/closed_02)
"I" = (
/obj/structure/table/wood,
/turf/simulated/floor/plating,
/area/mission/prefab/city/closed_02)
"J" = (
/obj/structure/interactive/door/airlock/locked,
/turf/simulated/floor/plating,
/area/mission/prefab/city/closed_02)
"K" = (
/obj/structure/interactive/bar_sign,
/turf/simulated/wall/metal,
/area/mission/prefab/city/closed_02)

(1,1,1) = {"
s
l
l
w
l
l
w
l
l
w
l
l
w
l
l
r
"}
(2,1,1) = {"
k
b
b
b
b
b
b
b
b
b
b
G
G
G
b
k
"}
(3,1,1) = {"
k
b
d
e
h
b
p
z
z
e
e
e
e
z
G
k
"}
(4,1,1) = {"
u
b
e
e
e
e
e
e
e
e
e
e
e
e
G
k
"}
(5,1,1) = {"
k
b
f
f
i
b
o
e
e
F
F
e
e
o
G
k
"}
(6,1,1) = {"
k
b
f
e
j
b
o
B
F
F
F
H
e
b
b
k
"}
(7,1,1) = {"
u
b
g
b
b
b
x
C
C
C
B
b
e
J
a
v
"}
(8,1,1) = {"
k
c
A
b
m
m
b
E
E
C
B
b
e
K
a
k
"}
(9,1,1) = {"
k
c
A
b
n
m
b
E
E
C
F
b
e
b
a
k
"}
(10,1,1) = {"
u
c
A
b
e
n
b
E
E
C
B
b
e
J
a
k
"}
(11,1,1) = {"
k
c
A
b
e
b
b
F
C
C
F
e
e
b
b
k
"}
(12,1,1) = {"
k
c
D
b
e
e
y
F
F
F
F
e
e
e
G
k
"}
(13,1,1) = {"
v
c
D
b
e
e
e
e
e
e
F
e
e
I
G
k
"}
(14,1,1) = {"
k
c
D
b
o
d
e
e
e
e
e
z
I
I
G
k
"}
(15,1,1) = {"
k
c
D
b
b
b
b
b
b
b
b
G
G
G
b
k
"}
(16,1,1) = {"
t
l
l
w
l
l
w
l
l
w
l
l
w
l
l
q
"}
