//MAP CONVERTED BY dmm2tgm.py THIS HEADER COMMENT PREVENTS RECONVERSION, DO NOT REMOVE
"a" = (
/turf/dmm_suite/clear_turf,
/area/dmm_suite/clear_area)
"b" = (
/turf/simulated/wall/metal,
/area/mission/prefab/city/closed_01)
"c" = (
/turf/simulated/floor/plating,
/area/dmm_suite/clear_area)
"d" = (
/obj/structure/table/steel,
/turf/simulated/floor/plating,
/area/mission/prefab/city/closed_01)
"e" = (
/obj/structure/interactive/potted_plant/bin,
/turf/simulated/floor/plating,
/area/mission/prefab/city/closed_01)
"f" = (
/turf/simulated/floor/plating,
/area/mission/prefab/city/closed_01)
"g" = (
/obj/structure/interactive/power/apc,
/turf/simulated/wall/metal,
/area/mission/prefab/city/closed_01)
"h" = (
/obj/structure/interactive/door/airlock/locked,
/obj/structure/interactive/wire/green,
/turf/simulated/floor/plating,
/area/mission/prefab/city/closed_01)
"i" = (
/obj/structure/interactive/wire/green,
/turf/simulated/floor/plating,
/area/mission/prefab/city/closed_01)
"j" = (
/obj/structure/interactive/fence/corner{
	icon_state = "corner";
	dir = 8
	},
/turf/dmm_suite/no_wall,
/area/dmm_suite/clear_area)
"k" = (
/obj/structure/interactive/fence{
	icon_state = "straight";
	dir = 4
	},
/turf/dmm_suite/no_wall,
/area/dmm_suite/clear_area)
"l" = (
/obj/structure/interactive/fence/post{
	icon_state = "post";
	dir = 8
	},
/turf/dmm_suite/no_wall,
/area/dmm_suite/clear_area)
"m" = (
/obj/structure/interactive/fence/door,
/turf/dmm_suite/no_wall,
/area/dmm_suite/clear_area)
"n" = (
/obj/structure/interactive/fence/corner{
	icon_state = "corner";
	dir = 4
	},
/turf/dmm_suite/no_wall,
/area/dmm_suite/clear_area)
"o" = (
/obj/structure/interactive/fence,
/turf/dmm_suite/no_wall,
/area/dmm_suite/clear_area)
"p" = (
/obj/structure/interactive/fence/post{
	icon_state = "post";
	dir = 1
	},
/turf/dmm_suite/no_wall,
/area/dmm_suite/clear_area)
"q" = (
/turf/dmm_suite/no_wall,
/area/dmm_suite/clear_area)
"r" = (
/obj/structure/interactive/fence/corner{
	icon_state = "corner";
	dir = 10
	},
/turf/dmm_suite/no_wall,
/area/dmm_suite/clear_area)
"s" = (
/obj/structure/interactive/solar_panel,
/obj/structure/interactive/wire/yellow,
/turf/simulated/floor/plating,
/area/dmm_suite/clear_area)
"t" = (
/obj/structure/interactive/crate/engineering,
/turf/simulated/floor/plating,
/area/mission/prefab/city/closed_01)
"u" = (
/obj/structure/interactive/wire/yellow,
/turf/simulated/floor/plating,
/area/dmm_suite/clear_area)
"v" = (
/obj/structure/interactive/wire/green,
/obj/structure/interactive/power/smes{
	icon_state = "smes_map";
	dir = 8
	},
/turf/simulated/floor/plating,
/area/dmm_suite/clear_area)
"w" = (
/obj/structure/interactive/crate/trash,
/turf/simulated/floor/plating,
/area/mission/prefab/city/closed_01)
"x" = (
/obj/structure/interactive/wire/green,
/turf/simulated/floor/plating,
/area/dmm_suite/clear_area)
"y" = (
/obj/structure/interactive/fence/corner{
	icon_state = "corner";
	dir = 6
	},
/turf/dmm_suite/no_wall,
/area/dmm_suite/clear_area)
"z" = (
/obj/structure/interactive/construction/grille,
/turf/simulated/floor/plating,
/area/mission/prefab/city/closed_01)
"A" = (
/obj/marker/spawning/window/reinforced,
/turf/simulated/floor/plating,
/area/mission/prefab/city/closed_01)
"B" = (
/obj/structure/interactive/fire_closet{
	icon_state = "extinguisher";
	dir = 1
	},
/turf/simulated/wall/metal,
/area/mission/prefab/city/closed_01)
"C" = (
/obj/structure/interactive/door/airlock/locked,
/turf/simulated/floor/plating,
/area/mission/prefab/city/closed_01)
"D" = (
/obj/structure/interactive/bar_sign,
/turf/simulated/wall/metal,
/area/mission/prefab/city/closed_01)
"E" = (
/obj/marker/spawning/random/maintenance,
/turf/simulated/floor/plating,
/area/mission/prefab/city/closed_01)
"F" = (
/obj/marker/spawning/random/maintenance,
/turf/simulated/floor/plating,
/area/dmm_suite/clear_area)

(1,1,1) = {"
j
o
o
p
o
p
o
o
o
o
p
o
o
p
o
r
"}
(2,1,1) = {"
k
a
a
a
a
b
b
b
b
b
b
b
b
b
b
k
"}
(3,1,1) = {"
k
b
b
b
b
b
w
E
d
d
d
d
d
t
D
k
"}
(4,1,1) = {"
l
b
d
E
E
t
f
f
f
f
f
f
f
t
b
l
"}
(5,1,1) = {"
k
b
d
f
f
f
f
f
f
f
f
f
f
B
b
k
"}
(6,1,1) = {"
k
b
d
f
f
f
f
f
f
E
E
E
f
C
q
k
"}
(7,1,1) = {"
k
b
e
f
f
f
f
f
f
E
E
f
f
C
q
m
"}
(8,1,1) = {"
l
b
b
g
i
i
f
f
f
f
f
f
f
b
b
k
"}
(9,1,1) = {"
k
s
s
b
b
i
b
b
t
f
f
f
f
z
A
k
"}
(10,1,1) = {"
k
c
u
b
f
i
E
b
t
f
f
f
t
z
A
k
"}
(11,1,1) = {"
k
c
u
b
f
i
E
b
E
f
f
b
b
b
b
l
"}
(12,1,1) = {"
m
c
v
b
f
i
t
b
E
f
f
f
f
E
b
k
"}
(13,1,1) = {"
k
c
x
h
i
i
d
b
z
z
z
b
f
E
b
k
"}
(14,1,1) = {"
k
c
F
b
f
f
d
b
A
A
A
b
E
E
b
l
"}
(15,1,1) = {"
k
c
F
b
b
b
b
b
q
q
q
b
b
b
b
k
"}
(16,1,1) = {"
n
o
o
p
o
o
o
o
p
o
o
p
o
o
o
y
"}
