"a" = (/turf/dmm_suite/clear_turf,/area/dmm_suite/clear_area)
"b" = (/turf/simulated/wall/metal,/area/mission/prefab/city/closed_02)
"c" = (/turf/simulated/floor/plating,/area/dmm_suite/clear_area)
"d" = (/obj/structure/interactive/potted_plant/office,/turf/simulated/floor/plating,/area/mission/prefab/city/closed_02)
"e" = (/turf/simulated/floor/plating,/area/mission/prefab/city/closed_02)
"f" = (/obj/structure/interactive/wire/green,/turf/simulated/floor/plating,/area/mission/prefab/city/closed_02)
"g" = (/obj/structure/interactive/door/airlock/locked,/obj/structure/interactive/wire/green,/turf/simulated/floor/plating,/area/mission/prefab/city/closed_02)
"h" = (/obj/structure/interactive/crate/trash,/turf/simulated/floor/plating,/area/mission/prefab/city/closed_02)
"i" = (/obj/structure/interactive/reagent_tank/rolly/ethanol,/turf/simulated/floor/plating,/area/mission/prefab/city/closed_02)
"j" = (/obj/structure/interactive/chair{icon_state = "chair"; dir = 8},/turf/simulated/floor/plating,/area/mission/prefab/city/closed_02)
"k" = (/obj/structure/interactive/fence{icon_state = "straight"; dir = 4},/turf/dmm_suite/clear_turf,/area/dmm_suite/clear_area)
"l" = (/obj/structure/interactive/fence,/turf/dmm_suite/clear_turf,/area/dmm_suite/clear_area)
"m" = (/obj/marker/spawning/random/maintenance,/turf/simulated/floor/tile,/area/mission/prefab/city/closed_02)
"n" = (/turf/simulated/floor/tile,/area/mission/prefab/city/closed_02)
"o" = (/obj/structure/interactive/crate/engineering,/turf/simulated/floor/plating,/area/mission/prefab/city/closed_02)
"p" = (/obj/structure/interactive/chair,/turf/simulated/floor/plating,/area/mission/prefab/city/closed_02)
"q" = (/obj/structure/interactive/fence/corner,/turf/dmm_suite/clear_turf,/area/dmm_suite/clear_area)
"r" = (/obj/structure/interactive/fence/corner{icon_state = "corner"; dir = 10},/turf/dmm_suite/clear_turf,/area/dmm_suite/clear_area)
"s" = (/obj/structure/interactive/fence/corner{icon_state = "corner"; dir = 8},/turf/dmm_suite/clear_turf,/area/dmm_suite/clear_area)
"t" = (/obj/structure/interactive/fence/corner{icon_state = "corner"; dir = 4},/turf/dmm_suite/clear_turf,/area/dmm_suite/clear_area)
"u" = (/obj/structure/interactive/fence/post{icon_state = "post"; dir = 8},/turf/dmm_suite/clear_turf,/area/dmm_suite/clear_area)
"v" = (/obj/structure/interactive/fence/door,/turf/dmm_suite/clear_turf,/area/dmm_suite/clear_area)
"w" = (/obj/structure/interactive/fence/post,/turf/dmm_suite/clear_turf,/area/dmm_suite/clear_area)
"x" = (/obj/structure/interactive/fire_closet,/turf/simulated/wall/metal,/area/mission/prefab/city/closed_02)
"y" = (/obj/structure/interactive/crate/engineering,/turf/simulated/floor/wood/brown,/area/mission/prefab/city/closed_02)
"z" = (/obj/marker/spawning/random/maintenance,/turf/simulated/floor/plating,/area/mission/prefab/city/closed_02)
"A" = (/obj/structure/interactive/wire/green,/turf/simulated/floor/plating,/area/dmm_suite/clear_area)
"B" = (/obj/marker/spawning/random/maintenance,/turf/simulated/floor/wood/brown,/area/mission/prefab/city/closed_02)
"C" = (/obj/structure/table/wood,/turf/simulated/floor/wood/brown,/area/mission/prefab/city/closed_02)
"D" = (/obj/marker/spawning/random/maintenance,/turf/simulated/floor/plating,/area/dmm_suite/clear_area)
"E" = (/obj/structure/carpet/red,/turf/simulated/floor/wood/brown,/area/mission/prefab/city/closed_02)
"F" = (/turf/simulated/floor/wood/brown,/area/mission/prefab/city/closed_02)
"G" = (/obj/marker/spawning/window,/turf/simulated/floor/plating,/area/mission/prefab/city/closed_02)
"H" = (/obj/structure/interactive/ore_box,/turf/simulated/floor/plating,/area/mission/prefab/city/closed_02)
"I" = (/obj/structure/table/wood,/turf/simulated/floor/plating,/area/mission/prefab/city/closed_02)
"J" = (/obj/structure/interactive/door/airlock/locked,/turf/simulated/floor/plating,/area/mission/prefab/city/closed_02)
"K" = (/obj/structure/interactive/bar_sign,/turf/simulated/wall/metal,/area/mission/prefab/city/closed_02)
"L" = (/mob/living/advanced/npc/bandit,/turf/simulated/floor/plating,/area/mission/prefab/city/closed_02)

(1,1,1) = {"
skkukkukkukkvkkt
lbbbbbbccccccccl
lbdeffgAAAADDDDl
wbLefebbbbbbbbbw
lbheijbmneeeLobl
lbbebbbmmnbeedbl
wbpeooxbbbbyeebw
lbzeLBCEEEFFeebl
lbzeeFCEEECFeebl
wbeeFFCCCCCFeebw
lbeeFFBBFBFFFebl
lGeeeHbbbbeeezGl
wGeeeeeeeeeeeIGw
lGzeobJKbJbeIIGl
lbGGGbaaaabGGGbl
rkkkkkvkkkkkkkkq
"}
