"aa" = (/turf/dmm_suite/no_wall,/area/dmm_suite/clear_area)
"ab" = (/turf/simulated/wall/metal,/area/mission/prefab/city/die_lab/backroom)
"ac" = (/obj/structure/interactive/solar_panel,/obj/structure/interactive/wire/yellow,/turf/simulated/floor/plating,/area/mission/prefab/city/die_lab)
"ad" = (/obj/structure/interactive/wire/yellow,/obj/marker/smart_clear_turf,/obj/marker/map_node,/obj/marker/smart_clear_turf,/turf/simulated/floor/plating,/area/mission/prefab/city/die_lab)
"ae" = (/mob/living/simple/slime/water,/turf/simulated/floor/plating/reinforced,/area/mission/prefab/city/die_lab)
"af" = (/mob/living/simple/slime/blood,/obj/structure/interactive/lighting/fixture/bulb,/turf/simulated/floor/plating/reinforced,/area/mission/prefab/city/die_lab)
"ag" = (/obj/structure/interactive/fence/end{icon_state = "end"; dir = 1},/turf/simulated/floor/plating/reinforced,/area/mission/prefab/city/die_lab)
"ah" = (/obj/marker/spawning/random/maintenance,/turf/simulated/floor/plating,/area/mission/prefab/city/die_lab)
"ai" = (/obj/structure/interactive/light_switch,/turf/simulated/wall/metal,/area/mission/prefab/city/die_lab)
"aj" = (/obj/decal/poster/off_station,/turf/simulated/wall/metal,/area/mission/prefab/city/die_lab)
"ak" = (/obj/structure/interactive/wire/yellow,/obj/structure/interactive/door/airlock/locked,/turf/simulated/floor/plating,/area/mission/prefab/city/die_lab)
"al" = (/obj/structure/sign/shock,/turf/simulated/wall/metal,/area/mission/prefab/city/die_lab)
"am" = (/obj/structure/interactive/power/apc,/turf/simulated/wall/metal,/area/mission/prefab/city/die_lab)
"an" = (/obj/marker/spawning/random/maintenance,/turf/simulated/floor/plating/reinforced,/area/mission/prefab/city/die_lab)
"ao" = (/mob/living/advanced/npc/monkey,/turf/simulated/floor/plating/reinforced,/area/mission/prefab/city/die_lab)
"ap" = (/obj/marker/spawning/random/trash,/turf/simulated/floor/plating/reinforced,/area/mission/prefab/city/die_lab)
"aq" = (/turf/simulated/floor/plating/reinforced,/area/mission/prefab/city/die_lab)
"ar" = (/obj/structure/interactive/fence,/turf/simulated/floor/plating/reinforced,/area/mission/prefab/city/die_lab)
"as" = (/obj/marker/mission_mob,/turf/simulated/floor/plating,/area/mission/prefab/city/die_lab)
"at" = (/obj/structure/interactive/chair/comfy,/turf/simulated/floor/plating,/area/mission/prefab/city/die_lab)
"au" = (/obj/structure/interactive/potted_plant/bin,/obj/marker/cover_node/right{icon_state = "right"; dir = 1},/turf/simulated/floor/plating,/area/mission/prefab/city/die_lab)
"av" = (/obj/structure/interactive/wire/yellow,/obj/marker/map_node,/turf/simulated/floor/plating,/area/mission/prefab/city/die_lab)
"aw" = (/obj/structure/interactive/wire/yellow,/obj/marker/cover_node/left{icon_state = "left"; dir = 1},/turf/simulated/floor/plating,/area/mission/prefab/city/die_lab)
"ax" = (/obj/structure/interactive/power/smes{icon_state = "smes_map"; dir = 8},/obj/structure/interactive/wire/green,/turf/simulated/floor/plating,/area/mission/prefab/city/die_lab)
"ay" = (/obj/structure/interactive/wire/green,/turf/simulated/floor/plating,/area/mission/prefab/city/die_lab)
"az" = (/obj/marker/spawning/random/food,/turf/simulated/floor/plating,/area/mission/prefab/city/die_lab)
"aA" = (/obj/structure/interactive/fence/door{icon_state = "door_opened"; dir = 8},/turf/simulated/floor/plating/reinforced,/area/mission/prefab/city/die_lab)
"aB" = (/turf/simulated/wall/metal,/area/mission/prefab/city/die_lab)
"aC" = (/obj/marker/spawning/random/dangerous,/turf/simulated/floor/plating/reinforced,/area/mission/prefab/city/die_lab)
"aD" = (/mob/living/simple/slime/jungle,/turf/simulated/floor/plating/reinforced,/area/mission/prefab/city/die_lab)
"aE" = (/turf/simulated/floor/plating,/area/mission/prefab/city/die_lab)
"aF" = (/obj/marker/mission_corpse,/turf/simulated/floor/plating/reinforced,/area/mission/prefab/city/die_lab)
"aG" = (/obj/structure/interactive/fence/end,/turf/simulated/floor/plating/reinforced,/area/mission/prefab/city/die_lab)
"aH" = (/obj/structure/interactive/crate/trash,/obj/marker/spawning/random/trash,/turf/simulated/floor/plating,/area/mission/prefab/city/die_lab)
"aI" = (/obj/structure/interactive/lighting/fixture/bulb{icon_state = "preview"; dir = 1},/turf/simulated/floor/plating,/area/mission/prefab/city/die_lab)
"aJ" = (/obj/marker/map_node,/turf/simulated/floor/plating,/area/mission/prefab/city/die_lab)
"aK" = (/obj/structure/interactive/storage/safe,/turf/simulated/floor/plating,/area/mission/prefab/city/die_lab)
"aL" = (/mob/living/simple/slime/magma,/obj/structure/interactive/lighting/fixture/bulb{icon_state = "preview"; dir = 1},/turf/simulated/floor/plating/reinforced,/area/mission/prefab/city/die_lab)
"aM" = (/mob/living/advanced/npc/monkey{icon_state = "directional"; dir = 8},/turf/simulated/floor/plating/reinforced,/area/mission/prefab/city/die_lab)
"aN" = (/obj/structure/interactive/door/airlock/locked,/turf/simulated/floor/tile/grey,/area/mission/prefab/city/die_lab)
"aO" = (/obj/structure/sign/secure,/turf/simulated/wall/metal,/area/mission/prefab/city/die_lab)
"aP" = (/obj/structure/table,/obj/item/slime_core/red,/turf/simulated/floor/tile/grey,/area/mission/prefab/city/die_lab/backroom)
"aQ" = (/turf/simulated/floor/tile/grey,/area/mission/prefab/city/die_lab/backroom)
"aR" = (/obj/structure/carpet/red,/turf/simulated/floor/tile/grey,/area/mission/prefab/city/die_lab/backroom)
"aS" = (/obj/structure/table/reinforced/steel,/obj/structure/carpet/red,/turf/simulated/floor/tile/grey,/area/mission/prefab/city/die_lab/backroom)
"aT" = (/obj/structure/interactive/storage/safe,/obj/structure/carpet/red,/obj/structure/interactive/crate/trash,/obj/marker/spawning/random/trash,/turf/simulated/floor/tile/grey,/area/mission/prefab/city/die_lab/backroom)
"aU" = (/obj/structure/carpet/red,/obj/marker/map_node,/turf/simulated/floor/tile/grey,/area/mission/prefab/city/die_lab/backroom)
"aV" = (/obj/marker/map_node,/turf/simulated/floor/tile/grey,/area/mission/prefab/city/die_lab/backroom)
"aW" = (/obj/structure/table,/obj/item/slime_core/black/weak,/turf/simulated/floor/tile/grey,/area/mission/prefab/city/die_lab/backroom)
"aX" = (/obj/structure/interactive/lighting/fixture/tube{icon_state = "preview"; dir = 4},/obj/structure/table,/obj/item/slime_core/red,/turf/simulated/floor/tile/grey,/area/mission/prefab/city/die_lab/backroom)
"aY" = (/obj/structure/table/reinforced/steel,/obj/structure/interactive/storage/cash_register{icon_state = "register"; dir = 4},/obj/structure/carpet/red,/turf/simulated/floor/tile/grey,/area/mission/prefab/city/die_lab/backroom)
"aZ" = (/obj/marker/mission_mob{icon_state = "directional"; dir = 8},/turf/simulated/floor/tile/grey,/area/mission/prefab/city/die_lab/backroom)
"ba" = (/obj/structure/interactive/lighting/fixture/tube{icon_state = "preview"; dir = 8},/obj/structure/table,/obj/item/slime_core/black,/turf/simulated/floor/tile/grey,/area/mission/prefab/city/die_lab/backroom)
"bb" = (/obj/marker/spawning/window,/turf/simulated/floor/plating,/area/mission/prefab/city/die_lab/backroom)
"bc" = (/obj/structure/table,/obj/item/slime_core/green,/turf/simulated/floor/tile/grey,/area/mission/prefab/city/die_lab/backroom)
"bd" = (/obj/structure/table/reinforced/steel,/obj/structure/carpet/red,/obj/item/slime_core/custom,/turf/simulated/floor/tile/grey,/area/mission/prefab/city/die_lab/backroom)
"be" = (/obj/structure/table,/obj/item/slime_core/black/strong,/turf/simulated/floor/tile/grey,/area/mission/prefab/city/die_lab/backroom)
"bf" = (/obj/marker/smart_clear_turf,/turf/dmm_suite/no_wall,/area/dmm_suite/clear_area)
"bg" = (/obj/structure/table,/obj/item/slime_core/custom,/turf/simulated/floor/tile/grey,/area/mission/prefab/city/die_lab/backroom)
"bh" = (/obj/structure/table,/obj/item/slime_core/blue,/turf/simulated/floor/tile/grey,/area/mission/prefab/city/die_lab/backroom)
"bi" = (/obj/marker/map_node/x2,/turf/simulated/floor/tile/grey,/area/mission/prefab/city/die_lab/backroom)
"bj" = (/obj/marker/mission_mob{icon_state = "directional"; dir = 4},/turf/simulated/floor/tile/grey,/area/mission/prefab/city/die_lab/backroom)
"bk" = (/obj/structure/table,/obj/item/slime_core/white/strong,/turf/simulated/floor/tile/grey,/area/mission/prefab/city/die_lab/backroom)
"bl" = (/obj/structure/interactive/lighting/fixture/tube{icon_state = "preview"; dir = 4},/obj/structure/table,/obj/item/slime_core/white,/turf/simulated/floor/tile/grey,/area/mission/prefab/city/die_lab/backroom)
"bm" = (/obj/structure/interactive/fire_closet{icon_state = "extinguisher"; dir = 1},/turf/simulated/wall/metal,/area/mission/prefab/city/die_lab/backroom)
"bn" = (/obj/structure/interactive/fire_closet{icon_state = "extinguisher"; dir = 1},/turf/simulated/wall/metal,/area/mission/prefab/city/die_lab)
"bo" = (/obj/structure/carpet/grey,/turf/simulated/floor/tile/grey,/area/mission/prefab/city/die_lab/backroom)
"bp" = (/obj/structure/interactive/lighting/fixture/tube{icon_state = "preview"; dir = 8},/obj/structure/table,/obj/item/slime_core/white,/turf/simulated/floor/tile/grey,/area/mission/prefab/city/die_lab/backroom)
"bq" = (/obj/structure/table,/obj/item/slime_core/white,/turf/simulated/floor/tile/grey,/area/mission/prefab/city/die_lab/backroom)
"br" = (/obj/structure/carpet/grey,/obj/marker/map_node,/turf/simulated/floor/tile/grey,/area/mission/prefab/city/die_lab/backroom)
"bs" = (/obj/structure/interactive/potted_plant/bin,/obj/marker/cover_node/left,/turf/simulated/floor/tile/grey,/area/mission/prefab/city/die_lab/backroom)
"bt" = (/obj/structure/table,/obj/item/slime_core/white/weak,/turf/simulated/floor/tile/grey,/area/mission/prefab/city/die_lab/backroom)
"bu" = (/obj/structure/interactive/door/airlock/glass,/turf/simulated/floor/tile/grey,/area/mission/prefab/city/die_lab/backroom)
"bv" = (/obj/structure/interactive/bar_sign/die_lab,/turf/simulated/wall/metal,/area/mission/prefab/city/die_lab/backroom)
"bw" = (/obj/marker/smart_clear_turf,/obj/marker/map_node,/obj/marker/smart_clear_turf,/turf/dmm_suite/no_wall,/area/dmm_suite/clear_area)
"bx" = (/obj/structure/carpet/red,/obj/marker/mission_mob,/turf/simulated/floor/tile/grey,/area/mission/prefab/city/die_lab/backroom)
"by" = (/obj/marker/mission_mob,/turf/simulated/floor/tile/grey,/area/mission/prefab/city/die_lab/backroom)
"bz" = (/obj/structure/carpet/grey,/obj/marker/cover_node,/turf/simulated/floor/tile/grey,/area/mission/prefab/city/die_lab/backroom)
"bA" = (/obj/structure/carpet/grey,/obj/marker/cover_node/right,/turf/simulated/floor/tile/grey,/area/mission/prefab/city/die_lab/backroom)
"bB" = (/obj/marker/cover_node/right,/turf/simulated/floor/plating,/area/mission/prefab/city/die_lab)
"bC" = (/obj/marker/cover_node/left,/turf/simulated/floor/plating,/area/mission/prefab/city/die_lab)
"bD" = (/obj/marker/cover_node/left{icon_state = "left"; dir = 8},/turf/simulated/floor/tile/grey,/area/mission/prefab/city/die_lab/backroom)
"bE" = (/obj/marker/cover_node/left{icon_state = "left"; dir = 4},/turf/simulated/floor/tile/grey,/area/mission/prefab/city/die_lab/backroom)
"bF" = (/obj/marker/mission_mob{icon_state = "directional"; dir = 8},/obj/marker/cover_node/right{icon_state = "right"; dir = 4},/turf/simulated/floor/tile/grey,/area/mission/prefab/city/die_lab/backroom)
"bG" = (/obj/marker/cover_node/right{icon_state = "right"; dir = 8},/turf/simulated/floor/tile/grey,/area/mission/prefab/city/die_lab/backroom)
"bH" = (/mob/living/advanced/npc/monkey{icon_state = "directional"; dir = 1},/obj/structure/interactive/lighting/fixture/bulb{icon_state = "preview"; dir = 1},/turf/simulated/floor/plating/reinforced,/area/mission/prefab/city/die_lab)
"bI" = (/obj/marker/mission_corpse,/turf/simulated/floor/tile/grey,/area/mission/prefab/city/die_lab/backroom)

(1,1,1) = {"
aBaBaBaBaBaBacadacacaBaBaBaBaBaB
aBaeafagahaiajakalaBamahaganaoaB
aBapaFarasatauavawaxayazaAapaCaB
aBaDaqaAaEaEaEaEaEaEaEaEaraCapaB
aBanaLaGaHaIbCaJbBaKaIazaGbHaMaB
aBaBaBajajaBbnaNaOaiaBaBajaBaBaB
aaabaPaQaRaSaTaUaRaRaRaVaQaWabaa
aaabaXbDaRaYbxaRbxaSaRbIbFbaabaa
aabbbcaQaRaSaSaSbdbdaRaQaQbebbaa
bfbbbcbIaRaRaRaRaRaRaRaQaQbgbbbf
aabbbhaQaQaQaQaQaQaQaQbiaQbgbbaa
aabbbhaQbjaQaQbiaQaQaQaQaQbkbbaa
aaabblbGaQbyboboboaQaQaQbEbpabaa
aaabbqaQaQaQbzbrbAbsaQaZaQbtabaa
aaabbbbbbbbbbmbubvabbbbbbbbbabaa
aaaaaabfaaaaaabwaaaaaaaabfaaaaaa
"}
