"aa" = (/turf/dmm_suite/no_wall,/area/dmm_suite/clear_area)
"ab" = (/turf/simulated/wall/metal,/area/mission/prefab/city/die_lab/backroom)
"ac" = (/obj/structure/interactive/solar_panel,/obj/structure/interactive/wire/yellow,/turf/simulated/floor/plating,/area/mission/prefab/city/die_lab/backroom)
"ad" = (/obj/structure/interactive/wire/yellow,/turf/simulated/floor/plating,/area/mission/prefab/city/die_lab/backroom)
"ae" = (/mob/living/simple/slime/water,/turf/simulated/floor/plating/reinforced,/area/mission/prefab/city/die_lab/backroom)
"af" = (/obj/structure/interactive/lighting/fixture/bulb,/mob/living/simple/slime/blood,/turf/simulated/floor/plating/reinforced,/area/mission/prefab/city/die_lab/backroom)
"ag" = (/obj/structure/interactive/fence/end{icon_state = "end"; dir = 1},/turf/simulated/floor/plating/reinforced,/area/mission/prefab/city/die_lab/backroom)
"ah" = (/obj/structure/interactive/storage/trash_pile,/turf/simulated/floor/plating,/area/mission/prefab/city/die_lab/backroom)
"ai" = (/obj/structure/interactive/light_switch,/turf/simulated/wall/metal,/area/mission/prefab/city/die_lab/backroom)
"aj" = (/obj/structure/interactive/wire/yellow,/obj/structure/interactive/door/airlock/locked,/turf/simulated/floor/plating,/area/mission/prefab/city/die_lab/backroom)
"ak" = (/obj/structure/interactive/power/apc,/turf/simulated/wall/metal,/area/mission/prefab/city/die_lab/backroom)
"al" = (/obj/structure/interactive/storage/trash_pile,/obj/structure/interactive/lighting/fixture/bulb,/turf/simulated/floor/plating/reinforced,/area/mission/prefab/city/die_lab/backroom)
"am" = (/mob/living/advanced/npc/monkey,/turf/simulated/floor/plating/reinforced,/area/mission/prefab/city/die_lab/backroom)
"an" = (/turf/simulated/floor/plating/reinforced,/area/mission/prefab/city/die_lab/backroom)
"ao" = (/obj/structure/interactive/fence,/turf/simulated/floor/plating/reinforced,/area/mission/prefab/city/die_lab/backroom)
"ap" = (/turf/simulated/floor/plating,/area/mission/prefab/city/die_lab/backroom)
"aq" = (/obj/structure/interactive/power/smes{icon_state = "smes_map"; dir = 8},/obj/structure/interactive/wire/green,/turf/simulated/floor/plating,/area/mission/prefab/city/die_lab/backroom)
"ar" = (/obj/structure/interactive/wire/green,/turf/simulated/floor/plating,/area/mission/prefab/city/die_lab/backroom)
"as" = (/obj/structure/interactive/fence/door{icon_state = "door_opened"; dir = 8},/turf/simulated/floor/plating/reinforced,/area/mission/prefab/city/die_lab/backroom)
"at" = (/mob/living/simple/slime/jungle,/turf/simulated/floor/plating/reinforced,/area/mission/prefab/city/die_lab/backroom)
"au" = (/obj/structure/interactive/storage/trash_pile,/turf/simulated/floor/plating/reinforced,/area/mission/prefab/city/die_lab/backroom)
"av" = (/obj/structure/interactive/lighting/fixture/bulb{icon_state = "preview"; dir = 1},/mob/living/simple/slime/magma,/turf/simulated/floor/plating/reinforced,/area/mission/prefab/city/die_lab/backroom)
"aw" = (/obj/structure/interactive/fence/end,/turf/simulated/floor/plating/reinforced,/area/mission/prefab/city/die_lab/backroom)
"ax" = (/obj/structure/interactive/lighting/fixture/bulb{icon_state = "preview"; dir = 1},/turf/simulated/floor/plating,/area/mission/prefab/city/die_lab/backroom)
"ay" = (/obj/structure/interactive/lighting/fixture/bulb{icon_state = "preview"; dir = 1},/mob/living/advanced/npc/monkey{icon_state = "directional"; dir = 1},/turf/simulated/floor/plating/reinforced,/area/mission/prefab/city/die_lab/backroom)
"az" = (/mob/living/advanced/npc/monkey{icon_state = "directional"; dir = 8},/turf/simulated/floor/plating/reinforced,/area/mission/prefab/city/die_lab/backroom)
"aA" = (/obj/structure/interactive/door/airlock/locked,/turf/simulated/floor/tile/grey,/area/mission/prefab/city/die_lab/backroom)
"aB" = (/turf/simulated/wall/metal,/area/mission/prefab/city/die_lab)
"aC" = (/obj/structure/table,/obj/item/slime_core/red,/turf/simulated/floor/tile/grey,/area/mission/prefab/city/die_lab)
"aD" = (/turf/simulated/floor/tile/grey,/area/mission/prefab/city/die_lab)
"aE" = (/obj/structure/carpet/red,/turf/simulated/floor/tile/grey,/area/mission/prefab/city/die_lab)
"aF" = (/obj/structure/table/reinforced/steel,/obj/structure/carpet/red,/turf/simulated/floor/tile/grey,/area/mission/prefab/city/die_lab)
"aG" = (/obj/structure/interactive/storage/safe,/obj/structure/carpet/red,/turf/simulated/floor/tile/grey,/area/mission/prefab/city/die_lab)
"aH" = (/obj/structure/table,/obj/item/slime_core/black/weak,/turf/simulated/floor/tile/grey,/area/mission/prefab/city/die_lab)
"aI" = (/obj/structure/interactive/lighting/fixture/tube{icon_state = "preview"; dir = 4},/obj/structure/table,/obj/item/slime_core/red,/turf/simulated/floor/tile/grey,/area/mission/prefab/city/die_lab)
"aJ" = (/obj/structure/table/reinforced/steel,/obj/structure/interactive/storage/cash_register{icon_state = "register"; dir = 4},/obj/structure/carpet/red,/turf/simulated/floor/tile/grey,/area/mission/prefab/city/die_lab)
"aK" = (/obj/structure/interactive/lighting/fixture/tube{icon_state = "preview"; dir = 8},/obj/structure/table,/obj/item/slime_core/black,/turf/simulated/floor/tile/grey,/area/mission/prefab/city/die_lab)
"aL" = (/obj/marker/spawning/window,/turf/simulated/floor/plating,/area/mission/prefab/city/die_lab)
"aM" = (/obj/structure/table,/obj/item/slime_core/green,/turf/simulated/floor/tile/grey,/area/mission/prefab/city/die_lab)
"aN" = (/obj/structure/table/reinforced/steel,/obj/structure/carpet/red,/obj/item/slime_core/custom,/turf/simulated/floor/tile/grey,/area/mission/prefab/city/die_lab)
"aO" = (/obj/structure/table,/obj/item/slime_core/black/strong,/turf/simulated/floor/tile/grey,/area/mission/prefab/city/die_lab)
"aP" = (/obj/structure/table,/obj/item/slime_core/custom,/turf/simulated/floor/tile/grey,/area/mission/prefab/city/die_lab)
"aQ" = (/obj/structure/table,/obj/item/slime_core/blue,/turf/simulated/floor/tile/grey,/area/mission/prefab/city/die_lab)
"aR" = (/obj/structure/table,/obj/item/slime_core/white/strong,/turf/simulated/floor/tile/grey,/area/mission/prefab/city/die_lab)
"aS" = (/obj/structure/interactive/lighting/fixture/tube{icon_state = "preview"; dir = 4},/obj/structure/table,/obj/item/slime_core/white,/turf/simulated/floor/tile/grey,/area/mission/prefab/city/die_lab)
"aT" = (/obj/structure/carpet/grey,/turf/simulated/floor/tile/grey,/area/mission/prefab/city/die_lab)
"aU" = (/obj/structure/interactive/lighting/fixture/tube{icon_state = "preview"; dir = 8},/obj/structure/table,/obj/item/slime_core/white,/turf/simulated/floor/tile/grey,/area/mission/prefab/city/die_lab)
"aV" = (/obj/structure/table,/obj/item/slime_core/white,/turf/simulated/floor/tile/grey,/area/mission/prefab/city/die_lab)
"aW" = (/obj/structure/table,/obj/item/slime_core/white/weak,/turf/simulated/floor/tile/grey,/area/mission/prefab/city/die_lab)
"aX" = (/obj/structure/interactive/door/airlock/glass,/turf/simulated/floor/tile/grey,/area/mission/prefab/city/die_lab)
"aY" = (/obj/structure/interactive/bar_sign/die_lab,/turf/simulated/wall/metal,/area/mission/prefab/city/die_lab)
"aZ" = (/obj/structure/interactive/wire/yellow,/obj/marker/smart_clear_turf,/obj/marker/map_node,/turf/simulated/floor/plating,/area/mission/prefab/city/die_lab/backroom)
"ba" = (/obj/marker/map_node/x2,/turf/simulated/floor/tile/grey,/area/mission/prefab/city/die_lab)
"bb" = (/obj/marker/map_node,/turf/simulated/floor/plating,/area/mission/prefab/city/die_lab/backroom)
"bc" = (/obj/structure/carpet/red,/obj/marker/map_node,/turf/simulated/floor/tile/grey,/area/mission/prefab/city/die_lab)
"bd" = (/obj/marker/map_node,/turf/simulated/floor/tile/grey,/area/mission/prefab/city/die_lab)
"be" = (/obj/structure/carpet/grey,/obj/marker/map_node,/turf/simulated/floor/tile/grey,/area/mission/prefab/city/die_lab)
"bf" = (/obj/marker/smart_clear_turf,/obj/marker/map_node,/turf/dmm_suite/no_wall,/area/dmm_suite/clear_area)
"bg" = (/obj/structure/interactive/wire/yellow,/obj/marker/map_node,/turf/simulated/floor/plating,/area/mission/prefab/city/die_lab/backroom)

(1,1,1) = {"
ababababababacaZacacabababababab
abaeafagahaiabajababakahagalamab
abananaoapapapbgadaqarapasananab
abatanasapapapapapapapapaoananab
abauavawapaxapbbapapaxapawayazab
abababababababaAabaiabababababab
aaaBaCaDaEaFaGbcaEaEaEbdaDaHaBaa
aaaBaIaDaEaJaEaEaEaFaEaDaDaKaBaa
aaaLaMaDaEaFaFaFaNaNaEaDaDaOaLaa
aaaLaMaDaEaEaEaEaEaEaEaDaDaPaLaa
aaaLaQaDaDaDaDaDaDaDaDbaaDaPaLaa
aaaLaQaDaDaDaDbaaDaDaDaDaDaRaLaa
aaaBaSaDaDaDaTaTaTaDaDaDaDaUaBaa
aaaBaVaDaDaDaTbeaTaDaDaDaDaWaBaa
aaaBaLaLaLaLaBaXaYaBaLaLaLaLaBaa
aaaaaaaaaaaaaabfaaaaaaaaaaaaaaaa
"}
