"aa" = (/turf/simulated/wall/wood/brown,/area/mission/prefab/city/discount_dans/kitchen)
"ab" = (/obj/structure/interactive/door/airlock/station/maintenance,/turf/simulated/floor/tile,/area/mission/prefab/city/discount_dans/kitchen)
"ac" = (/turf/simulated/wall/wood/brown,/area/mission/prefab/city/discount_dans)
"ad" = (/turf/simulated/wall/wood/brown,/area/mission/prefab/city/discount_dans/bathroom_female)
"ae" = (/turf/simulated/floor/tile,/area/mission/prefab/city/discount_dans/kitchen)
"af" = (/obj/structure/table/reinforced/steel,/obj/structure/interactive/lighting/fixture/tube,/turf/simulated/floor/tile,/area/mission/prefab/city/discount_dans/kitchen)
"ag" = (/obj/structure/table/cooking/grill,/turf/simulated/floor/tile,/area/mission/prefab/city/discount_dans/kitchen)
"ah" = (/turf/simulated/floor/wood/brown,/area/mission/prefab/city/discount_dans)
"ai" = (/obj/structure/interactive/door/airlock/station/bathroom/female,/turf/simulated/floor/tile,/area/mission/prefab/city/discount_dans/bathroom_female)
"aj" = (/turf/simulated/floor/tile,/area/mission/prefab/city/discount_dans/bathroom_female)
"ak" = (/obj/structure/interactive/door/airlock/glass,/turf/simulated/floor/wood/brown,/area/mission/prefab/city/discount_dans/kitchen)
"al" = (/obj/structure/sign/restroom/female,/turf/simulated/wall/wood/brown,/area/mission/prefab/city/discount_dans/bathroom_female)
"am" = (/obj/structure/interactive/misc/sink{icon_state = "sink"; dir = 8},/turf/simulated/floor/tile,/area/mission/prefab/city/discount_dans/bathroom_female)
"an" = (/obj/structure/interactive/misc/toilet{icon_state = "toilet"; dir = 8},/turf/simulated/floor/tile,/area/mission/prefab/city/discount_dans/bathroom_female)
"ao" = (/obj/structure/table/reinforced/steel,/turf/simulated/floor/wood/brown,/area/mission/prefab/city/discount_dans/kitchen)
"ap" = (/turf/dmm_suite/no_wall,/area/dmm_suite/clear_area)
"aq" = (/obj/structure/interactive/power/apc{icon_state = "apc"; dir = 4},/turf/simulated/wall/wood/brown,/area/mission/prefab/city/discount_dans/kitchen)
"ar" = (/obj/structure/interactive/wire/green,/turf/simulated/floor/wood/brown,/area/mission/prefab/city/discount_dans)
"as" = (/turf/simulated/wall/wood/brown,/area/mission/prefab/city/discount_dans/bathroom_male)
"at" = (/obj/structure/carpet/red,/turf/simulated/floor/wood/brown,/area/mission/prefab/city/discount_dans)
"au" = (/obj/structure/sign/restroom/male,/turf/simulated/wall/wood/brown,/area/mission/prefab/city/discount_dans/bathroom_male)
"av" = (/obj/structure/interactive/misc/sink{icon_state = "sink"; dir = 8},/turf/simulated/floor/tile,/area/mission/prefab/city/discount_dans/bathroom_male)
"aw" = (/obj/structure/interactive/misc/toilet{icon_state = "toilet"; dir = 8},/turf/simulated/floor/tile,/area/mission/prefab/city/discount_dans/bathroom_male)
"ax" = (/obj/structure/short_wall/wood,/turf/simulated/floor/wood/brown/dark,/area/dmm_suite/clear_area)
"ay" = (/obj/structure/interactive/chair/wood{icon_state = "wooden_chair"; dir = 4},/turf/simulated/floor/wood/brown/dark,/area/dmm_suite/clear_area)
"az" = (/obj/structure/table/wood,/turf/simulated/floor/wood/brown/dark,/area/dmm_suite/clear_area)
"aA" = (/obj/structure/interactive/chair/wood{icon_state = "wooden_chair"; dir = 8},/turf/simulated/floor/wood/brown/dark,/area/dmm_suite/clear_area)
"aB" = (/turf/simulated/floor/wood/brown/dark,/area/dmm_suite/clear_area)
"aC" = (/obj/structure/interactive/chair/wood{icon_state = "wooden_chair"; dir = 4},/obj/structure/interactive/lighting/fixture/tube,/turf/simulated/floor/wood/brown/dark,/area/mission/prefab/city/discount_dans)
"aD" = (/obj/structure/interactive/chair/wood{icon_state = "wooden_chair"; dir = 1},/turf/simulated/floor/wood/brown/dark,/area/dmm_suite/clear_area)
"aE" = (/obj/structure/interactive/door/airlock/station/bathroom/male,/turf/simulated/floor/tile,/area/mission/prefab/city/discount_dans/bathroom_male)
"aF" = (/turf/simulated/floor/tile,/area/mission/prefab/city/discount_dans/bathroom_male)
"aG" = (/obj/structure/table/wood,/obj/structure/carpet/red,/turf/simulated/floor/wood/brown,/area/mission/prefab/city/discount_dans)
"aH" = (/obj/structure/interactive/chair/stool/bar{icon_state = "bar"; dir = 1},/obj/structure/carpet/red,/turf/simulated/floor/wood/brown,/area/mission/prefab/city/discount_dans)
"aI" = (/turf/dmm_suite/clear_turf,/area/dmm_suite/clear_area)
"aJ" = (/obj/structure/interactive/chair/stool/bar{icon_state = "bar"; dir = 8},/obj/structure/carpet/red,/turf/simulated/floor/wood/brown,/area/mission/prefab/city/discount_dans)
"aK" = (/obj/structure/interactive/wire/green,/turf/simulated/floor/plating,/area/dmm_suite/clear_area)
"aL" = (/turf/simulated/floor/plating,/area/dmm_suite/clear_area)
"aM" = (/obj/structure/interactive/fence/end{icon_state = "end"; dir = 1},/turf/simulated/floor/plating,/area/dmm_suite/clear_area)
"aN" = (/obj/structure/interactive/power/smes,/obj/structure/interactive/wire/yellow,/turf/simulated/floor/plating,/area/dmm_suite/clear_area)
"aO" = (/obj/structure/interactive/fence,/turf/simulated/floor/plating,/area/dmm_suite/clear_area)
"aP" = (/obj/structure/interactive/solar_panel,/obj/structure/interactive/wire/yellow,/turf/simulated/floor/plating,/area/dmm_suite/clear_area)
"aQ" = (/obj/structure/interactive/fence/end{icon_state = "end"; dir = 4},/turf/simulated/floor/plating,/area/dmm_suite/clear_area)
"aR" = (/obj/structure/interactive/chair/stool/bar,/obj/structure/carpet/red,/turf/simulated/floor/wood/brown,/area/mission/prefab/city/discount_dans)
"aS" = (/obj/structure/interactive/fence/door,/turf/simulated/floor/plating,/area/dmm_suite/clear_area)
"aT" = (/obj/structure/interactive/door/airlock/station/maintenance,/obj/structure/interactive/wire/green,/turf/simulated/floor/wood/brown,/area/mission/prefab/city/discount_dans)
"aU" = (/obj/structure/interactive/fence/corner{icon_state = "corner"; dir = 6},/turf/simulated/floor/plating,/area/dmm_suite/clear_area)
"aV" = (/obj/marker/spawning/window,/turf/simulated/floor/wood/brown,/area/mission/prefab/city/discount_dans)
"aW" = (/obj/structure/interactive/chair/wood,/obj/structure/carpet/red,/turf/simulated/floor/wood/brown,/area/mission/prefab/city/discount_dans)
"aX" = (/obj/structure/interactive/chair/wood{icon_state = "wooden_chair"; dir = 4},/obj/structure/carpet/red,/turf/simulated/floor/wood/brown,/area/mission/prefab/city/discount_dans)
"aY" = (/obj/structure/interactive/chair/wood{icon_state = "wooden_chair"; dir = 1},/obj/structure/carpet/red,/turf/simulated/floor/wood/brown,/area/mission/prefab/city/discount_dans)
"aZ" = (/obj/structure/interactive/chair/wood{icon_state = "wooden_chair"; dir = 8},/obj/structure/carpet/red,/turf/simulated/floor/wood/brown,/area/mission/prefab/city/discount_dans)
"ba" = (/obj/structure/interactive/bar_sign/dan,/turf/simulated/wall/wood/brown,/area/mission/prefab/city/discount_dans)
"bb" = (/obj/structure/interactive/door/airlock/wood/dark,/turf/simulated/floor/wood/brown/dark,/area/mission/prefab/city/discount_dans)
"bc" = (/obj/structure/interactive/light_switch{icon_state = "setup"; dir = 1},/turf/simulated/wall/wood/brown,/area/mission/prefab/city/discount_dans/kitchen)
"bd" = (/obj/structure/interactive/light_switch,/turf/simulated/wall/wood/brown,/area/mission/prefab/city/discount_dans/bathroom_female)
"be" = (/obj/structure/interactive/light_switch{icon_state = "setup"; dir = 1},/turf/simulated/wall/wood/brown,/area/mission/prefab/city/discount_dans/bathroom_male)
"bf" = (/obj/structure/table/wood,/obj/structure/carpet/red,/obj/structure/interactive/storage/cash_register{icon_state = "register"; dir = 1},/turf/simulated/floor/wood/brown,/area/mission/prefab/city/discount_dans)
"bg" = (/obj/structure/carpet/red,/obj/structure/interactive/storage/safe,/obj/structure/interactive/crate/closet,/turf/simulated/floor/wood/brown,/area/mission/prefab/city/discount_dans)
"bh" = (/obj/structure/table/wood,/obj/structure/carpet/red,/obj/item/container/simple/alcohol/beer,/turf/simulated/floor/wood/brown,/area/mission/prefab/city/discount_dans)
"bi" = (/obj/structure/table/wood,/obj/structure/carpet/red,/obj/item/container/simple/alcohol/beer,/obj/item/container/simple/alcohol/beer,/turf/simulated/floor/wood/brown,/area/mission/prefab/city/discount_dans)
"bj" = (/obj/structure/carpet/red,/obj/structure/interactive/vending/smart_fridge/bar/solarian,/turf/simulated/floor/wood/brown,/area/mission/prefab/city/discount_dans)
"bk" = (/obj/structure/interactive/vending/smart_fridge/kitchen/solarian,/turf/simulated/floor/tile,/area/mission/prefab/city/discount_dans/kitchen)
"bl" = (/obj/structure/interactive/crate/closet/freezer,/turf/simulated/floor/tile,/area/mission/prefab/city/discount_dans/kitchen)
"bm" = (/obj/structure/carpet/red,/obj/structure/interactive/lighting/fixture/tube{icon_state = "preview"; dir = 4},/turf/simulated/floor/wood/brown,/area/mission/prefab/city/discount_dans)
"bn" = (/obj/structure/interactive/lighting/fixture/tube{icon_state = "preview"; dir = 1},/turf/simulated/floor/wood/brown,/area/mission/prefab/city/discount_dans)
"bo" = (/obj/structure/interactive/lighting/fixture/tube,/turf/simulated/floor/wood/brown,/area/mission/prefab/city/discount_dans)
"bp" = (/obj/structure/interactive/lighting/fixture/tube{icon_state = "preview"; dir = 8},/turf/simulated/floor/wood/brown,/area/mission/prefab/city/discount_dans)
"bq" = (/obj/structure/carpet/red,/obj/structure/interactive/lighting/fixture/tube,/turf/simulated/floor/wood/brown,/area/mission/prefab/city/discount_dans)
"br" = (/obj/structure/interactive/lighting/fixture/tube{icon_state = "preview"; dir = 4},/turf/simulated/floor/tile,/area/mission/prefab/city/discount_dans/kitchen)
"bs" = (/obj/structure/interactive/chair/wood,/obj/structure/interactive/lighting/fixture/tube,/turf/simulated/floor/wood/brown/dark,/area/mission/prefab/city/discount_dans)
"bt" = (/obj/structure/interactive/lighting/fixture/bulb,/turf/simulated/floor/tile,/area/mission/prefab/city/discount_dans/bathroom_female)
"bu" = (/obj/structure/interactive/lighting/fixture/bulb{icon_state = "preview"; dir = 1},/turf/simulated/floor/tile,/area/mission/prefab/city/discount_dans/bathroom_male)

(1,1,1) = {"
aaabaaaaaaaaaaaaaaacacadbdadadaI
aaaebkblagagagafaaahboaiajbtadaI
aabraeaeaeaeaeaeakahahalamanadaI
aaaaaaaoaoaoaobcaqarahasasasasaI
acbgbjatatatatbqatarahauavawasaI
acbmatatatatatatatarahaEaFbuasaI
acbhbfaGaGaGaGbhaGarahasbeasasaI
acaHaHaJaHaHaRaRaHararaTaKaLaMaI
aVahahahahahahahahahbpacaNaLaOaI
aVataWaWatahahataWaWatacaPaLaOaI
acaXbhaGaXbnahaYbibhaZacaPaLaOaI
acacaVaVbaacbbacaVaVacacaQaSaUaI
axaCazaAaBaBaBaBaAazbsaxapapapaI
axaBaBaBaBaBaBaBaBaBaBaxapapapaI
axaDazaAaBaBaBaBayazaDaxapapapaI
axaxaxaxaxaBaBaxaxaxaxaxapapapaI
"}
