"aa" = (/obj/structure/interactive/storage/trash_pile/low_chance,/turf/dmm_suite/clear_turf,/area/dmm_suite/clear_area)
"ab" = (/turf/simulated/wall/metal,/area/dmm_suite/clear_area)
"ac" = (/turf/simulated/wall/metal,/area/mission/prefab/city/newmed_clinic/furnace)
"ad" = (/obj/structure/sign/fire,/turf/simulated/wall/metal,/area/mission/prefab/city/newmed_clinic/furnace)
"ae" = (/obj/structure/interactive/crate/coffin,/obj/marker/spawning/random/valuable,/turf/simulated/floor/plating/reinforced,/area/mission/prefab/city/newmed_clinic/furnace)
"af" = (/obj/structure/interactive/storage/trash_pile/low_chance,/turf/simulated/floor/plating/reinforced,/area/mission/prefab/city/newmed_clinic/furnace)
"ag" = (/obj/structure/interactive/lighting/fixture/bulb,/turf/simulated/floor/plating/reinforced,/area/mission/prefab/city/newmed_clinic/furnace)
"ah" = (/obj/structure/interactive/conveyor{icon_state = "conveyor"; dir = 4},/turf/simulated/floor/plating/reinforced,/area/mission/prefab/city/newmed_clinic/furnace)
"ai" = (/obj/structure/interactive/conveyor{icon_state = "conveyor"; dir = 4},/obj/structure/interactive/plastic_flaps,/turf/simulated/floor/plating/reinforced,/area/mission/prefab/city/newmed_clinic/furnace)
"aj" = (/obj/structure/interactive/conveyor{icon_state = "conveyor"; dir = 4},/turf/simulated/liquid/lava,/area/mission/prefab/city/newmed_clinic/furnace)
"ak" = (/obj/structure/interactive/conveyor,/turf/simulated/liquid/lava,/area/mission/prefab/city/newmed_clinic/furnace)
"al" = (/obj/structure/interactive/crate/bodybag,/obj/marker/spawning/random/trash,/turf/simulated/floor/plating/reinforced,/area/mission/prefab/city/newmed_clinic/furnace)
"am" = (/turf/simulated/floor/plating/reinforced,/area/mission/prefab/city/newmed_clinic/furnace)
"an" = (/obj/structure/interactive/atmospherics/fan,/turf/simulated/floor/plating/reinforced,/area/mission/prefab/city/newmed_clinic/furnace)
"ao" = (/obj/structure/interactive/fence/end{icon_state = "end"; dir = 4},/turf/simulated/floor/plating,/area/dmm_suite/clear_area)
"ap" = (/obj/structure/interactive/fence{icon_state = "straight"; dir = 4},/turf/simulated/floor/plating,/area/dmm_suite/clear_area)
"aq" = (/obj/structure/interactive/fence/door,/obj/marker/smart_clear_turf,/obj/marker/map_node,/turf/simulated/floor/plating,/area/dmm_suite/clear_area)
"ar" = (/obj/structure/interactive/fence/corner{icon_state = "corner"; dir = 4},/turf/simulated/floor/plating,/area/dmm_suite/clear_area)
"as" = (/turf/simulated/floor/plating,/area/dmm_suite/clear_area)
"at" = (/obj/structure/interactive/fence,/turf/simulated/floor/plating,/area/dmm_suite/clear_area)
"au" = (/obj/structure/interactive/fence/end,/turf/simulated/floor/plating,/area/dmm_suite/clear_area)
"av" = (/obj/structure/interactive/solar_panel,/obj/structure/interactive/wire/yellow,/turf/simulated/floor/plating,/area/dmm_suite/clear_area)
"aw" = (/obj/structure/interactive/power/smes{icon_state = "smes_map"; dir = 1},/obj/structure/interactive/wire/green,/turf/simulated/floor/plating,/area/dmm_suite/clear_area)
"ax" = (/obj/structure/interactive/wire/yellow,/turf/simulated/floor/plating,/area/dmm_suite/clear_area)
"ay" = (/obj/marker/map_node,/turf/simulated/floor/plating/reinforced,/area/mission/prefab/city/newmed_clinic/furnace)
"az" = (/turf/simulated/liquid/lava,/area/mission/prefab/city/newmed_clinic/furnace)
"aA" = (/obj/structure/interactive/crate/bodybag,/obj/marker/spawning/random/misc,/obj/marker/cover_node/left,/turf/simulated/floor/plating/reinforced,/area/mission/prefab/city/newmed_clinic/furnace)
"aB" = (/obj/structure/interactive/crate/trash,/obj/marker/spawning/random/trash,/obj/marker/cover_node/right,/turf/simulated/floor/plating/reinforced,/area/mission/prefab/city/newmed_clinic/furnace)
"aC" = (/obj/structure/interactive/conveyor{icon_state = "conveyor"; dir = 8},/turf/simulated/floor/plating/reinforced,/area/mission/prefab/city/newmed_clinic/furnace)
"aD" = (/obj/structure/interactive/storage/trash_pile/low_chance,/turf/simulated/floor/plating,/area/dmm_suite/clear_area)
"aE" = (/obj/structure/interactive/conveyor{icon_state = "conveyor"; dir = 8},/obj/structure/interactive/plastic_flaps,/turf/simulated/floor/plating/reinforced,/area/mission/prefab/city/newmed_clinic/furnace)
"aF" = (/obj/structure/interactive/conveyor{icon_state = "conveyor"; dir = 8},/turf/simulated/liquid/lava,/area/mission/prefab/city/newmed_clinic/furnace)
"aG" = (/turf/simulated/wall/metal,/area/mission/prefab/city/newmed_clinic)
"aH" = (/obj/structure/interactive/light_switch{icon_state = "setup"; dir = 1},/turf/simulated/wall/metal,/area/mission/prefab/city/newmed_clinic/furnace)
"aI" = (/obj/structure/interactive/door/airlock/dark,/turf/simulated/floor/plating/reinforced,/area/mission/prefab/city/newmed_clinic/furnace)
"aJ" = (/obj/structure/sign/secure,/turf/simulated/wall/metal,/area/mission/prefab/city/newmed_clinic/furnace)
"aK" = (/obj/structure/interactive/light_switch,/turf/simulated/wall/metal,/area/mission/prefab/city/newmed_clinic/furnace)
"aL" = (/obj/structure/interactive/crate/medical,/obj/marker/spawning/random/valuable,/turf/simulated/floor/tile/morphing/green,/area/mission/prefab/city/newmed_clinic)
"aM" = (/turf/simulated/floor/tile/morphing/green,/area/mission/prefab/city/newmed_clinic)
"aN" = (/obj/structure/table/simple,/turf/simulated/floor/tile/morphing/green,/area/mission/prefab/city/newmed_clinic)
"aO" = (/obj/structure/interactive/crate/medical,/obj/marker/spawning/random/trash,/obj/marker/spawning/random/trash,/turf/simulated/floor/tile/morphing/green,/area/mission/prefab/city/newmed_clinic)
"aP" = (/obj/structure/interactive/lighting/fixture/tube,/turf/simulated/floor/tile/morphing/green,/area/mission/prefab/city/newmed_clinic)
"aQ" = (/mob/living/simple/bot/medibot/rogue,/turf/simulated/floor/tile/morphing/green,/area/mission/prefab/city/newmed_clinic)
"aR" = (/obj/structure/interactive/power/apc,/turf/simulated/wall/metal,/area/mission/prefab/city/newmed_clinic)
"aS" = (/obj/structure/interactive/wire/green,/obj/structure/interactive/door/airlock/dark,/turf/simulated/floor/plating,/area/mission/prefab/city/newmed_clinic)
"aT" = (/mob/living/simple/bot/medibot/rogue,/turf/simulated/floor/tile/tint,/area/mission/prefab/city/newmed_clinic)
"aU" = (/turf/simulated/floor/tile/tint,/area/mission/prefab/city/newmed_clinic)
"aV" = (/obj/structure/table/simple,/turf/simulated/floor/tile/tint,/area/mission/prefab/city/newmed_clinic)
"aW" = (/obj/structure/interactive/wire/green,/turf/simulated/floor/tile/morphing/green,/area/mission/prefab/city/newmed_clinic)
"aX" = (/obj/structure/interactive/wire/green,/obj/structure/interactive/lighting/fixture/tube,/obj/marker/cover_node/right{icon_state = "right"; dir = 1},/turf/simulated/floor/tile/morphing/green,/area/mission/prefab/city/newmed_clinic)
"aY" = (/obj/structure/interactive/potted_plant/nanotrasen,/turf/simulated/floor/tile/morphing/green,/area/mission/prefab/city/newmed_clinic)
"aZ" = (/obj/structure/interactive/lighting/fixture/tube{icon_state = "preview"; dir = 4},/turf/simulated/floor/tile/morphing/green,/area/mission/prefab/city/newmed_clinic)
"ba" = (/obj/marker/map_node,/turf/simulated/floor/plating,/area/dmm_suite/clear_area)
"bb" = (/turf/simulated/wall/metal,/area/mission/prefab/city/newmed_clinic/lobby)
"bc" = (/obj/structure/interactive/light_switch,/turf/simulated/wall/metal,/area/mission/prefab/city/newmed_clinic/lobby)
"bd" = (/obj/structure/interactive/door/airlock/glass,/turf/simulated/floor/tile/tint,/area/mission/prefab/city/newmed_clinic/lobby)
"be" = (/obj/structure/sign/no_smoking,/turf/simulated/wall/metal,/area/mission/prefab/city/newmed_clinic/lobby)
"bf" = (/obj/structure/interactive/bed/sleeper/medical/weak,/turf/simulated/floor/tile/morphing/green,/area/mission/prefab/city/newmed_clinic)
"bg" = (/obj/structure/table/simple,/obj/marker/spawning/random/misc,/turf/simulated/floor/tile/tint,/area/mission/prefab/city/newmed_clinic)
"bh" = (/obj/structure/interactive/bed/sleeper/medical/weak,/turf/simulated/floor/tile/tint,/area/mission/prefab/city/newmed_clinic)
"bi" = (/obj/structure/interactive/potted_plant/nanotrasen,/turf/simulated/floor/tile/morphing/medical,/area/mission/prefab/city/newmed_clinic/lobby)
"bj" = (/turf/simulated/floor/tile/morphing/medical,/area/mission/prefab/city/newmed_clinic/lobby)
"bk" = (/obj/structure/table/simple,/turf/simulated/floor/tile/morphing/medical,/area/mission/prefab/city/newmed_clinic/lobby)
"bl" = (/obj/structure/interactive/chair,/turf/simulated/floor/tile/morphing/medical,/area/mission/prefab/city/newmed_clinic/lobby)
"bm" = (/obj/structure/interactive/fire_closet{icon_state = "extinguisher"; dir = 8},/turf/simulated/wall/metal,/area/mission/prefab/city/newmed_clinic/lobby)
"bn" = (/mob/living/simple/bot/medibot/rogue,/turf/simulated/floor/tile/tint,/area/mission/prefab/city/newmed_clinic/lobby)
"bo" = (/obj/structure/table/simple,/obj/structure/interactive/storage/cash_register{icon_state = "register"; dir = 8},/turf/simulated/floor/tile/tint,/area/mission/prefab/city/newmed_clinic/lobby)
"bp" = (/turf/simulated/floor/tile/tint,/area/mission/prefab/city/newmed_clinic/lobby)
"bq" = (/obj/structure/interactive/chair{icon_state = "chair"; dir = 8},/turf/simulated/floor/tile/morphing/medical,/area/mission/prefab/city/newmed_clinic/lobby)
"br" = (/obj/structure/interactive/lighting/fixture/tube{icon_state = "preview"; dir = 4},/turf/simulated/floor/tile/morphing/medical,/area/mission/prefab/city/newmed_clinic/lobby)
"bs" = (/obj/structure/interactive/chair/office{icon_state = "officechair_white"; dir = 8},/turf/simulated/floor/tile/tint,/area/mission/prefab/city/newmed_clinic/lobby)
"bt" = (/obj/structure/table/simple,/turf/simulated/floor/tile/tint,/area/mission/prefab/city/newmed_clinic/lobby)
"bu" = (/obj/structure/interactive/chair{icon_state = "chair"; dir = 8},/obj/structure/interactive/lighting/fixture/tube{icon_state = "preview"; dir = 8},/turf/simulated/floor/tile/morphing/medical,/area/mission/prefab/city/newmed_clinic/lobby)
"bv" = (/obj/structure/interactive/lighting/fixture/tube{icon_state = "preview"; dir = 8},/turf/simulated/floor/tile/morphing/green,/area/mission/prefab/city/newmed_clinic)
"bw" = (/obj/structure/interactive/atmospherics/scrubber,/turf/simulated/floor/tile/tint,/area/mission/prefab/city/newmed_clinic)
"bx" = (/obj/structure/interactive/chair{icon_state = "chair"; dir = 4},/turf/simulated/floor/tile/morphing/medical,/area/mission/prefab/city/newmed_clinic/lobby)
"by" = (/obj/structure/interactive/crate/medical,/obj/marker/spawning/random/trash,/turf/simulated/floor/tile/morphing/green,/area/mission/prefab/city/newmed_clinic)
"bz" = (/obj/structure/carpet/grey,/turf/simulated/floor/tile/morphing/medical,/area/mission/prefab/city/newmed_clinic/lobby)
"bA" = (/obj/marker/spawning/window,/turf/simulated/floor/plating,/area/mission/prefab/city/newmed_clinic/lobby)
"bB" = (/obj/structure/interactive/bar_sign/newmed_clinic,/turf/simulated/wall/metal,/area/mission/prefab/city/newmed_clinic/lobby)
"bC" = (/obj/structure/interactive/wire/green,/obj/marker/map_node,/turf/simulated/floor/plating,/area/dmm_suite/clear_area)
"bD" = (/obj/marker/map_node,/turf/simulated/floor/tile/morphing/green,/area/mission/prefab/city/newmed_clinic)
"bE" = (/obj/structure/interactive/wire/green,/obj/marker/map_node,/turf/simulated/floor/tile/morphing/green,/area/mission/prefab/city/newmed_clinic)
"bF" = (/obj/marker/map_node,/turf/simulated/floor/tile/tint,/area/mission/prefab/city/newmed_clinic)
"bG" = (/obj/structure/interactive/atmospherics/vent,/obj/marker/map_node,/turf/simulated/floor/tile/tint,/area/mission/prefab/city/newmed_clinic)
"bH" = (/obj/marker/map_node,/turf/simulated/floor/tile/morphing/medical,/area/mission/prefab/city/newmed_clinic/lobby)
"bI" = (/obj/marker/map_node,/turf/simulated/floor/tile/tint,/area/mission/prefab/city/newmed_clinic/lobby)
"bJ" = (/obj/structure/interactive/door/airlock/glass,/obj/marker/smart_clear_turf,/obj/marker/map_node,/turf/simulated/floor/tile/tint,/area/mission/prefab/city/newmed_clinic/lobby)
"bK" = (/obj/marker/cover_node/left,/turf/simulated/floor/tile/morphing/green,/area/mission/prefab/city/newmed_clinic)
"bL" = (/obj/marker/cover_node/right,/turf/simulated/floor/tile/morphing/green,/area/mission/prefab/city/newmed_clinic)
"bM" = (/obj/structure/carpet/grey,/obj/marker/cover_node/right,/turf/simulated/floor/tile/morphing/medical,/area/mission/prefab/city/newmed_clinic/lobby)
"bN" = (/obj/structure/interactive/potted_plant/nanotrasen,/obj/marker/cover_node/left{icon_state = "left"; dir = 1},/turf/simulated/floor/tile/morphing/green,/area/mission/prefab/city/newmed_clinic)
"bO" = (/obj/marker/cover_node/left{icon_state = "left"; dir = 4},/turf/simulated/floor/tile/morphing/green,/area/mission/prefab/city/newmed_clinic)
"bP" = (/obj/marker/mission_corpse,/turf/simulated/floor/tile/morphing/green,/area/mission/prefab/city/newmed_clinic)
"bQ" = (/obj/marker/mission_corpse,/turf/simulated/floor/tile/tint,/area/mission/prefab/city/newmed_clinic)
"bR" = (/obj/marker/mission_corpse,/turf/simulated/floor/tile/tint,/area/mission/prefab/city/newmed_clinic/lobby)

(1,1,1) = {"
aaacacacacadacacacacacacaoapaqar
aaacaeafagahaiajajajakacavavasat
aaacalamanamacazazazakacavavasat
aaacaAayaBaCaEaFaFaFakacaxbabaau
aGacaHaIaJacaKacacacacacawbCaDab
aGaLaMbDaNaOaMaPaMaQaOaRaGaSaGaG
aGaMaTaUaVaVaVaVaUaUbPaWaXbEbNaG
aGaZbFaUbGbQaUbDaMbKbDbLbKbDbLaG
aGaMaUaUaUaUaTbObbbcbdbbbebdbbbb
aGbfaUbgaUaVbhaMbbbibHbkblbHbibb
aGaMaUaUbFaUaUaMbmbjbnbobIbpbqbb
aGbfaUaVaUaVbhaMbbbrbsbtbpbRbubb
aGaZaUaTaUaUaUbvbbbkbtbtbpbnbqbb
aGbfaUaVbwaVbhaMbbbxbpbpbIbpbqbb
aGaYaMaMbDaMaMbybbbxbjbzbzbMbqbb
aGaGaGaGaGaGaGaGbbbAbAbAbJbBbbbb
"}
