"aa" = (/turf/dmm_suite/clear_turf,/area/dmm_suite/clear_area)
"ab" = (/turf/simulated/wall/metal/circuit,/area/mission/prefab/city/the_coderbus)
"ac" = (/turf/simulated/wall/metal/circuit,/area/mission/prefab/city/the_coderbus/bathroom)
"ad" = (/turf/simulated/floor/plating,/area/dmm_suite/clear_area)
"ae" = (/obj/structure/interactive/fire_closet,/turf/simulated/wall/metal/circuit,/area/mission/prefab/city/the_coderbus)
"af" = (/obj/structure/interactive/misc/toilet,/turf/simulated/floor/tile/tint,/area/mission/prefab/city/the_coderbus/bathroom)
"ag" = (/obj/structure/interactive/crate/trash,/obj/marker/spawning/random/dangerous,/turf/simulated/floor/tile/tint,/area/mission/prefab/city/the_coderbus/bathroom)
"ah" = (/obj/structure/interactive/potted_plant/office,/turf/simulated/floor/tile/morphing,/area/mission/prefab/city/the_coderbus)
"ai" = (/obj/structure/interactive/wire/green,/turf/simulated/floor/tile/morphing,/area/mission/prefab/city/the_coderbus)
"aj" = (/obj/structure/interactive/door/airlock/station/maintenance,/obj/structure/interactive/wire/green,/turf/simulated/floor/plating,/area/mission/prefab/city/the_coderbus)
"ak" = (/obj/structure/interactive/lighting/fixture/bulb{icon_state = "preview"; dir = 4},/turf/simulated/floor/tile/tint,/area/mission/prefab/city/the_coderbus/bathroom)
"al" = (/turf/simulated/floor/tile/tint,/area/mission/prefab/city/the_coderbus/bathroom)
"am" = (/obj/structure/interactive/fence/end{icon_state = "end"; dir = 4},/turf/simulated/floor/plating,/area/dmm_suite/clear_area)
"an" = (/obj/structure/interactive/fence{icon_state = "straight"; dir = 4},/turf/simulated/floor/plating,/area/dmm_suite/clear_area)
"ao" = (/obj/structure/interactive/fence/corner{icon_state = "corner"; dir = 4},/turf/simulated/floor/plating,/area/dmm_suite/clear_area)
"ap" = (/obj/structure/interactive/power/smes{icon_state = "smes_map"; dir = 4},/obj/structure/interactive/wire/green,/turf/simulated/floor/plating,/area/dmm_suite/clear_area)
"aq" = (/obj/structure/interactive/wire/yellow,/turf/simulated/floor/plating,/area/dmm_suite/clear_area)
"ar" = (/obj/structure/interactive/fence,/turf/simulated/floor/plating,/area/dmm_suite/clear_area)
"as" = (/obj/structure/interactive/fence/end,/turf/simulated/floor/plating,/area/dmm_suite/clear_area)
"at" = (/obj/structure/interactive/door/airlock/station/bathroom/toilet,/obj/marker/cover_node/left,/turf/simulated/floor/tile/dark/ish,/area/mission/prefab/city/the_coderbus/bathroom)
"au" = (/turf/simulated/floor/tile/morphing,/area/mission/prefab/city/the_coderbus)
"av" = (/obj/structure/interactive/misc/sink{icon_state = "sink"; dir = 8},/turf/simulated/floor/tile/tint,/area/mission/prefab/city/the_coderbus/bathroom)
"aw" = (/obj/structure/interactive/light_switch{icon_state = "setup"; dir = 8},/turf/simulated/wall/metal/circuit,/area/mission/prefab/city/the_coderbus/bathroom)
"ax" = (/obj/structure/interactive/lighting/fixture/tube{icon_state = "preview"; dir = 4},/turf/simulated/floor/tile/morphing,/area/mission/prefab/city/the_coderbus)
"ay" = (/obj/structure/interactive/bookcase,/turf/simulated/floor/tile/morphing,/area/mission/prefab/city/the_coderbus)
"az" = (/obj/structure/interactive/solar_panel,/obj/structure/interactive/wire/yellow,/turf/simulated/floor/plating,/area/dmm_suite/clear_area)
"aA" = (/obj/structure/table/reinforced/steel,/turf/simulated/floor/tile/morphing,/area/mission/prefab/city/the_coderbus)
"aB" = (/obj/structure/table/reinforced/steel,/obj/structure/interactive/lighting/fixture/tube,/turf/simulated/floor/tile/morphing,/area/mission/prefab/city/the_coderbus)
"aC" = (/obj/structure/interactive/crate/trash,/obj/marker/spawning/random/trash,/turf/simulated/floor/tile/morphing,/area/mission/prefab/city/the_coderbus)
"aD" = (/obj/marker/spawning/window,/turf/simulated/floor/plating,/area/mission/prefab/city/the_coderbus)
"aE" = (/obj/structure/interactive/power/apc,/turf/simulated/wall/metal/circuit,/area/mission/prefab/city/the_coderbus/bathroom)
"aF" = (/obj/structure/interactive/wire/green,/turf/simulated/floor/tile/dark/ish,/area/mission/prefab/city/the_coderbus)
"aG" = (/turf/simulated/floor/tile/dark/ish,/area/mission/prefab/city/the_coderbus)
"aH" = (/obj/structure/interactive/chair/office/dark{icon_state = "officechair_dark"; dir = 8},/obj/structure/carpet/red,/turf/simulated/floor/tile/dark/ish,/area/mission/prefab/city/the_coderbus)
"aI" = (/obj/structure/interactive/chair/office/dark{icon_state = "officechair_dark"; dir = 1},/obj/structure/carpet/red,/turf/simulated/floor/tile/dark/ish,/area/mission/prefab/city/the_coderbus)
"aJ" = (/obj/structure/interactive/wire/green,/obj/marker/map_node,/turf/simulated/floor/tile/morphing,/area/mission/prefab/city/the_coderbus)
"aK" = (/obj/structure/carpet/red,/turf/simulated/floor/tile/dark/ish,/area/mission/prefab/city/the_coderbus)
"aL" = (/obj/structure/interactive/light_switch{icon_state = "setup"; dir = 4},/turf/simulated/wall/metal/circuit,/area/mission/prefab/city/the_coderbus)
"aM" = (/obj/structure/interactive/chair/office/dark,/turf/simulated/floor/tile/dark/ish,/area/mission/prefab/city/the_coderbus)
"aN" = (/obj/structure/table/reinforced/steel,/turf/simulated/floor/tile/dark/ish,/area/mission/prefab/city/the_coderbus)
"aO" = (/obj/marker/spawning/random/maintenance,/turf/dmm_suite/clear_turf,/area/dmm_suite/clear_area)
"aP" = (/obj/marker/spawning/random/maintenance,/turf/simulated/floor/plating,/area/dmm_suite/clear_area)
"aQ" = (/obj/structure/interactive/chair/office/dark,/obj/structure/carpet/red,/turf/simulated/floor/tile/dark/ish,/area/mission/prefab/city/the_coderbus)
"aR" = (/obj/structure/interactive/wire/yellow,/obj/marker/spawning/random/supply_crate,/turf/simulated/floor/plating,/area/dmm_suite/clear_area)
"aS" = (/turf/dmm_suite/no_wall,/area/dmm_suite/clear_area)
"aT" = (/obj/structure/table/reinforced/steel,/obj/marker/spawning/random/food,/turf/simulated/floor/tile/morphing,/area/mission/prefab/city/the_coderbus)
"aU" = (/obj/structure/interactive/crate/trash,/obj/marker/spawning/random/trash,/obj/structure/interactive/lighting/fixture/tube{icon_state = "preview"; dir = 1},/obj/marker/cover_node/right,/turf/simulated/floor/tile/morphing,/area/mission/prefab/city/the_coderbus)
"aV" = (/obj/structure/interactive/crate/closet/anchored,/turf/simulated/floor/tile/morphing,/area/mission/prefab/city/the_coderbus)
"aW" = (/obj/structure/interactive/fire_closet{icon_state = "extinguisher"; dir = 8},/turf/simulated/wall/metal/circuit,/area/mission/prefab/city/the_coderbus)
"aX" = (/obj/structure/carpet/grey,/turf/simulated/floor/tile/dark/ish,/area/mission/prefab/city/the_coderbus)
"aY" = (/obj/structure/carpet/grey,/obj/marker/cover_node{icon_state = "both"; dir = 4},/turf/simulated/floor/tile/morphing,/area/mission/prefab/city/the_coderbus)
"aZ" = (/obj/structure/interactive/door/airlock/glass,/turf/simulated/floor/tile/dark/ish,/area/mission/prefab/city/the_coderbus)
"ba" = (/obj/structure/interactive/chair/office/dark{icon_state = "officechair_dark"; dir = 8},/turf/simulated/floor/tile/dark/ish,/area/mission/prefab/city/the_coderbus)
"bb" = (/obj/structure/table/reinforced/steel,/obj/structure/interactive/storage/cash_register{icon_state = "register"; dir = 8},/turf/simulated/floor/tile/dark/ish,/area/mission/prefab/city/the_coderbus)
"bc" = (/turf/simulated/floor/sidewalk,/area/dmm_suite/clear_area)
"bd" = (/obj/structure/interactive/fire_alarm{icon_state = "fire_alarm"; dir = 8},/turf/simulated/wall/metal/circuit,/area/mission/prefab/city/the_coderbus)
"be" = (/obj/structure/interactive/storage/safe,/turf/simulated/floor/tile/morphing,/area/mission/prefab/city/the_coderbus)
"bf" = (/obj/structure/interactive/bar_sign/the_coderbus,/turf/simulated/wall/metal/circuit,/area/mission/prefab/city/the_coderbus)
"bg" = (/obj/structure/interactive/wire/green,/obj/marker/map_node,/turf/simulated/floor/plating,/area/dmm_suite/clear_area)
"bh" = (/obj/marker/mission_mob,/obj/marker/map_node,/turf/simulated/floor/tile/tint,/area/mission/prefab/city/the_coderbus/bathroom)
"bi" = (/obj/marker/map_node,/turf/simulated/floor/tile/morphing,/area/mission/prefab/city/the_coderbus)
"bj" = (/obj/structure/interactive/wire/green,/obj/marker/map_node,/turf/simulated/floor/tile/dark/ish,/area/mission/prefab/city/the_coderbus)
"bk" = (/obj/marker/mission_mob,/turf/simulated/floor/tile/dark/ish,/area/mission/prefab/city/the_coderbus)
"bl" = (/obj/marker/mission_mob,/turf/simulated/floor/tile/morphing,/area/mission/prefab/city/the_coderbus)
"bm" = (/obj/marker/map_node,/turf/simulated/floor/tile/dark/ish,/area/mission/prefab/city/the_coderbus)
"bn" = (/obj/marker/map_node,/turf/simulated/floor/sidewalk,/area/dmm_suite/clear_area)
"bo" = (/obj/structure/carpet/grey,/obj/marker/map_node,/turf/simulated/floor/tile/morphing,/area/mission/prefab/city/the_coderbus)
"bp" = (/obj/structure/carpet/red,/obj/marker/map_node,/turf/simulated/floor/tile/dark/ish,/area/mission/prefab/city/the_coderbus)
"bq" = (/obj/structure/interactive/wire/green,/obj/marker/cover_node/left{icon_state = "left"; dir = 4},/turf/simulated/floor/tile/morphing,/area/mission/prefab/city/the_coderbus)
"br" = (/obj/structure/interactive/wire/green,/obj/marker/cover_node/right{icon_state = "right"; dir = 4},/turf/simulated/floor/tile/morphing,/area/mission/prefab/city/the_coderbus)
"bs" = (/obj/structure/interactive/potted_plant/office,/obj/marker/cover_node/left{icon_state = "left"; dir = 4},/turf/simulated/floor/tile/morphing,/area/mission/prefab/city/the_coderbus)
"bt" = (/obj/marker/map_node,/obj/marker/cover_node/right{icon_state = "right"; dir = 4},/turf/simulated/floor/tile/morphing,/area/mission/prefab/city/the_coderbus)
"bu" = (/obj/marker/mission_corpse,/turf/simulated/floor/tile/morphing,/area/mission/prefab/city/the_coderbus)
"bv" = (/obj/marker/mission_corpse,/turf/simulated/floor/tile/dark/ish,/area/mission/prefab/city/the_coderbus)

(1,1,1) = {"
aaaaaaaaaaaOaOabamanananananaoaa
aaacacacacabaeabapaqaRazazazaraa
aaacafagacahaJajbgadadadadaPasaa
aaacakbhatbibqababababababababaa
aaacavalawaxbrayaAaAaAaBaAaCaDaa
aaacacaEacbuaFaGaHaIaIaIaIauaDaa
aaabbiaiaiaibjbkaKaKbpaKaKblaDaa
aaaLauaMaNaGbmaGaQaQaQaHaQbuaDaa
aaabaTaNaNaGauaUaAaAaAaAaAaVaDaa
aaabahaGbvaGauabaDaDaDaDaDaDabaa
aaabbiaGaGbkbtaWbnbcbcbcbcbcbcbn
aaabauaNaNaXboaZbnaSaSaSaSaSaSaS
aaabaxbabbaXaYbdbcaSaSaSaSaSaSaS
aaabbibkaNaXboaZbnaSaSaSaSaSaSaS
aaabahbeaAaubsabbcaSaSaSaSaSaSaS
aaabbfabaDaDaDabbnaSaSaSaSaSaSaS
"}
