"aa" = (/turf/dmm_suite/clear_turf,/area/dmm_suite/clear_area)
"ab" = (/turf/simulated/wall/metal/reinforced,/area/mission/prefab/city/the_harmbaton)
"ac" = (/turf/simulated/wall/metal/reinforced,/area/mission/prefab/city/the_harmbaton/firing_range)
"ad" = (/obj/marker/spawning/window/reinforced,/turf/simulated/floor/plating,/area/mission/prefab/city/the_harmbaton)
"ae" = (/turf/simulated/floor/tile/dark,/area/mission/prefab/city/the_harmbaton)
"af" = (/obj/decal/poster/nanotrasen,/turf/simulated/wall/metal/reinforced,/area/mission/prefab/city/the_harmbaton/firing_range)
"ag" = (/obj/structure/interactive/wire/green,/turf/simulated/floor/plating,/area/dmm_suite/clear_area)
"ah" = (/turf/simulated/floor/plating/reinforced,/area/mission/prefab/city/the_harmbaton/firing_range)
"ai" = (/obj/structure/interactive/lighting/fixture/tube,/turf/simulated/floor/plating/reinforced,/area/mission/prefab/city/the_harmbaton/firing_range)
"aj" = (/obj/structure/table/reinforced/steel/dark,/turf/simulated/floor/tile/dark,/area/mission/prefab/city/the_harmbaton)
"ak" = (/obj/marker/spawning/window/reinforced,/turf/simulated/floor/plating,/area/mission/prefab/city/the_harmbaton/firing_range)
"al" = (/obj/structure/interactive/door/airlock/dark,/turf/simulated/floor/tile/dark,/area/mission/prefab/city/the_harmbaton)
"am" = (/obj/structure/interactive/door/airlock/dark,/obj/structure/interactive/wire/green,/turf/simulated/floor/tile/dark,/area/mission/prefab/city/the_harmbaton)
"an" = (/obj/structure/interactive/wire/green,/turf/simulated/floor/tile/dark,/area/mission/prefab/city/the_harmbaton)
"ao" = (/turf/simulated/floor/plating,/area/dmm_suite/clear_area)
"ap" = (/obj/structure/interactive/fence/end,/turf/simulated/floor/plating,/area/dmm_suite/clear_area)
"aq" = (/obj/structure/interactive/fence/end{icon_state = "end"; dir = 8},/turf/simulated/floor/plating,/area/dmm_suite/clear_area)
"ar" = (/obj/structure/interactive/fence,/turf/simulated/floor/plating,/area/dmm_suite/clear_area)
"as" = (/obj/structure/interactive/fence/corner{icon_state = "corner"; dir = 9},/turf/simulated/floor/plating,/area/dmm_suite/clear_area)
"at" = (/obj/structure/interactive/fence/door{icon_state = "door_opened"; dir = 8},/turf/simulated/floor/plating,/area/dmm_suite/clear_area)
"au" = (/obj/structure/interactive/power/smes{icon_state = "smes_map"; dir = 1},/obj/structure/interactive/wire/green,/turf/simulated/floor/plating,/area/dmm_suite/clear_area)
"av" = (/obj/structure/interactive/solar_panel,/obj/structure/interactive/wire/yellow,/turf/simulated/floor/plating,/area/dmm_suite/clear_area)
"aw" = (/obj/structure/interactive/wire/yellow,/turf/simulated/floor/plating,/area/dmm_suite/clear_area)
"ax" = (/turf/simulated/wall/metal/reinforced,/area/mission/prefab/city/the_harmbaton/armory)
"ay" = (/obj/structure/interactive/door/vault,/obj/structure/interactive/wire/green,/turf/simulated/floor/tile/dark,/area/mission/prefab/city/the_harmbaton/armory)
"az" = (/obj/structure/interactive/power/apc,/turf/simulated/wall/metal/reinforced,/area/mission/prefab/city/the_harmbaton/armory)
"aA" = (/obj/structure/table/reinforced/steel/dark,/obj/marker/spawning/random/dangerous,/turf/simulated/floor/plating/reinforced,/area/mission/prefab/city/the_harmbaton/armory)
"aB" = (/turf/simulated/floor/plating/reinforced,/area/mission/prefab/city/the_harmbaton/armory)
"aC" = (/obj/structure/interactive/wire/green,/turf/simulated/floor/plating/reinforced,/area/mission/prefab/city/the_harmbaton/armory)
"aD" = (/obj/structure/interactive/bar_sign/the_harmbaton,/turf/simulated/wall/metal/reinforced,/area/mission/prefab/city/the_harmbaton/armory)
"aE" = (/obj/structure/interactive/light_switch,/turf/simulated/wall/metal/reinforced,/area/mission/prefab/city/the_harmbaton/armory)
"aF" = (/obj/structure/interactive/lighting/fixture/tube,/turf/simulated/floor/tile/dark,/area/mission/prefab/city/the_harmbaton)
"aG" = (/obj/structure/table/reinforced/steel/dark,/obj/structure/interactive/lighting/fixture/tube{icon_state = "preview"; dir = 4},/obj/structure/interactive/storage/cash_register{icon_state = "register"; dir = 1},/turf/simulated/floor/tile/dark,/area/mission/prefab/city/the_harmbaton)
"aH" = (/obj/structure/carpet/grey,/obj/structure/interactive/crate/trash,/obj/marker/spawning/random/trash,/turf/simulated/floor/tile/dark,/area/mission/prefab/city/the_harmbaton/firing_range)
"aI" = (/obj/structure/table/simple,/obj/item/weapon/ranged/bullet/magazine/pistol/tactical,/obj/item/weapon/ranged/bullet/magazine/pistol/tactical,/turf/simulated/floor/tile/dark,/area/mission/prefab/city/the_harmbaton/firing_range)
"aJ" = (/obj/structure/table/reinforced/steel/dark,/obj/marker/spawning/random/dangerous,/obj/structure/interactive/lighting/fixture/tube{icon_state = "preview"; dir = 4},/turf/simulated/floor/plating/reinforced,/area/mission/prefab/city/the_harmbaton/armory)
"aK" = (/obj/structure/table/reinforced/steel/dark,/obj/marker/spawning/random/dangerous,/obj/structure/interactive/lighting/fixture/tube{icon_state = "preview"; dir = 8},/turf/simulated/floor/plating/reinforced,/area/mission/prefab/city/the_harmbaton/armory)
"aL" = (/obj/structure/interactive/lighting/fixture/tube{icon_state = "preview"; dir = 1},/turf/simulated/floor/plating/reinforced,/area/mission/prefab/city/the_harmbaton/armory)
"aM" = (/obj/structure/interactive/lighting/fixture/tube{icon_state = "preview"; dir = 1},/turf/simulated/floor/tile/dark,/area/mission/prefab/city/the_harmbaton)
"aN" = (/obj/structure/table/simple,/obj/item/magazine/pistol_45,/obj/item/magazine/pistol_45,/obj/item/magazine/pistol_45,/obj/item/magazine/pistol_45,/turf/simulated/floor/tile/dark,/area/mission/prefab/city/the_harmbaton/firing_range)
"aO" = (/obj/structure/interactive/chair/office/dark,/turf/simulated/floor/tile/dark,/area/mission/prefab/city/the_harmbaton)
"aP" = (/turf/dmm_suite/no_wall,/area/dmm_suite/clear_area)
"aQ" = (/obj/decal/poster/nanotrasen,/turf/simulated/wall/metal/reinforced,/area/mission/prefab/city/the_harmbaton)
"aR" = (/obj/decal/poster/nanotrasen{icon_state = ""; dir = 4},/turf/simulated/wall/metal/reinforced,/area/mission/prefab/city/the_harmbaton/armory)
"aS" = (/obj/decal/poster/nanotrasen{icon_state = ""; dir = 8},/turf/simulated/wall/metal/reinforced,/area/mission/prefab/city/the_harmbaton)
"aT" = (/obj/structure/table/reinforced/steel/dark,/obj/marker/spawning/random/vault_loot/secure,/turf/simulated/floor/plating/reinforced,/area/mission/prefab/city/the_harmbaton/armory)
"aU" = (/obj/structure/table/reinforced/steel/dark,/obj/marker/spawning/random/trash,/turf/simulated/floor/tile/dark,/area/mission/prefab/city/the_harmbaton)
"aV" = (/obj/structure/interactive/restocker/ammo,/turf/simulated/floor/tile/dark,/area/mission/prefab/city/the_harmbaton/firing_range)
"aW" = (/obj/structure/carpet/grey,/turf/simulated/floor/tile/dark,/area/mission/prefab/city/the_harmbaton)
"aX" = (/obj/structure/table/reinforced/steel/dark,/obj/item/magazine/pistol_45,/turf/simulated/floor/tile/dark,/area/mission/prefab/city/the_harmbaton/firing_range)
"aY" = (/obj/structure/carpet/grey,/turf/simulated/floor/tile/dark,/area/mission/prefab/city/the_harmbaton/firing_range)
"aZ" = (/obj/structure/interactive/crate/trash,/obj/marker/spawning/random/trash,/turf/simulated/floor/tile/dark,/area/mission/prefab/city/the_harmbaton)
"ba" = (/turf/simulated/floor/tile/dark,/area/mission/prefab/city/the_harmbaton/firing_range)
"bb" = (/obj/structure/interactive/fire_closet{icon_state = "extinguisher"; dir = 4},/turf/simulated/wall/metal/reinforced,/area/mission/prefab/city/the_harmbaton)
"bc" = (/obj/structure/interactive/fire_closet{icon_state = "extinguisher"; dir = 8},/turf/simulated/wall/metal/reinforced,/area/mission/prefab/city/the_harmbaton)
"bd" = (/obj/structure/table/reinforced/steel/dark,/obj/marker/spawning/random/dangerous,/turf/simulated/floor/tile/dark,/area/mission/prefab/city/the_harmbaton/firing_range)
"be" = (/obj/structure/interactive/lighting/fixture/tube{icon_state = "preview"; dir = 1},/turf/simulated/floor/plating/reinforced,/area/mission/prefab/city/the_harmbaton/firing_range)
"bf" = (/obj/structure/interactive/chair/stool,/turf/simulated/floor/tile/dark,/area/mission/prefab/city/the_harmbaton/firing_range)
"bg" = (/obj/structure/interactive/power/apc,/turf/simulated/wall/metal/reinforced,/area/mission/prefab/city/the_harmbaton/firing_range)
"bh" = (/obj/structure/interactive/door/airlock/dark,/turf/simulated/floor/tile/dark,/area/mission/prefab/city/the_harmbaton/firing_range)
"bi" = (/obj/structure/interactive/fire_closet{icon_state = "extinguisher"; dir = 1},/turf/simulated/wall/metal/reinforced,/area/mission/prefab/city/the_harmbaton/firing_range)
"bj" = (/obj/structure/interactive/light_switch{icon_state = "setup"; dir = 1},/turf/simulated/wall/metal/reinforced,/area/mission/prefab/city/the_harmbaton/firing_range)
"bk" = (/obj/structure/interactive/storage/safe,/turf/simulated/floor/tile/dark,/area/mission/prefab/city/the_harmbaton)
"bl" = (/obj/structure/interactive/storage/safe,/turf/simulated/floor/plating/reinforced,/area/mission/prefab/city/the_harmbaton/armory)
"bm" = (/obj/structure/sign/no_smoking,/turf/simulated/wall/metal/reinforced,/area/mission/prefab/city/the_harmbaton/firing_range)
"bn" = (/obj/structure/sign/secure,/turf/simulated/wall/metal/reinforced,/area/mission/prefab/city/the_harmbaton/armory)
"bo" = (/obj/structure/sign/no_smoking,/turf/simulated/wall/metal/reinforced,/area/mission/prefab/city/the_harmbaton)

(1,1,1) = {"
aPaPacacacacacacacacafafafafafac
asaqacahahahahahaiakaHaIaIaNaVac
aravacahahahahahahaXaYbabababaac
aravacahahahahahahbdaYbabababaac
arawacahahahahahbeakaYbabababfac
arauacacacacacacacbgbmbjbhbiacac
atagamanananananananaFaeaeaeaZab
apaobbaeanaMaeaeaeaeaeaeaeaeaeab
axaxaxaEaybnazaxaxaQaQabalababab
axaAaBaBaCaCaCaAaRbkaeaFaeaeabaa
axaAaBaBaBaBaBaAaRaeaOaUaeaeaSaa
axaJaBaBaBaBaBaKaxaGajajaeaebcaa
axaAaBaBaBaBaBaAaxaeaeaWaWaWaSaa
axaTaBblaLaBaBaTaxaeaeaWaWaWboaa
axaxaxaxaxaxaxaDaxadadadaladabaa
aaaaaaaaaaaaaaaaaoaoaoaoaoaoaoaa
"}
