"aa" = (/turf/dmm_suite/clear_turf,/area/dmm_suite/clear_area)
"ab" = (/turf/simulated/wall/metal/circuit,/area/mission/prefab/city/the_outer_spess)
"ac" = (/obj/structure/interactive/power/apc,/turf/simulated/wall/metal/circuit,/area/mission/prefab/city/the_outer_spess)
"ad" = (/obj/structure/interactive/wire/green,/obj/structure/interactive/door/airlock/station/maintenance,/turf/simulated/floor/plating/reinforced,/area/mission/prefab/city/the_outer_spess)
"ae" = (/obj/structure/interactive/potted_plant/office,/obj/structure/interactive/wire/green,/obj/marker/cover_node/right{icon_state = "right"; dir = 1},/turf/simulated/floor/plating/reinforced,/area/mission/prefab/city/the_outer_spess)
"af" = (/obj/marker/smart_clear_turf,/obj/marker/map_node,/turf/dmm_suite/no_wall,/area/dmm_suite/clear_area)
"ag" = (/obj/structure/interactive/crate/closet,/turf/simulated/floor/plating/reinforced,/area/mission/prefab/city/the_outer_spess)
"ah" = (/obj/structure/interactive/crate/closet,/obj/structure/interactive/lighting/fixture/tube,/turf/simulated/floor/plating/reinforced,/area/mission/prefab/city/the_outer_spess)
"ai" = (/obj/structure/interactive/bookcase,/turf/simulated/floor/plating/reinforced,/area/mission/prefab/city/the_outer_spess)
"aj" = (/turf/simulated/wall/metal/shuttle/off_white,/area/mission/prefab/city/the_outer_spess)
"ak" = (/obj/marker/spawning/window,/turf/simulated/floor/plating,/area/mission/prefab/city/the_outer_spess)
"al" = (/obj/structure/table/reinforced/steel/dark,/obj/item/clothing/head/helmet/full/spacesuit,/turf/simulated/floor/plating/reinforced,/area/mission/prefab/city/the_outer_spess)
"am" = (/turf/simulated/floor/plating/reinforced,/area/mission/prefab/city/the_outer_spess)
"an" = (/obj/structure/interactive/reagent_tank/rolly/water,/turf/simulated/floor/plating/reinforced,/area/mission/prefab/city/the_outer_spess)
"ao" = (/obj/structure/interactive/computer/console,/turf/simulated/floor/tile/shuttle/dark,/area/mission/prefab/city/the_outer_spess)
"ap" = (/obj/structure/table/reinforced/steel/dark,/obj/item/clothing/overwear/hardsuit/spacesuit,/turf/simulated/floor/plating/reinforced,/area/mission/prefab/city/the_outer_spess)
"aq" = (/obj/structure/sign/space,/turf/simulated/wall/metal/shuttle/off_white,/area/mission/prefab/city/the_outer_spess)
"ar" = (/obj/structure/interactive/chair/shuttle{icon_state = "shuttle_chair"; dir = 1},/turf/simulated/floor/tile/shuttle/dark,/area/mission/prefab/city/the_outer_spess)
"as" = (/obj/structure/interactive/intercom{icon_state = "intercom"; dir = 8},/turf/simulated/wall/metal/shuttle/off_white,/area/mission/prefab/city/the_outer_spess)
"at" = (/obj/structure/carpet/grey,/turf/simulated/floor/plating/reinforced,/area/mission/prefab/city/the_outer_spess)
"au" = (/obj/structure/interactive/door/airlock/external,/turf/simulated/floor/plating/shuttle,/area/mission/prefab/city/the_outer_spess)
"av" = (/obj/structure/interactive/lighting/fixture/floor,/turf/simulated/floor/tile/shuttle/dark,/area/mission/prefab/city/the_outer_spess)
"aw" = (/obj/structure/table/reinforced/steel/dark,/obj/item/clothing/overwear/hardsuit/spacesuit,/obj/structure/interactive/lighting/fixture/tube{icon_state = "preview"; dir = 4},/turf/simulated/floor/plating/reinforced,/area/mission/prefab/city/the_outer_spess)
"ax" = (/obj/marker/mission_corpse,/turf/simulated/floor/plating/reinforced,/area/mission/prefab/city/the_outer_spess)
"ay" = (/obj/structure/interactive/fence/corner{icon_state = "corner"; dir = 9},/turf/simulated/floor/plating,/area/dmm_suite/clear_area)
"az" = (/obj/structure/interactive/fence{icon_state = "straight"; dir = 4},/turf/simulated/floor/plating,/area/dmm_suite/clear_area)
"aA" = (/obj/structure/interactive/fence/post{icon_state = "post"; dir = 4},/turf/simulated/floor/plating,/area/dmm_suite/clear_area)
"aB" = (/obj/structure/interactive/fence/door,/turf/simulated/floor/plating,/area/dmm_suite/clear_area)
"aC" = (/obj/structure/interactive/fence/corner{icon_state = "corner"; dir = 4},/turf/simulated/floor/plating,/area/dmm_suite/clear_area)
"aD" = (/obj/structure/interactive/fence,/turf/simulated/floor/plating,/area/dmm_suite/clear_area)
"aE" = (/obj/structure/interactive/power/smes{icon_state = "smes_map"; dir = 4},/obj/structure/interactive/wire/green,/turf/simulated/floor/plating,/area/dmm_suite/clear_area)
"aF" = (/obj/structure/interactive/wire/yellow,/turf/simulated/floor/plating,/area/dmm_suite/clear_area)
"aG" = (/obj/structure/table/reinforced/steel/dark,/turf/simulated/floor/plating/reinforced,/area/mission/prefab/city/the_outer_spess)
"aH" = (/obj/structure/interactive/storage/safe,/turf/simulated/floor/plating/reinforced,/area/mission/prefab/city/the_outer_spess)
"aI" = (/obj/structure/table/reinforced/steel/dark,/obj/structure/interactive/storage/cash_register{icon_state = "register"; dir = 1},/turf/simulated/floor/plating/reinforced,/area/mission/prefab/city/the_outer_spess)
"aJ" = (/obj/structure/interactive/potted_plant/office,/turf/simulated/floor/plating/reinforced,/area/mission/prefab/city/the_outer_spess)
"aK" = (/obj/structure/shuttle_engine/heater,/obj/structure/window/directional/anchored{icon_state = "single"; dir = 1},/turf/simulated/floor/plating/shuttle,/area/mission/prefab/city/the_outer_spess)
"aL" = (/obj/structure/interactive/lighting/fixture/tube{icon_state = "preview"; dir = 1},/obj/marker/cover_node,/turf/simulated/floor/plating/reinforced,/area/mission/prefab/city/the_outer_spess)
"aM" = (/obj/structure/sign/no_smoking,/turf/simulated/wall/metal/circuit,/area/mission/prefab/city/the_outer_spess)
"aN" = (/obj/structure/interactive/solar_panel,/obj/structure/interactive/wire/yellow,/turf/simulated/floor/plating,/area/dmm_suite/clear_area)
"aO" = (/turf/simulated/floor/plating,/area/dmm_suite/clear_area)
"aP" = (/obj/structure/interactive/fence/end,/turf/simulated/floor/plating,/area/dmm_suite/clear_area)
"aQ" = (/obj/structure/shuttle_engine/burst/left,/turf/simulated/floor/plating/shuttle,/area/mission/prefab/city/the_outer_spess)
"aR" = (/obj/structure/shuttle_engine/propulsion,/turf/simulated/floor/plating/shuttle,/area/mission/prefab/city/the_outer_spess)
"aS" = (/obj/structure/shuttle_engine/burst/right,/turf/simulated/floor/plating/shuttle,/area/mission/prefab/city/the_outer_spess)
"aT" = (/obj/structure/carpet/grey,/obj/structure/interactive/door/airlock/glass,/turf/simulated/floor/plating/reinforced,/area/mission/prefab/city/the_outer_spess)
"aU" = (/obj/structure/interactive/bar_sign/the_outer_spess,/turf/simulated/wall/metal/circuit,/area/mission/prefab/city/the_outer_spess)
"aV" = (/turf/dmm_suite/no_wall,/area/dmm_suite/clear_area)
"aW" = (/obj/structure/interactive/wire/green,/obj/marker/map_node,/turf/simulated/floor/plating,/area/dmm_suite/clear_area)
"aX" = (/obj/marker/smart_clear_turf,/turf/dmm_suite/no_wall,/area/dmm_suite/clear_area)
"aY" = (/obj/marker/map_node,/turf/simulated/floor/plating,/area/dmm_suite/clear_area)
"aZ" = (/obj/structure/interactive/wire/green,/obj/marker/map_node,/turf/simulated/floor/plating/reinforced,/area/mission/prefab/city/the_outer_spess)
"ba" = (/obj/marker/map_node,/turf/simulated/floor/plating/reinforced,/area/mission/prefab/city/the_outer_spess)
"bb" = (/obj/marker/mission_mob,/turf/simulated/floor/plating/reinforced,/area/mission/prefab/city/the_outer_spess)
"bc" = (/obj/structure/carpet/grey,/obj/marker/map_node,/turf/simulated/floor/plating/reinforced,/area/mission/prefab/city/the_outer_spess)
"bd" = (/obj/marker/map_node,/turf/simulated/floor/tile/shuttle/dark,/area/mission/prefab/city/the_outer_spess)
"be" = (/obj/marker/map_node,/turf/dmm_suite/no_wall,/area/dmm_suite/clear_area)
"bf" = (/obj/marker/cover_node/right,/turf/simulated/floor/plating/reinforced,/area/mission/prefab/city/the_outer_spess)
"bg" = (/obj/structure/interactive/chair/shuttle{icon_state = "shuttle_chair"; dir = 1},/obj/marker/cover_node/left{icon_state = "left"; dir = 8},/turf/simulated/floor/tile/shuttle/dark,/area/mission/prefab/city/the_outer_spess)
"bh" = (/obj/structure/interactive/lighting/fixture/floor,/obj/marker/cover_node/right{icon_state = "right"; dir = 8},/turf/simulated/floor/tile/shuttle/dark,/area/mission/prefab/city/the_outer_spess)
"bi" = (/obj/marker/mission_corpse,/turf/simulated/floor/tile/shuttle/dark,/area/mission/prefab/city/the_outer_spess)

(1,1,1) = {"
aaaVaVaVaVaVaVaVaVaVaVaVafaVaVaa
aaaVayazazaAazazazaAazazaBaCaVaa
aaaVaDaEaFaFaFaFaNaNaNaNaOaDaVaa
aaaVaPaWaOaOaOaOaOaOaOaOaYaPaVaa
aaabacadabababababababababababaa
aaabaeaZagahagagaiabajajajajabaa
aVakalbabbamamamanakajaoaoajabaa
aXakapamamamamamaxakaqbgarasabaa
aVakalamamamambbatatauavavajabaa
aaabawambaamamamatbcaubdbiajabaa
aVakalamamaGamaHamakajbhavasabaa
aXakapamamaGaIaGaGakajararajabaa
aVakalaxbbamamamaJakajaKaKajabaa
aaabapambaaLbcbcbfaMaQaRaRaSabaa
aaabakakakabaTaTaUabakakakakabaa
aaaaaVaXaVaVbeafaVaVaVaVaXaVaaaa
"}
