"a" = (/turf/dmm_suite/clear_turf,/area/dmm_suite/clear_area)
"b" = (/turf/simulated/wall/metal/reinforced,/area/mission/prefab/city/the_harmbaton)
"c" = (/turf/simulated/floor/plating/reinforced,/area/mission/prefab/city/the_harmbaton)
"d" = (/obj/marker/spawning/window/reinforced,/turf/simulated/floor/plating,/area/mission/prefab/city/the_harmbaton)
"e" = (/turf/simulated/floor/tile/dark,/area/mission/prefab/city/the_harmbaton)
"f" = (/obj/structure/table/simple,/obj/item/weapon/ranged/bullet/magazine/pistol/tactical,/obj/item/weapon/ranged/bullet/magazine/pistol/tactical,/turf/simulated/floor/tile/dark,/area/mission/prefab/city/the_harmbaton)
"g" = (/obj/structure/interactive/wire/green,/turf/simulated/floor/plating,/area/dmm_suite/clear_area)
"h" = (/obj/structure/table/simple,/obj/item/magazine/pistol_45,/obj/item/magazine/pistol_45,/obj/item/magazine/pistol_45,/obj/item/magazine/pistol_45,/turf/simulated/floor/tile/dark,/area/mission/prefab/city/the_harmbaton)
"i" = (/obj/structure/table/reinforced/steel/dark,/obj/item/magazine/pistol_45,/turf/simulated/floor/tile/dark,/area/mission/prefab/city/the_harmbaton)
"j" = (/obj/structure/table/reinforced/steel/dark,/turf/simulated/floor/tile/dark,/area/mission/prefab/city/the_harmbaton)
"k" = (/obj/structure/interactive/power/apc,/turf/simulated/wall/metal/reinforced,/area/mission/prefab/city/the_harmbaton)
"l" = (/obj/structure/interactive/door/airlock/dark,/turf/simulated/floor/tile/dark,/area/mission/prefab/city/the_harmbaton)
"m" = (/obj/structure/interactive/door/airlock/dark,/obj/structure/interactive/wire/green,/turf/simulated/floor/tile/dark,/area/mission/prefab/city/the_harmbaton)
"n" = (/obj/structure/interactive/wire/green,/turf/simulated/floor/tile/dark,/area/mission/prefab/city/the_harmbaton)
"o" = (/turf/simulated/floor/plating,/area/dmm_suite/clear_area)
"p" = (/obj/structure/interactive/fence/end,/turf/simulated/floor/plating,/area/dmm_suite/clear_area)
"q" = (/obj/structure/interactive/fence/end{icon_state = "end"; dir = 8},/turf/simulated/floor/plating,/area/dmm_suite/clear_area)
"r" = (/obj/structure/interactive/fence,/turf/simulated/floor/plating,/area/dmm_suite/clear_area)
"s" = (/obj/structure/interactive/fence/corner{icon_state = "corner"; dir = 9},/turf/simulated/floor/plating,/area/dmm_suite/clear_area)
"t" = (/obj/structure/interactive/fence/door{icon_state = "door_opened"; dir = 8},/turf/simulated/floor/plating,/area/dmm_suite/clear_area)
"u" = (/obj/structure/interactive/power/smes{icon_state = "smes_map"; dir = 1},/obj/structure/interactive/wire/green,/turf/simulated/floor/plating,/area/dmm_suite/clear_area)
"v" = (/obj/structure/interactive/solar_panel,/obj/structure/interactive/wire/yellow,/turf/simulated/floor/plating,/area/dmm_suite/clear_area)
"w" = (/obj/structure/interactive/wire/yellow,/turf/simulated/floor/plating,/area/dmm_suite/clear_area)
"x" = (/turf/simulated/wall/metal/reinforced,/area/mission/prefab/city/the_harmbaton/armory)
"y" = (/obj/structure/interactive/door/vault,/obj/structure/interactive/wire/green,/turf/simulated/floor/tile/dark,/area/mission/prefab/city/the_harmbaton/armory)
"z" = (/obj/structure/interactive/power/apc,/turf/simulated/wall/metal/reinforced,/area/mission/prefab/city/the_harmbaton/armory)
"A" = (/obj/structure/table/reinforced/steel/dark,/obj/marker/spawning/random/dangerous,/turf/simulated/floor/plating/reinforced,/area/mission/prefab/city/the_harmbaton/armory)
"B" = (/turf/simulated/floor/plating/reinforced,/area/mission/prefab/city/the_harmbaton/armory)
"C" = (/obj/structure/interactive/wire/green,/turf/simulated/floor/plating/reinforced,/area/mission/prefab/city/the_harmbaton/armory)
"D" = (/obj/structure/interactive/bar_sign/the_harmbaton,/turf/simulated/wall/metal/reinforced,/area/mission/prefab/city/the_harmbaton/armory)
"E" = (/obj/structure/interactive/light_switch,/turf/simulated/wall/metal/reinforced,/area/mission/prefab/city/the_harmbaton/armory)
"F" = (/obj/structure/interactive/lighting/fixture/tube,/turf/simulated/floor/tile/dark,/area/mission/prefab/city/the_harmbaton)
"G" = (/obj/structure/table/reinforced/steel/dark,/obj/structure/interactive/lighting/fixture/tube{icon_state = "preview"; dir = 4},/turf/simulated/floor/tile/dark,/area/mission/prefab/city/the_harmbaton)
"H" = (/obj/structure/interactive/lighting/fixture/tube,/turf/simulated/floor/plating/reinforced,/area/mission/prefab/city/the_harmbaton)
"I" = (/obj/structure/interactive/lighting/fixture/tube{icon_state = "preview"; dir = 1},/turf/simulated/floor/plating/reinforced,/area/mission/prefab/city/the_harmbaton)
"J" = (/obj/structure/table/reinforced/steel/dark,/obj/marker/spawning/random/dangerous,/obj/structure/interactive/lighting/fixture/tube{icon_state = "preview"; dir = 4},/turf/simulated/floor/plating/reinforced,/area/mission/prefab/city/the_harmbaton/armory)
"K" = (/obj/structure/table/reinforced/steel/dark,/obj/marker/spawning/random/dangerous,/obj/structure/interactive/lighting/fixture/tube{icon_state = "preview"; dir = 8},/turf/simulated/floor/plating/reinforced,/area/mission/prefab/city/the_harmbaton/armory)
"L" = (/obj/structure/interactive/lighting/fixture/tube{icon_state = "preview"; dir = 1},/turf/simulated/floor/plating/reinforced,/area/mission/prefab/city/the_harmbaton/armory)
"M" = (/obj/structure/interactive/lighting/fixture/tube{icon_state = "preview"; dir = 1},/turf/simulated/floor/tile/dark,/area/mission/prefab/city/the_harmbaton)
"N" = (/obj/structure/interactive/restocker/ammo,/turf/simulated/floor/tile/dark,/area/mission/prefab/city/the_harmbaton)
"O" = (/obj/structure/interactive/chair/office/dark,/turf/simulated/floor/tile/dark,/area/mission/prefab/city/the_harmbaton)
"P" = (/turf/dmm_suite/no_wall,/area/dmm_suite/clear_area)

(1,1,1) = {"
PPbbbbbbbbbbbbbb
sqbcccccHdeffhNb
rvbccccccieeeeeb
rvbccccccjeeeeeb
rwbcccccIdeeeeeb
rubbbbbbbkbblbbb
tgmnnnnnnnFeeeeb
pobenMeeeeeeeeeb
xxxEyxzxxbbblbbb
xABBCCCAxeeFeeba
xABBBBBAxeOjeeba
xJBBBBBKxGjjeeba
xABBBBBAxeeeeeba
xABBLBBAxeeeeeba
xxxxxxxDxdddldba
aaaaaaaaoooooooa
"}
