//MAP CONVERTED BY dmm2tgm.py THIS HEADER COMMENT PREVENTS RECONVERSION, DO NOT REMOVE
"aa" = (
/turf/dmm_suite/clear_turf,
/area/dmm_suite/clear_area)
"ab" = (
/turf/simulated/wall/metal/reinforced,
/area/mission/prefab/city/the_harmbaton)
"ac" = (
/turf/simulated/wall/metal/reinforced,
/area/mission/prefab/city/the_harmbaton/firing_range)
"ad" = (
/obj/marker/spawning/window/reinforced,
/turf/simulated/floor/plating,
/area/mission/prefab/city/the_harmbaton)
"ae" = (
/turf/simulated/floor/tile/dark,
/area/mission/prefab/city/the_harmbaton)
"af" = (
/obj/decal/poster/nanotrasen,
/turf/simulated/wall/metal/reinforced,
/area/mission/prefab/city/the_harmbaton/firing_range)
"ag" = (
/obj/structure/interactive/wire/green,
/turf/simulated/floor/plating,
/area/dmm_suite/clear_area)
"ah" = (
/turf/simulated/floor/plating/reinforced,
/area/mission/prefab/city/the_harmbaton/firing_range)
"ai" = (
/obj/structure/interactive/lighting/fixture/tube,
/turf/simulated/floor/plating/reinforced,
/area/mission/prefab/city/the_harmbaton/firing_range)
"aj" = (
/obj/structure/table/reinforced/steel/dark,
/turf/simulated/floor/tile/dark,
/area/mission/prefab/city/the_harmbaton)
"ak" = (
/obj/marker/spawning/window/reinforced,
/turf/simulated/floor/plating,
/area/mission/prefab/city/the_harmbaton/firing_range)
"al" = (
/obj/structure/interactive/door/airlock/dark,
/turf/simulated/floor/tile/dark,
/area/mission/prefab/city/the_harmbaton)
"am" = (
/obj/structure/interactive/door/airlock/dark,
/obj/structure/interactive/wire/green,
/turf/simulated/floor/tile/dark,
/area/mission/prefab/city/the_harmbaton)
"an" = (
/obj/structure/interactive/wire/green,
/turf/simulated/floor/tile/dark,
/area/mission/prefab/city/the_harmbaton)
"ao" = (
/turf/simulated/floor/plating,
/area/dmm_suite/clear_area)
"ap" = (
/obj/structure/interactive/fence/end,
/turf/simulated/floor/plating,
/area/dmm_suite/clear_area)
"aq" = (
/obj/structure/interactive/fence/end{
	icon_state = "end";
	dir = 8
	},
/turf/simulated/floor/plating,
/area/dmm_suite/clear_area)
"ar" = (
/obj/structure/interactive/fence,
/turf/simulated/floor/plating,
/area/dmm_suite/clear_area)
"as" = (
/obj/structure/interactive/fence/corner{
	icon_state = "corner";
	dir = 9
	},
/turf/simulated/floor/plating,
/area/dmm_suite/clear_area)
"at" = (
/obj/structure/interactive/fence/door{
	icon_state = "door_opened";
	dir = 8
	},
/turf/simulated/floor/plating,
/area/dmm_suite/clear_area)
"au" = (
/obj/structure/interactive/power/smes{
	icon_state = "smes_map";
	dir = 1
	},
/obj/structure/interactive/wire/green,
/turf/simulated/floor/plating,
/area/dmm_suite/clear_area)
"av" = (
/obj/structure/interactive/solar_panel,
/obj/structure/interactive/wire/yellow,
/turf/simulated/floor/plating,
/area/dmm_suite/clear_area)
"aw" = (
/obj/structure/interactive/wire/yellow,
/turf/simulated/floor/plating,
/area/dmm_suite/clear_area)
"ax" = (
/turf/simulated/wall/metal/reinforced,
/area/mission/prefab/city/the_harmbaton/armory)
"ay" = (
/obj/structure/interactive/door/vault,
/obj/structure/interactive/wire/green,
/turf/simulated/floor/tile/dark,
/area/mission/prefab/city/the_harmbaton/armory)
"az" = (
/obj/structure/interactive/power/apc,
/turf/simulated/wall/metal/reinforced,
/area/mission/prefab/city/the_harmbaton/armory)
"aA" = (
/obj/structure/table/reinforced/steel/dark,
/obj/marker/spawning/random/dangerous,
/turf/simulated/floor/plating/reinforced,
/area/mission/prefab/city/the_harmbaton/armory)
"aB" = (
/turf/simulated/floor/plating/reinforced,
/area/mission/prefab/city/the_harmbaton/armory)
"aC" = (
/obj/structure/interactive/wire/green,
/turf/simulated/floor/plating/reinforced,
/area/mission/prefab/city/the_harmbaton/armory)
"aD" = (
/obj/structure/interactive/bar_sign/the_harmbaton,
/turf/simulated/wall/metal/reinforced,
/area/mission/prefab/city/the_harmbaton/armory)
"aE" = (
/obj/structure/interactive/light_switch,
/turf/simulated/wall/metal/reinforced,
/area/mission/prefab/city/the_harmbaton/armory)
"aF" = (
/obj/structure/interactive/lighting/fixture/tube,
/turf/simulated/floor/tile/dark,
/area/mission/prefab/city/the_harmbaton)
"aG" = (
/obj/structure/table/reinforced/steel/dark,
/obj/structure/interactive/lighting/fixture/tube{
	icon_state = "preview";
	dir = 4
	},
/obj/structure/interactive/storage/cash_register{
	icon_state = "register";
	dir = 1
	},
/turf/simulated/floor/tile/dark,
/area/mission/prefab/city/the_harmbaton)
"aH" = (
/obj/structure/carpet/grey,
/obj/structure/interactive/crate/trash,
/obj/marker/spawning/random/trash,
/turf/simulated/floor/tile/dark,
/area/mission/prefab/city/the_harmbaton/firing_range)
"aI" = (
/obj/structure/table/simple,
/obj/item/weapon/ranged/bullet/magazine/pistol/tactical,
/obj/item/weapon/ranged/bullet/magazine/pistol/tactical,
/turf/simulated/floor/tile/dark,
/area/mission/prefab/city/the_harmbaton/firing_range)
"aJ" = (
/obj/structure/table/reinforced/steel/dark,
/obj/marker/spawning/random/dangerous,
/obj/structure/interactive/lighting/fixture/tube{
	icon_state = "preview";
	dir = 4
	},
/turf/simulated/floor/plating/reinforced,
/area/mission/prefab/city/the_harmbaton/armory)
"aK" = (
/obj/structure/table/reinforced/steel/dark,
/obj/marker/spawning/random/dangerous,
/obj/structure/interactive/lighting/fixture/tube{
	icon_state = "preview";
	dir = 8
	},
/turf/simulated/floor/plating/reinforced,
/area/mission/prefab/city/the_harmbaton/armory)
"aL" = (
/obj/structure/interactive/lighting/fixture/tube{
	icon_state = "preview";
	dir = 1
	},
/turf/simulated/floor/plating/reinforced,
/area/mission/prefab/city/the_harmbaton/armory)
"aM" = (
/obj/structure/interactive/lighting/fixture/tube{
	icon_state = "preview";
	dir = 1
	},
/turf/simulated/floor/tile/dark,
/area/mission/prefab/city/the_harmbaton)
"aN" = (
/obj/structure/table/simple,
/obj/item/magazine/pistol_45,
/obj/item/magazine/pistol_45,
/obj/item/magazine/pistol_45,
/obj/item/magazine/pistol_45,
/turf/simulated/floor/tile/dark,
/area/mission/prefab/city/the_harmbaton/firing_range)
"aO" = (
/obj/structure/interactive/chair/office/dark,
/mob/living/advanced/npc/zombie/security,
/turf/simulated/floor/tile/dark,
/area/mission/prefab/city/the_harmbaton)
"aP" = (
/turf/dmm_suite/no_wall,
/area/dmm_suite/clear_area)
"aQ" = (
/obj/decal/poster/nanotrasen,
/turf/simulated/wall/metal/reinforced,
/area/mission/prefab/city/the_harmbaton)
"aR" = (
/obj/decal/poster/nanotrasen{
	icon_state = "";
	dir = 4
	},
/turf/simulated/wall/metal/reinforced,
/area/mission/prefab/city/the_harmbaton/armory)
"aS" = (
/obj/decal/poster/nanotrasen{
	icon_state = "";
	dir = 8
	},
/turf/simulated/wall/metal/reinforced,
/area/mission/prefab/city/the_harmbaton)
"aT" = (
/obj/structure/table/reinforced/steel/dark,
/obj/marker/spawning/random/vault_loot/secure,
/turf/simulated/floor/plating/reinforced,
/area/mission/prefab/city/the_harmbaton/armory)
"aU" = (
/obj/structure/table/reinforced/steel/dark,
/obj/marker/spawning/random/trash,
/turf/simulated/floor/tile/dark,
/area/mission/prefab/city/the_harmbaton)
"aV" = (
/obj/structure/interactive/restocker/ammo,
/turf/simulated/floor/tile/dark,
/area/mission/prefab/city/the_harmbaton/firing_range)
"aW" = (
/obj/structure/carpet/grey,
/turf/simulated/floor/tile/dark,
/area/mission/prefab/city/the_harmbaton)
"aX" = (
/obj/structure/table/reinforced/steel/dark,
/obj/item/magazine/pistol_45,
/turf/simulated/floor/tile/dark,
/area/mission/prefab/city/the_harmbaton/firing_range)
"aY" = (
/obj/structure/carpet/grey,
/turf/simulated/floor/tile/dark,
/area/mission/prefab/city/the_harmbaton/firing_range)
"aZ" = (
/obj/structure/interactive/crate/trash,
/obj/marker/spawning/random/trash,
/turf/simulated/floor/tile/dark,
/area/mission/prefab/city/the_harmbaton)
"ba" = (
/turf/simulated/floor/tile/dark,
/area/mission/prefab/city/the_harmbaton/firing_range)
"bb" = (
/obj/structure/interactive/fire_closet{
	icon_state = "extinguisher";
	dir = 4
	},
/turf/simulated/wall/metal/reinforced,
/area/mission/prefab/city/the_harmbaton)
"bc" = (
/obj/structure/interactive/fire_closet{
	icon_state = "extinguisher";
	dir = 8
	},
/turf/simulated/wall/metal/reinforced,
/area/mission/prefab/city/the_harmbaton)
"bd" = (
/obj/structure/table/reinforced/steel/dark,
/obj/marker/spawning/random/dangerous,
/turf/simulated/floor/tile/dark,
/area/mission/prefab/city/the_harmbaton/firing_range)
"be" = (
/obj/structure/interactive/lighting/fixture/tube{
	icon_state = "preview";
	dir = 1
	},
/turf/simulated/floor/plating/reinforced,
/area/mission/prefab/city/the_harmbaton/firing_range)
"bf" = (
/obj/structure/interactive/chair/stool,
/turf/simulated/floor/tile/dark,
/area/mission/prefab/city/the_harmbaton/firing_range)
"bg" = (
/obj/structure/interactive/power/apc,
/turf/simulated/wall/metal/reinforced,
/area/mission/prefab/city/the_harmbaton/firing_range)
"bh" = (
/obj/structure/interactive/door/airlock/dark,
/turf/simulated/floor/tile/dark,
/area/mission/prefab/city/the_harmbaton/firing_range)
"bi" = (
/obj/structure/interactive/fire_closet{
	icon_state = "extinguisher";
	dir = 1
	},
/turf/simulated/wall/metal/reinforced,
/area/mission/prefab/city/the_harmbaton/firing_range)
"bj" = (
/obj/structure/interactive/light_switch{
	icon_state = "setup";
	dir = 1
	},
/turf/simulated/wall/metal/reinforced,
/area/mission/prefab/city/the_harmbaton/firing_range)
"bk" = (
/obj/structure/interactive/storage/safe,
/turf/simulated/floor/tile/dark,
/area/mission/prefab/city/the_harmbaton)
"bl" = (
/obj/structure/interactive/storage/safe,
/turf/simulated/floor/plating/reinforced,
/area/mission/prefab/city/the_harmbaton/armory)
"bm" = (
/obj/structure/sign/no_smoking,
/turf/simulated/wall/metal/reinforced,
/area/mission/prefab/city/the_harmbaton/firing_range)
"bn" = (
/obj/structure/sign/secure,
/turf/simulated/wall/metal/reinforced,
/area/mission/prefab/city/the_harmbaton/armory)
"bo" = (
/obj/structure/sign/no_smoking,
/turf/simulated/wall/metal/reinforced,
/area/mission/prefab/city/the_harmbaton)
"bp" = (
/mob/living/advanced/npc/zombie/security{
	icon_state = "directional";
	dir = 4
	},
/turf/simulated/floor/plating/reinforced,
/area/mission/prefab/city/the_harmbaton/armory)
"bq" = (
/obj/structure/interactive/wire/green,
/mob/living/advanced/npc/zombie/security{
	icon_state = "directional";
	dir = 8
	},
/turf/simulated/floor/plating/reinforced,
/area/mission/prefab/city/the_harmbaton/armory)
"br" = (
/mob/living/advanced/npc/zombie/security{
	icon_state = "directional";
	dir = 8
	},
/turf/simulated/floor/tile/dark,
/area/mission/prefab/city/the_harmbaton/firing_range)
"bs" = (
/mob/living/advanced/npc/zombie/civilian{
	icon_state = "directional";
	dir = 8
	},
/turf/simulated/floor/tile/dark,
/area/mission/prefab/city/the_harmbaton)
"bt" = (
/mob/living/advanced/npc/zombie/civilian{
	icon_state = "directional";
	dir = 4
	},
/turf/simulated/floor/tile/dark,
/area/mission/prefab/city/the_harmbaton)

(1,1,1) = {"
aP
as
ar
ar
ar
ar
at
ap
ax
ax
ax
ax
ax
ax
ax
aa
"}
(2,1,1) = {"
aP
aq
av
av
aw
au
ag
ao
ax
aA
aA
aJ
aA
aT
ax
aa
"}
(3,1,1) = {"
ac
ac
ac
ac
ac
ac
am
bb
ax
bp
aB
aB
aB
aB
ax
aa
"}
(4,1,1) = {"
ac
ah
ah
ah
ah
ac
an
ae
aE
aB
aB
aB
aB
bl
ax
aa
"}
(5,1,1) = {"
ac
ah
ah
ah
ah
ac
an
an
ay
aC
aB
aB
aB
aL
ax
aa
"}
(6,1,1) = {"
ac
ah
ah
ah
ah
ac
an
aM
bn
aC
aB
aB
aB
aB
ax
aa
"}
(7,1,1) = {"
ac
ah
ah
ah
ah
ac
an
ae
az
bq
aB
aB
aB
aB
ax
aa
"}
(8,1,1) = {"
ac
ah
ah
ah
ah
ac
an
ae
ax
aA
aA
aK
aA
aT
aD
aa
"}
(9,1,1) = {"
ac
ai
ah
ah
be
ac
an
ae
ax
aR
aR
ax
ax
ax
ax
ao
"}
(10,1,1) = {"
ac
ak
aX
bd
ak
bg
an
ae
aQ
bk
ae
aG
ae
bt
ad
ao
"}
(11,1,1) = {"
af
aH
aY
aY
aY
bm
aF
ae
aQ
ae
aO
aj
ae
ae
ad
ao
"}
(12,1,1) = {"
af
aI
ba
br
ba
bj
ae
ae
ab
aF
aU
aj
aW
aW
ad
ao
"}
(13,1,1) = {"
af
aI
ba
ba
ba
bh
ae
ae
al
ae
ae
ae
aW
aW
al
ao
"}
(14,1,1) = {"
af
aN
br
ba
ba
bi
ae
ae
ab
ae
bs
ae
aW
aW
ad
ao
"}
(15,1,1) = {"
af
aV
ba
ba
bf
ac
aZ
ae
ab
ab
aS
bc
aS
bo
ab
ao
"}
(16,1,1) = {"
ac
ac
ac
ac
ac
ac
ab
ab
ab
aa
aa
aa
aa
aa
aa
aa
"}
