"a" = (/turf/dmm_suite/clear_turf,/area/dmm_suite/clear_area)
"b" = (/obj/marker/spawning/window,/turf/simulated/floor/plating,/area/mission/prefab/city/the_net)
"c" = (/turf/simulated/wall/metal/circuit,/area/mission/prefab/city/the_net)
"d" = (/obj/decal/poster/nanotrasen,/turf/simulated/wall/metal/circuit,/area/mission/prefab/city/the_net)
"e" = (/obj/structure/interactive/door/airlock/dark,/turf/simulated/floor/tile/dark/single,/area/mission/prefab/city/the_net)
"f" = (/turf/simulated/floor/plating/reinforced,/area/mission/prefab/city/the_net)
"g" = (/obj/structure/interactive/potted_plant/nanotrasen,/turf/simulated/floor/tile/morphing/green,/area/mission/prefab/city/the_net)
"h" = (/turf/simulated/floor/tile/morphing/green,/area/mission/prefab/city/the_net)
"i" = (/obj/structure/interactive/chair/office/dark,/turf/simulated/floor/tile/morphing/green,/area/mission/prefab/city/the_net)
"j" = (/obj/structure/interactive/chair/office/dark{icon_state = "officechair_dark"; dir = 8},/turf/simulated/floor/tile/morphing/green,/area/mission/prefab/city/the_net)
"k" = (/obj/structure/interactive/chair/office/dark{icon_state = "officechair_dark"; dir = 4},/turf/simulated/floor/tile/morphing/green,/area/mission/prefab/city/the_net)
"l" = (/obj/structure/interactive/chair{icon_state = "chair"; dir = 4},/turf/simulated/floor/tile/morphing/green,/area/mission/prefab/city/the_net)
"m" = (/turf/simulated/floor/tile/dark/single,/area/mission/prefab/city/the_net)
"n" = (/obj/structure/table/steel/dark,/turf/simulated/floor/tile/dark/single,/area/mission/prefab/city/the_net)
"o" = (/obj/structure/interactive/chair{icon_state = "chair"; dir = 8},/turf/simulated/floor/tile/morphing/green,/area/mission/prefab/city/the_net)
"p" = (/obj/decal/poster/nanotrasen{icon_state = ""; dir = 4},/turf/simulated/wall/metal/circuit,/area/mission/prefab/city/the_net)
"q" = (/obj/structure/interactive/chair/office/dark{icon_state = "officechair_dark"; dir = 8},/turf/simulated/floor/tile/dark/single,/area/mission/prefab/city/the_net)
"r" = (/obj/structure/interactive/chair/office/dark,/turf/simulated/floor/tile/dark/single,/area/mission/prefab/city/the_net)
"s" = (/obj/structure/interactive/chair/office/dark{icon_state = "officechair_dark"; dir = 4},/turf/simulated/floor/tile/dark/single,/area/mission/prefab/city/the_net)
"t" = (/obj/decal/poster/nanotrasen{icon_state = ""; dir = 8},/turf/simulated/wall/metal/circuit,/area/mission/prefab/city/the_net)
"u" = (/obj/structure/interactive/bar_sign/the_net,/turf/simulated/wall/metal/circuit,/area/mission/prefab/city/the_net)
"v" = (/obj/structure/interactive/lighting/fixture/bulb/green{icon_state = "preview"; dir = 1},/turf/simulated/floor/plating/reinforced,/area/mission/prefab/city/the_net)
"w" = (/obj/structure/interactive/lighting/fixture/bulb/green,/turf/simulated/floor/plating/reinforced,/area/mission/prefab/city/the_net)
"x" = (/obj/structure/interactive/chair{icon_state = "chair"; dir = 4},/obj/structure/interactive/lighting/fixture/tube/fluorescent{icon_state = "preview"; dir = 4},/turf/simulated/floor/tile/morphing/green,/area/mission/prefab/city/the_net)
"y" = (/obj/structure/interactive/chair{icon_state = "chair"; dir = 8},/obj/structure/interactive/lighting/fixture/tube/fluorescent{icon_state = "preview"; dir = 8},/turf/simulated/floor/tile/morphing/green,/area/mission/prefab/city/the_net)
"z" = (/obj/structure/table/steel/dark,/obj/structure/interactive/storage/cash_register{icon_state = "register"; dir = 1},/turf/simulated/floor/tile/dark/single,/area/mission/prefab/city/the_net)
"A" = (/obj/structure/interactive/wire/green,/turf/simulated/floor/plating,/area/dmm_suite/clear_area)
"B" = (/obj/structure/interactive/fence/corner{icon_state = "corner"; dir = 9},/obj/structure/interactive/wire/green,/turf/simulated/floor/plating,/area/dmm_suite/clear_area)
"C" = (/obj/structure/interactive/fence/door,/obj/structure/interactive/wire/green,/turf/simulated/floor/plating,/area/dmm_suite/clear_area)
"D" = (/obj/structure/interactive/fence{icon_state = "straight"; dir = 4},/turf/simulated/floor/plating,/area/dmm_suite/clear_area)
"E" = (/obj/structure/interactive/fence/corner{icon_state = "corner"; dir = 5},/turf/simulated/floor/plating,/area/dmm_suite/clear_area)
"F" = (/obj/structure/interactive/fence/end,/turf/simulated/floor/plating,/area/dmm_suite/clear_area)
"G" = (/obj/structure/interactive/power/smes{icon_state = "smes_map"; dir = 4},/obj/structure/interactive/wire/yellow,/turf/simulated/floor/plating,/area/dmm_suite/clear_area)
"H" = (/obj/structure/interactive/solar_panel,/obj/structure/interactive/wire/yellow,/turf/simulated/floor/plating,/area/dmm_suite/clear_area)
"I" = (/obj/structure/interactive/door/airlock/dark,/obj/structure/interactive/wire/green,/turf/simulated/floor/tile/dark/single,/area/mission/prefab/city/the_net)
"J" = (/obj/structure/interactive/wire/green,/turf/simulated/floor/tile/morphing/green,/area/mission/prefab/city/the_net)
"K" = (/obj/structure/interactive/wire/green,/turf/simulated/floor/tile/dark/single,/area/mission/prefab/city/the_net)
"L" = (/obj/structure/interactive/power/apc{icon_state = "apc"; dir = 1},/turf/simulated/wall/metal/circuit,/area/mission/prefab/city/the_net)
"M" = (/turf/dmm_suite/no_wall,/area/dmm_suite/clear_area)

(1,1,1) = {"
aaMMABCDDDDDDEaa
aaMMAFAGHHHHHFaa
bbcdIddddddddcbb
bfbgJijkkijhgbfb
bvblKnnnnnnmobvb
bcpxKqrqsqrmytcb
bwblKnnnnnnmobwb
bvblKsrsrqqmobvb
bcpxKnnnnnnmytcb
bwblKmmmmmmmobwb
bvblKmmmmmmmobvb
bcpxKmnqrnmmytcb
bwblKmnznnmmobwb
bfbgJhmmmmhhgbfb
bbucLhmmmmhcucbb
MMMMcbbeebbcMMMM
"}
