"a" = (/turf/simulated/wall/rock,/area/overworld/rain)
"b" = (/turf/simulated/wall/river,/area/overworld/rain)
"c" = (/turf/simulated/wall/rock/basalt,/area/overworld/rain)
"d" = (/turf/simulated/floor/chasm,/area/overworld/rain)
"e" = (/turf/simulated/floor/colored/grass/jungle,/area/overworld/rain)
"f" = (/turf/simulated/floor/basalt,/area/overworld/rain)
"g" = (/turf/simulated/floor/colored/dirt/jungle,/area/overworld/rain)
"h" = (/turf/simulated/floor/lava,/area/overworld/rain)
"i" = (/turf/simulated/floor/wood/dock,/area/overworld/rain)
"j" = (/obj/structure/interactive/nature/rocks,/turf/simulated/floor/colored/dirt/jungle,/area/overworld/rain)
"k" = (/turf/simulated/floor/cave_dirt,/area/overworld/rain)
"l" = (/turf/simulated/wall/metal/rusted,/area/overworld/rain)
"m" = (/turf/simulated/floor/ash,/area/overworld/rain)
"n" = (/obj/structure/interactive/nature/rocks,/turf/simulated/floor/cave_dirt,/area/overworld/rain)
"o" = (/obj/structure/interactive/nature/rocks,/turf/simulated/floor/basalt,/area/overworld/rain)
"p" = (/obj/structure/interactive/nature/rocks,/turf/simulated/floor/colored/grass/jungle,/area/overworld/rain)
"q" = (/obj/marker/spawnpoint/new_character,/turf/simulated/floor/colored/grass/jungle,/area/overworld/rain)

(1,1,1) = {"
aaaaaaaaaaaaaaaaaaaaaaaaaaaaaaaaaaaaaaaaaaaaaaaaaaaaaaaaaaaaaaaaaaaaaaaaaaabbbbbbbbbbbbbbbbbbbbbbbbaaaaaaaaaaaaaaaaaaaaaaaaaaaaa
aaaaaaaaaaaaacccccccccccccccaaaaaaaaaaaaaaaaaaaaaaaaaaaaaaaaaaaaaaaaaaaaaaabbbbbbbbbbbbbbbbbbbbbbbbaaaaaaaaaaaaaaaaaaaaaaaaaaaaa
aaaaaaaaaaccccccccccdccccccccaaaaaaaaaaaaaaaaaaaaaaaaaaaaaaaaaaaaaaaaaeeeebbbbbbbbbbbbbbbbbbbbbbbbbfffffgffaaaaaaaaaaaaaaaaaaaaa
aaaaaaaaaccccccdddddddfffcccceeeeeeeeeeeeeeeaaaaaaaaaaaeeeeeeeeeeeeeeeeeeebbbbbbbbbbbbbbbbbbbbbbbbbffhhfffffffffffgeeeeeeaaaaaaa
aaaaaaaaccccddddddddffffccccceeeeeeeeeeeeeeeeeeebbeeeeeeeeeeeeeeeeeeeeeeebbbbbbbbbbbbbbbbbbbbbbbbbbgfhhhhhfffffffggeeeeeeaaaaaaa
aaaaaaaccccddddddffffccccccceeeeeeeeeeeeeeeeeeebbbeeeeeeeeeeeeeeeeeeeeeeebbbbbbbbbbbbbbbbbbbbbbbbbggfhhhhffffffggggeeeeeeeaaaaaa
aaaaaacccdddddddfffffccceeeeeeeeeeeeeeeeeeeeeeeebbbeeeeeeeeeeeeeeeeeeeeebbbbbbbbbbbbbbbbbbbbbbbbbbggfffffffffgggggeeeeeeeeeeaaaa
aaaaacccdddddddfffffcccceeeeeeeeeeeeeeeeeeeeeeeebbbbeeeeeeeeeeeeeeeeeeeebbbbbbbbbbbbbbbbbbbbbbbbbbgggfffffffggggeeeeeeeeeeeaaaaa
aaaacccdddddddffffffccceeeeeeeeeeeeeeeeeeeeeeeeeebbbeeeeeeeeeeeeeeeeeeeebbbbbbbbbbbbbbbbbbbbbbbbbbffffffffgggggeeeeeeeeeeeeaaaaa
aaaacccdddddfffhhfffcccfeeeeeeeeeeeeeeeeeeeeeeeeebbbbeeeeeeeeeeeeeeeeeeebbbbbbbbbbbbbbbbbbbbbbbbfffffffffgggeeeeeeeeeeeeeeeeaaaa
aaaccccddddffhhhhffccccfeeeeeeeeeeeeeeeeeeeeeeeeeiiiieeeeeeeeeeeeeeeeeeeebbbbbbbbbbbbbbbbbbbbbbfffffgggggggeeeeeeeeeeeeeeeeeaaaa
aaacccdddddffhhhfffccccffeeeeeeeeeeeeeeeeeeeeeeeeiiiieeeeeeeggeeeeeeeeeeeebbbbbbbbbbbbbbbbbbbbbggggggeeeggeeeeeeeeeeeeeeeeeeeaaa
aaaccddddddfhhhhfffcccccffeeeeeeeeeeeeeeeeeeeeeeebbbbeeegggggggeeeeeeeeeeeebbbbbbbbbbbbbbbbbbbeeeeeeeeeeeeeeeeeeeeeeeeeeeeeeeaaa
aaccddddddffhhhggffccccccfeeeeeeeeeeeeeeeeeeeeeeebbbbeeggggggggeggeeeeeeeeeeebbbbbbbbbbbbbbbbbbeeeeeeeeeeeeeeeeeeeeeeeeeeeeeeaaa
aaccddddddfhhhhgggfffccccfeeeeeeeeeeeeeeeeeeeeeeebebbbeggggggggggggeeeeeeeeeeebbbbbbbbbbbbbbbbbbeeeeeeeeeeeeeeeeeeeeeeeeeeeeeeaa
aaccddddddfhhhggggfffccccffggeeeeeeeeeeeeeeeeeeeebebbbbbggggggggggggeeeeeeeeeeebbbbbbbbbbbbbbbbbbeeeeeeeeeeeeeeeeeeeeeeeeeeeeeaa
acccdddddffhhhggggffffccccfgggeeeeeeeeeeeeeeeeeeeeeebbbbgggggggggggggeeeeeeeeeeebbbbbbbbbbbbbbbbeeeeeeeeeeeeeeeeeeeeeeeeeeeeeeaa
accdddddfffhgggggjjggfffccfgggeeeeeeeeeeeeeeeeeeeeeebbbbgggffffffffgggeeeeeeeeeeebbbbbbbbbbbbbbbeeeeeeeeeeeeeeeeeeeeeeeeeeeeeeea
aacddddfffggggggggjjgfffccfgggeeeeeeeeeeeeeeeeeeeeeebbbbggfhhhfffffeeeeeeeeeeeeeeebbbbbbbbbbbbbbbeeeeeeeeeeeeeeeeeeeeggeeeeeeeea
aacdddfffgggjggggggjgggffffgggeeeeeeeeeeeeeeeeeeeeeebbbbgfhhhhhhhffeeeeeeeeeeeeeeeebbbbbbbbbbbbbbbbbbbeeeeeeeeeeeeeeegggeeeeeeea
accddfffggjjjggggggjjgggggggggegeeeeeeeeeeeeeeeeeeeebbbbffhhhhhhhfffeeeeeeeeeeeeeeeebbbbbbbbbbbbbbbbbbbeeeeeeeeeeeeeeggggeeeeeaa
accdfffggjjgggggggggjjggggggggggeeeeeeeeeeeeeeeeeeeebbbbfffhhhhhfffeeeeeeeeeeeeeeebbbbbbbbbbbbbbbbbbbbbeeeeeeeeeeeeeegggggeeeeaa
accddffgjjgggggjjjjggjgggeeggggeeeeeeeeeeeeeeeeeeeebbbbbffffffffffeeeeeeebbbbiibbbbbbbbbbbbbbbbbbbbbbbbbeeeeeeeeeeeeffggggeeeeaa
accffffjjgggggjjggjgggggeeeggggeeeeeeeeeeeeeeeeeeebbbbbbeefffffffeeeeebbbbbbbiibbbbbbbebbbbbbbbbbbbbbbbbbbbeeeeeeeeffffgggeeeeaa
acccccgggggggggggggggggeeeeeeeeeeeeeeeeeeeeeeeeggbbbbebeeefffeeeeeeeeeebbbbbbiibbbbbbeeebbbbbbbbbbbbbbbbbbbbbbbeeeefffffgggeeaaa
acccccgggggggeggggggeeeeeeeeeeeeeeeeeeeeeeeeeeggbbbbbeeeeeeeeeeeeeeeeebbbbbbbiibbbbeeeeeeebbbbebbbbbbbbbbbbbbbbeeeeeffffffgeaaaa
aaccccggggggeeeeeeeeeeeeeeeeeeeeeeeeeffgggeeeggbbbbbeeeeeeeeeeeeeeeebbbbbeeeeeeeeeeeeeeeeeeeebbbbbbbbbbbbbbbbbbbeeeeeffffffeahha
aaaggggggggeeeeeeeeeeeeeeeeeeeeeeffffffgggggggbbbbbbeeeeeeeeeeeeeebbbbbbeeeeeeeeeeeeeeeeeeeeeeeeeeeeebbbbbbbbbbbbeeeeefffffffhha
aaagggggggeeeeeeeeeeeeeeeeeeeeeeffhhffgggggggbbbbeebeeeeeeeeeeeeeebbbbbeeeeeeeeeeeeeeeeeeeeeeeeeeeeeeebbbbbbbbbbbbeeeeeffffhhhha
aaaagggggeeeeeeeeeeeeeeeeeeeeeeefffhffggggggbbbbeeeeeeeeeeeeeeeeeebbbeeeeeeeeeeeeeeeeeeeeeeeeeeeeeeeeeeebbbbbbbbbbbbeeeeefffhhha
aaaaagggffeeeeeeeeeeeeeeeeeeeeeeeffffggggggbbbbbeeeeeeeeeeeeeeeebbbbbeeeeeeeeeeeeeeeeeeeeeeeeeeeeeeeeeeeeebbbbbbbbbbeeeegggffaaa
aaaaaffffffeeeeeeeeeeeeeeeeeeeebbbfgggggggbbbbbeeeeeeeeeeeeeeeebbbbbeeeeeeeeeegggggggggggeeeeeeeeeeeeeeeeeebbbbbbbbbeeeeegggfaaa
aaaaaffffffeeeebbbbbbbbbiibbbbbbbbbbbbbbbbbbbeeeeeeeeeeeffffeebbbbbbeeeeeeggggggggggggggggggeffffeeggeeeeeeebbbbbbbbeeeeeegggfaa
aaaaahhhhfffbbbbbbbbbbbbiibbbbbbbbbbbbbbbbbbbeeeeeeefffffffeebbbbbbeeeeeeeggggggggggggggffgfffffffeggeeeeeeeiiiiiiiiieeeeeeggfaa
aaaahhhhhhhfbbbbbbbbbbbbiibbbbbbbeeebbbbbbbbbbbbeeeffffgggggbbbebbeeeeeeeeeeegggggggggggffffffhhhffgggeeeeeeiiiiiiiiieeeeeegggaa
aaaahhhhhhhffbbbbbffffeeeeeeeeeeeeeeeeeebbbbbbbeeeefffggggggbbebbeeeeeeeeeeeeeeggggggeggfffffhhhhffgggeeeeeeiiiiiiiiieeeeeeeggea
aaaahhhhhhhhfffffffffeeeeeeeeeeeeeeeeeeeebbbbbbbbbeffggggggbbbbeeeeeeeeeeeeeeeeeeeeeeeeeeeffffhhhhffgggeeeeebbbbbbbbbeeeeeeeeeea
aaaahhhhhhhhhhhffffeeeeeeeeeeeeeeeeeeeeeeeeeebbbbbbbbbbbbgebbbeeeeeeeeeeeeeeeeeeeeeeeeeeeeeffffhhhffggggeeeebbbbbbbbbeeeeeeeeeea
aaaahhhhhhhhhhhffeeeeeeeeeeeeeeeeeeeeeeegeeeeeebbbbbbbbbbbbbeeeeeeeeeeeeeeeeeeeeeeeeeeeeeeeeefffffffggggeeeebbbbbbbbbeeeeeeeeeea
aaaahhhhhhffffffeeeeeeeeeeeeeeeeeeeggggggeegeeeeebbbbbbbbbbbeeeeeeeeeeeeeeeeeeeeeeeeeeeeeeeeeeeeeegggggggeeebbbbbbbbbbeeeeeeeeea
aaaahhhhhhfffffeeeeeeeeeeeeeeeeeeeggggggggggeeeebbbbbebbbbbbbbbeeeeeeeeeeeeeeeeeeeeeeeeeeeeeeeeeeeeegggggeeebbbbbbbbbbbbeeeeeeea
aaaafhhhffffgggeeeeeeeeeeeeeeeeeegggggggggeeeebbbbbbbeeeebbbbbbbbbeeeeeeeebbbbbbbbbbbbbbbbbbeeeeeeeeegggggeebbbbbbbbbbbbbbeeeeea
aaaafffffggggggeeeeeeeeeeeeeeeeeeegggggeeeeeeebbbbbbbeeeeeeebbbbbbbeeeeebbbbbbbbbbbbbbbbbbbbbbeeeeeeeeggggeebbbbbbbbbbbbbbbeeeea
aaagffggggggggeeeeeeeeeeeeeeeeeeegggffffffeeebbbbbbeeeeeeeeeebbbbbbeeeebbbbbbbbbbbbbbbbbbbbbbbbbeeeeeeeeeeeebbbbbbbbbbbbbbbeeeea
aaaggggggggggeeeeeeeeeeeeeeeeeeeegffffffffeebbbbbbeeeeeeeeeeeeebbbbeebbbbbbbbeeeeeeeeeeeebbbebbbbbbeeeeeeeeebbbbbbbbbbbbbbbeeeea
aaaeggggggeeeeeeeeeeeeeeeeeeeeeeegffffffffiiiiiieeeeeeeeeeeeeeeeeebbbbbbbbbbeeeeeeeeeeeeeeeeeebbbbbbeeeeeeeebbbbbbbbbbbbbbbeeeea
aaaeeeeeeeeeeeeeeeeeeeeeeeeeeeeeeeeeeeffeeiiiiiieeeeeeefeeeeeeeeeebbebbbbbeeeeeeeeeeeeeeeeeeeeeebbbbbeeeeeeebbbbbbbbbbbbbbbbeeea
aaaeeeeeeeeeeeeebbbbbbbbebbeeeeeeeeeeeeeebbbbbeeeeeefffffeeeeeeeebbbbbbbbbeeggggeeeeeeeeeeeeeeeeebbbbeeeeeeebbbbbbbbbbbbbbbbbeaa
aaaeeeeeeeeebbbbbbbbbbbbbbbbeeeeeeeeebbeebbbeeeeeeeefffffeffeeeeebbbbbbbbeeeggggggeeeeeeeeeeeeeeeeebbbbeeeeeebbbbbbbbbbbbbbbbbaa
aaaeeeeeeebbbbbbeeeeeeebbbbbbeeeeebbbbbbbbeeeeeeeeeefffffffffeeeebbbbbbbeegggggggggeeeeeeeeeeeeeeeeebbbbbeeeebbbbbbbbbbbbbbbbaaa
aaaeeeeeebbbbbeeeeeeeeeeeeebbbbbbbbbbbbeeeeeeeeeeeggffffhhhffeeeeebebbbbeggggffgggggeeeeeeeeeeeeeeeeebbbbeeeebbbbbbbbbbbbbbbaaaa
aaaeeeeebbbbeeeeeeeeeeeeeeeeebbeebbbbbbeeeeeeeeeeggggghhhhhffeeeeebbbbbbgggggffffggggeeeeeeeeeeeeeeeeeebbbbbbbbbbbbbbbbbbbbbaaaa
aaaeeeebbbeeeeeeeeeeeeeeeeeeeeeeeebbbbbbeeeeeeeeggggghhhhhhhfeeeeebbbbbbbgggggfffffffgffeeeeeeeeeeeeeeeeebbbbbbbbbbbbbbbbbbaaaaa
aaaaebbbbeeeeeeeeeeeeeeeeeeeeeeeeebbbbbbeeeeeeeeggggghhhhhhffeeeeeebbbbbbbggggffhhfffffffeeeeeeeeeeeeeeeeeebbbbbbbbbbbbbbbbaaaaa
aaaabbbbeeeeeeeeeeeggggeeeeeeeeeeebbbbbbeeeeeeeeggggghhffffffeeeeeeeebbbbbbggggffhhfhhffeeeeeeeeeeeeeeeeeeeeebbbbbbbbbbbbbbaaaaa
aaaaaeeeeeeeeeeeggggeggeeeeeeeeeeeeebbbbbeeeeeeeggggggfffffeeeeeeeeeeebbbbbggggfffhhhhhffeeeeeeeeeeeeeeeeeeeebbbbbbbbbbbbbbbbaaa
aaaaaaeeeeeeeegggggggggeeeeeeeeeeeeeebbbbeeeeeeeegggggffffeeeeeeeeeeeebbbbbbggggffffhhhhffeeeeeeeeeeeeeeeeeeeeebbbbbbbbbbbbbbaaa
aaaaaaeeeeeeegggggggggeeeeeeeeeeeeeeeebbbbeeeeeeeeggggfffeeeeeeeeeeeeeebbbbbbggggggffffffffeeeeeeeeeeeeeeeeeeeebbbbbbbbbbbbbbbaa
aaaaaaeeeeeegggggggggeeeeeeeeeeeeeeeeeebbbbeeeeeeeeeeeeeeeeeeeeeeeeeeeeebbbbbbbgggggfggfffffeeeeeeeeeeeeeeeeeeebbbbbbbbbbbbbbbba
aaaaaaeeeeggggggggggeeeeeeeeeeeeeeeeeeeeeebbbbeeeeeeeeeeeeeeeeeeeeeeeeeebbbbbbbbbgggggggggggeeeeeeeeeeeeeeeeeeebbbbbbbbbbbbbbbba
aaaaaeeeegggggggggggeeeeeeeeeeeeeeeeeeeeeebbbbbbbeeeeeeeeeeeeeeeeeebbbbbbbbbbbbbbbgggggggggggeeeeeeeeeeeeeeeeeebbbbbbbbbbbbbbbbb
aaaaaeeegggggggggggeeeeeeeeeeeeeeeeeeeeeeeebbbbbbeeeeeeeeeeeeeeiibbbbbbbbbbbbbbbbbbggggggggggeeeeeeeeeeeeeeeeeebbbbbbbbbbbbbbbbb
aaaaaeegggggggggggeeeeeeeeeeeeeeeeeeeeeeeeeeeebbbbbbbeeeeeeebbbiibbbbbbbbbbebbbbbbbbbbggggggggeeeeeeeeeeeeeeeeebbbbbbbbbbbbbbbbb
aaacceffffggggggeeeeeeeeeeeeeeeeeeeeeeeeeeeeeebbbbbbbbbbbbbbbbbiibbbbbbbbeeeeebbbbbbbbbbgggggggeeeeeeeeeeeeeeeebbbbbbbbbbbbbbbbb
aaacceffffggggffffeeeeeeeeeeeeeeeeeeeeeeeeeeeeeeeebbbbbbbbbbbbbiibbbbbeeeeeeeeebbbbbbbbbbggggggeeeeeeeeeeeeeeeebbbbbbbbbbbbbbbbb
aacccfffffffffffffeeeeeeeeeeeeeeeeeeeeeeeeffffeeeeeeebbbbbbbbbbiieeeeeeeeeeeeeeebbbbbbbbbgggggggeeeeeeeeeeeeeeebbbbbbbbbbbbbbbbb
aacddfffhhhfffffffeeeeeeeeeeeeeeeeeeeeeefffffffeeeeeebbbeeeeeeeeeeeeeeeeeeeeeeeeeeeeebbbbbggggggeeeeeeeeeeeeeeeebbbbbbbbbbbbbbbb
accdddfhhhhhfffffeeeeeeeeeeeeeeeeeeeeeeefffffffggggebbbbeeeeeeeeeegggeeeeeeeeeeeeeeeeebbbbgggggggeeeeeeeeeeeeeeebbbbbbbbbbbbbbbb
accdddfhhhhfffffeeeeeeeeeeeeeeeeeeeeeeefffffffgggggebbbbeeeeeeeeggggeeeeeeeeeeeeeeeeeeebbbbbggggggeeeeeeeeeeeeeebbbbbbbbbbbbbbbb
accdddfhhhhffffeeeeeeeeeeeeeeeeeeeeeeeeffffffggggggeiiiieeeeeeeggggggeeeeeeeeeeeeeeeeeeebbbbbbggggeeeeeeeeeeeeeebbbbbbbbbbbbbbbb
accdddffffffeeeeeeeeeeeeeeeeeeeeeeeeeeefffffgggggeeeiiiieeeegggggggfffffffeeeeeeeeeeeeeebbbbbbbgggeeeeeeeeeeeeeebbbbbbbbbbbbbbbb
accddddffffeeeeeeeeeeeeeeeeeeeeeeeeeeeeffffggggeeeeebbbbbeeegggggggffffffffeeeeeeeeeeeeeebbbbbbbggeeeeeeeeeeeeeebbbbbbbbbbbbbbbb
accddddffffeeeeeeeeeeeeeeeeeeeeeeeeeeeeeffeeeeeeeeeebbbbbeeggggggggffffffffffffggggeeeeeeebbbbbbbgeeeeeeeeeeeeeebbbbbbbbbbbbbbbb
accddddffeeeeeeeeeeeeeeeeeeeeeeeeeeeeeeeeeeeeeeeeeeeebbbeeegeeeeegeeffffffffffffgggeeeeeeebbbbbbbggeeeeeeeeeeeeeebbbbbbbbbbbbbbb
aacdddddfeeeeeeeeeeeeeeeeeeeeeeeeeeeeeeeeeeeeebbbbbbbbbbeeeeeeeeeeeeeeefffffffffggeeeeeeeeeiiiiieeeeeeeeeeeeeeeeebbbbbbbbbbbbbbb
aaccddddffeeeeeeeeeeeeeeeeeeeeeeeeeeeeeeeebbbbbbbbbbbbbbeeeeeeeeeeeeeeeeeeeeggggeeeeeeeeeeeiiiiieeeeeeeeeeeeeeeeebbbbbbbbbbbbbbb
aaccdddddfeeeeeeeeeeeeeeeeeeeeeeeeeeeeeebbbbbbbbbbbbebbbbeeeeeeeeeeeeeeeeeeegggeeeeeeeeeeebbbbbeeeeeeeeeeeeeeeeeebbbbbbbbbbbbbbb
aacccdddffeeeeeeeeeeeeeeeeeeeeeeeeeeebbbbbbbbbbbbbbeeebbbbbeeeeeeeeeeeeeeeeeeeeeeeeeeeeebbbbbbeeeeeeeeeeeeeeeeeeebbbbbbbbbbbbbbb
aaccccccfeeeeeeeeeeeeeeeeeeeeeeeebbbbbbbbbbbeeeeeeeeeeebbbbbbbeeeeeeeeeeeeeeeeeeeeeeeeebbbbbeeeeeeeeeeeeeeeeeeeeebbbbbbbbbbbbbbb
aaakccccfeeeeeeeeeeeeeeeeeeeebebbbbbbbeeeeeeeeeeeeeeeeeebbbbbbbbbeeeeeeeeeeeeeeeeeeeeebbbbbeeeeeeeeeeeeeeeeeeeeeebbbbbbbbbbbbbbb
aakkkkcceeeeeeeeeeeeeeeeeeebebbbbeeeeeeeeeeeeeeeeeeeeeeeebbbbbbbbbbbbbbbbbbbbbbbeeeeebbbbbeeeeeeeeeggggggggggggggbbbbbbbbbbbbbbb
aakkkacceeeeeeeeeeeeeeeeeebbbbeeeeeeeeeeeeeeeeeeeeeeeeeeeebbbbbbbbbbbbbbbbbbbbbbbbbbbbbbbeeeeeeegggggggggfggggggfbbbbbbbbbbbbbbb
aakkkaaeeeeeeeeeeeeeeeeeebbbeeeeeeeeeeefffffffffeeeeeeeeeeeeeeeeeebbbbbbbbbbbbbbbbbbbbbbeeeeeeegggggfffffffffffffbbbbbbbbbbbbbbb
akkkaaaeeeeeeeeeeeeeebeebbbeeeeeeeeeeefffffhfffffffffeeeeeeeeeeeeeeeeebbbbbbbbbbbbbbeeeeeeeeeeggggffffhhhfhhhhhhfgbbbbbbbbbbbbbb
akkkaaeeeeeeeeeeeeeeebbbbbbeeeeeeeeefffffffhhfffffffffffeeeeeeeeeeeeeeeebbbbbbbbbbeeeeeeeeeeegggfffhhhhhhhhhhhhffgbbbbbbbbbbbbbb
akkaaeeeeeeeeeeeeeeebbbbbbeeeefffffffffffffhhhfffffffffffffeeeeeeeeeeeeeebbbbbbbeeeeeeeeeeeegggfffhhhhffffffffffffbbbbbbbbbbbbbb
akkaaeeeeeeeeeeeeeebbbbbbeeeeeefffffffffffffhfffffffhhhhfffffeeeeeeeeeeeeeeeebbbbeeeeeeeeeeegggffhhhffffgggffffffgbbbbbbbbbbbbbb
akkkaaaeeeeeeeeeebbbbbbeeeeeeeeefffffffhhffffffffffhhhfhfffffffeeeeeeeeeeeeeeebbbeeeeeeeeeeeggffhhhfffgggggllllliiiiibbbbbbbbbbb
akkkaaaaaaeeeeeebbbbbbeeeeeeeeeeffhhffhhhffffffhhffhhhhhffffffffeeeeeeeeeeeeeebbbbeeeeeeeeeeggffhfffggggeeelmmmmiiiiibbbbbbbbbbb
akkkkknnkaeeeeeebbbbeeeeeeeeeeefffhhffhhhffffhhhhffffhhfffffffffffggeeeeeeeeeeebbbbeeeeeeeeegffhhffgggeeeeelmmmmiiiiibbbbbbbbbbb
akkkknnkaakkebiibbeeeeeeeeeeeeefffhhfffffffffhhhhfffffffffffffffeggggeeeeeeeeeebbbbeeeeeeeeegfhhffgggeeeeeelmmmliiiiibbbbbbbbbbb
aakknnaaakkkbbiibeeeeeeeeeeeeeeefffhfffffffffhhhhffffffoooooooofggggggeeeeeeeeebbbbbeeeeeeeegfhffggggeeeeeelmmmliiiiibbbbbbbbbbb
aakknaakkkkbbbiibeeeeeeeeegggggggfffffffffffffffffoffooooooojjjgggggggggeeeeeeeebbbbeeeeeeeegfffgggggeeemmelmmmmiiiiibbbbbbbbbbb
aaknnaakkkkbbbiieeeeeeeeeegggggegjjjjjjjjofffffffofofjjjjjjjjjgggggggggggeeeeeeeebbbbeeeeeeegfffggggggeemmmlmmmmiiiiibbbbbbbbbbb
aaknnakkkkbbbbiieeeeeeeeeegggegggjjjjjjjjjjjjjjjjjjjjjjjjjjjjggeeeeggggggeeeeeeeebbbbeeeeeeegfffgggggggeemmmmmmliiiiibbbbbbbbbbb
aakkkkkkkbbbbbeeeeeeeeeeeeeeggggggjooooojjjjjjjjjjjjjjjjjjgggggeeeegggggggeeeeeeeebbbbeeeeefffffgggggggeeemmmmmliiiiibbbbbbbbbbb
aaakkkkkbbbbbeeeeeeeeeeeeeeeeeeeeffffooooofffffffffffjjgfffffggeeeeggggggggeeeeeeebbbbeeeeefffffgggggggeeemmmmmmiiiiibbbbbbbbbbb
aakkkkkbbbbbbaaeeeeeeeeeeeeeeeeeefffffffffffffhhhhhhfffffffffgeeeeeggggggggeeeeeeebbbbeeeeffffffgggggggeeeemmmmmiiiiibbbbbbbbbbb
aakkkkkbbbbaaaaeeeeeeeeeeeeeeeeeffffffffffffffhhhhhhffffffffggeeeeeggggggggeeeeeeebbbbeeeefefffgggggggeeeeellllliiiiibbbbbbbbbbb
akkkkkbbbbaaaaaeeeeeeeeeeeeeeeeeeefffeffgggfffffhhhffffggfffggeeeeeeggggggggeeeeeeebbbllmmllllllgggggefffeeeeeeeeebbbbbbbbbbbbbb
akkkkbbbbaaaaaaeeeeeeeeeeeeeeeeeeeeeeeeeggggffffhhhfffgggggggeeeeeeeggggggggeeeeeeebbblmmmmmmmmlggffffffffeeeeeeeebbbbbbbbbbbbbb
akkkkbbbbaaaaaaeeeeeeeeeeeeeeeeeeeeeeeeeggggffffhhffffgggggeeeeeeeeeggggggggeeeeeeebbblmmmmmmmmlggffffffffffeeeeeebbbbbbbbbbbbbb
akkkkbbbaaaaaaaaeeeeeeeeeeeeeeeeeeeeeeeegggffffffffffggggeeeeeeeeeeeggggggggeeeeeebbbelmmmmmmmmlgfffhhhhfffffeeeeebbbbbbbbbbbbbb
akkkkbbaaaaaaaaeeeeeeeeeeeeeeeeeeeeeeeeeeggffgggfgggggggeeeeeeeeeeeegggggggeeeeeeebbbelmmmmmmmmlffffhhhhhffffeeggbbbbbbbbbbbbbbb
akkkkbaaaaaaaaaeeeeeeeeeeeeeeeeeeeeeeeeeegggggggggfgggggeeeeeeeeeeeeeggggggeeeeeebbbeellllllllllffffhhhhhhfffffggbbbbbbbbbbbbbbb
akkkkaaaaaaaaaaeeeeeeeeeeeeeeeeeeeeeeeeeeeeeegggggggeeeeeeeeeeeeeeeeeggggggeeeeeebbbggggggggggglgfffhhhhhhhhfffggbbbbbbbbbbbbbbb
akkkkaaaaaaaaaeeeeeeeeeeeeeeeeeeeeeeeeeeeeeeeeeeeeeeeeeeeeeeeeeeeeeeegggggeeeeeebbbbgggggggggggggffffhhhhhhhfffggbbbbbbbbbbbbbbb
akkkkkaaaaaaeeeeeeeeeeeeeeeeeeeeeeeeeeeeeeeeeeeeeeeeeeeeeeeeeeeeeeeeeeeeggeeeeebbbbgggggggggggggggffffhhhhffffgggbbbbbbbbbbbbbbb
akkknnaaaaaaeggggeffffeeeeeeeeeeeeeeeeeeeeeeeeeeeeeeeeeeeeeeeeeeeeeeeeeeeeeeeeebbbggggggggggggglggfffffffffffggggbbbbbbbbbbbbbbb
akkkknaaaaagggggfffffffffeeeeeeeeeeeeeeeeeeeeeeeeeeeeeeeeeeeeeeeeeeeeeeeeeeeebbbbelllllggggglllllllllllfffffgggggbbbbbbbbbbbbbbb
akkkknkaaaagggggjjffhhhhfffeeeeeeeeeeeeaeaaaaeeeeeeeeeeeeeeeeeeeeeeeeeeeeeeeebbbeelmmmmggggglmmmmmmmmmlffffggggggbbbbbbbbbbbbbbb
akkkknnaaaaegggggjjfffhhhfffeeeeeeaaaaaaaaaaaeeeeeeeeeeeeeeeeeeeeeeeeeeeeeeebbbeeelmmmmggggglmmmmmmmmmlffffggggggbbbbbbbbbbbbbbb
aakkkknaaaaaegggggjjjffhhhffeeeeeaaaanannaaaaaeeeeeeeeeeeeeeeeeeeeeeeeeeeeeebbbeeelmmmlgggggmmmmmmmmmmlggggggggggbbbbbbbbbbbbbbb
aaakkknnaaaaaaggggggjjffhhhffeeeaaannnnnkkkaaaeeeeeeeeeeeeeeeeeeeeeeeeeeeeeebbbeeelmmmlgggggmmmmmmmmmmlggggggggggbbbbbbbbbbbbbbb
aaakkkknaaaaaaeggggggjjfffffffeeaaannnkkkkkaaaeeeeeeeeeeeeeeeeeeeeeeeeeeeeeebbbeeelmmmlggggglmmmmmmmmmlgggggggggbbbbbbbbbbbbbbbb
aaakkkkknnnaaaaeggggggjjffffffeeaaaannkkkkaaaaeeeeeeeeeeeeeeeeeeeeeeeeeeeeeebbbbbelmmmlggggglmmmmmmmmmlgggggggggbbbbbbbbbbbbbbbb
aakkkkkkkknaaaaaaaaggggjjjffgeeeeeaaaakkkkaaaaeeeeeeeeeeeeeeeeeeeeeeeeeeeeeeebbbbelllllggggglmmmmmmmmmlgggggggggbbbbbbbbbbbbbbbb
aakkkkkkkkkkaaaaaaaaaggggggeggeeeeeaaakkkkkaaaaaeeeeeeeeeeeeeeeeeeeeeeeeeeeeebbbbbbggggggggglllllllllllbbbbgggggbbbbbbbbbbbbbbbb
aakkkkkkkkkkkaaaaaaaaegggggggeeeeeeaaakkkkkkaaaaaeeeeeeeeeeeeeeeeeeeeeeeeeeeeebbbbbbbbgggggggggbbbbbbbbbbbbbbbbbbbbbbbbbbbbbbbbb
aaaakkkkkkkkkkkkaaaaaeeeeegeeeeeaaaaaakkakkkkaaaaeeeeeeeeeeeeeeeeeeeeeeeeeeeeebbbbbbbbbbiibbbbbbbbbbbbbbbbbbbbbbbbbbbbbbbbbbbbbb
aaaaakkkkkkkkkkkkaaaaaeeeeeeeeaaaaaaakkkakkkkkaaaaaaaaeeeeeeeeeeeeeeeeeeeeeeeeebbbbbbbbbiibbbbbbbbbbbbbbbbbbbbbbbbbbbbbbbbbbbbbb
aaaakkkkkkkkkkkkkaaaaaaeeeeeaaaaaaakkkkaakkkkkaaaaaaaaaeeeeeeeeeeeeeeeeeeeeeeeeebbbbbbbbiibbbbbbbbbbbbbbbbbbbbeebbbbbbbbbbbbbbbb
aaakkkkkkkkkkkkkkakkkaaaaaeaaaaaakkkkkaaaakkkkkkaaaaaaaaaaeeeeeeeeaaaaaeeeeeeeeeeeebbbbbiibbbbbbeeebbbbbeeeebeebbbbbbbbbbbbbbbbb
aakkkkkkkkkkkkkkkkkkkaaaaaaaaaakkkkkkkaaaaaakkkkkkakkaaaaaaaeeeeaaaaaaaaeeeeeeeeeeaaaaeeeeeeeeeeeeeeeeepeeeebbbbbbbbbbbbbbbbbbbb
aakkkknnaaaaaakkkkkkkkaaaaaaakkkkkkkkaaaaaaaaakkkkkkkkkkkaaaaeeaaakkkkkaaaeeeeeeeaaaaaaeeeeeqeeeeekknnnaaaaeeebbbbbbbbbbbbbbbbbb
aaaannnaaaaaaaaaakkkkkkkkkkkkkkkkkaaaaaaaaaaaaakkkkkkkkkkaaaaaaaakkkkkkkaaaaaaeaaaaaaaaaaeeeeeeekkkknaaaaaaaebbbbbbbbbbbbbbbbbbb
aaaannnaaaaaaaaaaaaaaaakkkkkkkaaaaaaaaaaaaaaaaaakakkkkkkkkkkkkkkkkkkkkkkaaaaaaaaaaaaaaaaaaaeeeeaakknnaaaaaaaebbbbbbbbbbbbbbbbbbb
aaaaaaaaaaaaaaaaaaaaaaaaaaaaaaaaaaaaaaaaaaaaaaaaaaaaaaaaaaaaaaaaaaaaaaaaaaaaaaaaaaaaaaaaaaaaaaaaannnnaaaaaaabbbbbbbbbbbbbbbbbbbb
"}
