"a" = (/turf,/area)
"b" = (/obj/trigger/telesmart/down,/turf/simulated/floor/stair/wood,/area/overworld/starting_area)
"c" = (/turf/simulated/wall/wood/brown,/area/overworld/starting_area)
"d" = (/obj/structure/smooth/table/wood,/turf/simulated/floor/wood/brown,/area/overworld/starting_area)
"e" = (/obj/structure/smooth/table/wood,/obj/item/torch/candle,/turf/simulated/floor/wood/brown,/area/overworld/starting_area)
"f" = (/obj/marker/spawnpoint/new_character,/turf/simulated/floor/wood/brown,/area/overworld/starting_area)
"g" = (/obj/marker/mob_spawn/marwani/ship,/turf/simulated/floor/wood/brown,/area/overworld/starting_area)
"h" = (/obj/structure/interactive/bed,/turf/simulated/floor/wood/brown,/area/overworld/starting_area)
"i" = (/turf/simulated/floor/wood/brown,/area/overworld/starting_area)
"j" = (/obj/structure/interactive/door/wood,/turf/simulated/floor/wood/brown,/area/overworld/starting_area)
"k" = (/turf/simulated/floor/colored/sand/underwater,/area)
"l" = (/turf/simulated/wall/rock,/area)
"m" = (/turf/simulated/floor/plating/ai,/area)
"n" = (/turf/simulated/floor/tile/dark,/area)
"o" = (/turf/simulated/wall/metal/reinforced,/area)
"p" = (/obj/structure/smooth/window,/turf/simulated/floor/plating,/area)
"q" = (/turf/simulated/floor/basalt,/area)
"r" = (/turf/simulated/floor/lava,/area)
"s" = (/turf/simulated/wall/rock/basalt,/area)

(1,1,1) = {"
aaaaaaaaaaaaaaaaaaaaaaaaaaaaaaaaomnnnmoaaaaaaaaaaaaaaaaaaaaaaaaaaaaaaaaaaaaaaaaaaaaaaaaaaaaaaaaaaaaaaaaaaallkkkkkkkkkkkkkkkkkkkk
aaaaaaaaaaaaaaaaaaaaaaaaaaaaaaaaomnnnmoaaaaaaaaaaaaaaaaaaaaaaaaaaaaaaaaaaaaaaaaaaaaaaaaaaaaaaaaaaaaaaaaaaallkkkkkkkkkkkkkkkkkkkk
aaaaaaaaaaaaaaaaaaaaaaaaaaaaaaaaomnnnmoaaaaaaaaaaaaaaaaaaaaaaaaaaaaaaaaaaaaaaaaaaaaaaaaaaaaaaaaaaaaaaaaaaallkkkkkkkkkkkkkkkkkkkk
aaaaaaaaaaaaaaaaaaaaaaaaaaaaaaaaomnnnmoaaaaaaaaaaaaaaaaaaaaaaaaaaaaaaaaaaaaaaaaaaaaaaaaaaaaaaaaaaaaaaaaaaallkkkkkkkkkkkkkkkkkkkk
aaaaaaaaaaaaaaaaaaaaaaaaaaaaaaaaomnnnmoaaaaaaaaaaaaaaaaaaaaaaaaaaaaaaaaaaaaaaaaaaaaaaaaaaaaaaaaaaaaaaaaaaallkkkkkkkkkkkkkkkkkkkk
aaaaaaaaaaaaaaaaaaaaaaaaaaaaaaaaomnnnmoaaaaaaaaaaaaaaaaaaaaaaaaaaaaaaaaaaaaaaaaaaaaaaaaaaaaaaaaaaaaaaaaaaalkkkkkkkkkkkkkkkkkkkkk
aaaaaaaaaaaaaaaaaaaaaaaaaaaaaaaaomnnnmoaaaaaaaaaaaaaaaaaaaaaaaaaaaaaaaaaaaaaaaaaaaaaaaaaaaaaaaaaaaaaaaaaaalkkkkkkkkkkkkkkkkkkkkk
aaaaaaaaaaaaaaaaaaaaaaaaaaaaaaaaomnnnmoaaaaaaaaaaaaaaaaaaaaaaaaaaaaaaaaaaaaaaaaaaaaaaaaaaaaaaaaaaaaaaaaaaalkkkkkkkkkkkkkkkkkkkkk
aaaaaaaaaaaaaaaaaaaaaaaaaaaaaaaaomnnnmoaaaaaaaaaaaaaaaaaaaaaaaaaaaaaaaaaaaaaaaaaaaaaaaaaaaaaaaaaaaaaaaaaaalkkkkkkkkkkkkkkkkkkkkk
aaaaaaaaaaaaaaaaaaaaaaaaaaaaaaaaomnnnmoaaaaaaaaaaaaaaaaaaaaaaaaaaaaaaaaaaaaaaaaaaaaaaaaaaaaaaaaaaaaaaaaaaallkkkkkkkkkkkkkkkkkkkk
aaaaaaaaaaaaaaaaaaaaaaaaaaaaaaaaomnnnmoaaaaaaaaaaaaaaaaaaaaaaaaaaaaaaaaaaaaaaaaaaaaaaaaaaaaaaaaaaaaaaaaaaallkkkkkkkkkkkkkkkkkkkk
aaaaaaaaaaaaaaaaaaaaaaaaaaaoooooomnnnmooooooaaaaaaaaaaaaaaaaaaaaaaaaaaaaaaaaaaaaaaaaaaaaaaaaaaaaaaaaaaaaaallkkkkkkkkkkkkkkkkkkkk
aaaaaaaaaaaaaaaaaaaaaaaaaaaommmmmmnnnmmmmmmoaaaaaaaaaaaaaaaaaaaaaaaaaaaaaaaaaaaaaaaaaaaaaaaaaaaaaaaaaaaaaallkkkkkkkkkkkkkkkkkkkk
aaaaaaaaaaaaaaaaaaaaaaaaaaaomnnnnnnnnnnnnnmoaaaaaaaaaaaaaaaaaaaaaaaaaaaaaaaaaaaaaaaaaaaaaaaaaaaaaaaaaaaaaallkkkkkkkkkkkkkkkkkkkk
aaaaaaaaaaaaaaaaaaaaaaaaaaaomnnnnnnnnnnnnnmoaaaaaaaaaaaaaaaaaaaaaaaaaaaaaaaaaaaaaaaaaaaaaaaaaaaaaaaaaaaaaallkkkkkkkkkkkkkkkkkkkk
aaaaaaaaaaaaaaaaaaaaaaaaaaaomnnnnnnnnnnnnnmoaaaaaaaaaaaaaaaaaaaaaaaaaaaaaaaaaaaaaaaaaaaaaaaaaaaaaaaaaaaaaallkkkkkkkkkkkkkkkkkkkk
aaaaaaaaaaaaaaaaaaaaaaaooooomnnnmmnnnmmnnnmoooooaaaaaaaaaaaaaaaaaaaaaaaaaaaaaaaaaaaaaaaaaaaaaaaaaaaaaaaaaallkkkkkkkkkkkkkkkkkkkk
aaaaaaaaaaaaaaaaaaaaaaaommmmmnnnmmnnnmmnnnmmmmmoaaaaaaaaaaaaaaaaaaaaaaaaaaaaaaaaaaaaaaaaaaaaaaaaaaaaaaaaaalkkkkkkkkkkkkkkkkkkkkk
aaaaaaaaaaaaaaaaaaaaaaaomnnnnnnnnnnnnnnnnnnnnnmoaaaaaaaaaaaaaaaaaaaaaaaaaaaaaaaaaaaaaaaaaaaaaaaaaaaaaaaaaalkkkkkkkkkkkkkkkkkkkkk
aaaaaaaaaaaaaaaaaaaaaaaomnnnnnnnnnnnnnnnnnnnnnmoaaaaaaaaaaaaaaaaaaaaaaaaaaaaaaaaaaaaaaaaaaaaaaaaaaaaaaaaaalkkkkkkkkkkkkkkkkkkkkk
aaaaaaaaaaaaaaaaaaaaaaaomnnnnnnnnnnnnnnnnnnnnnmoaaaaaaaaaaaaaaaaaaaaaaaaaaaaaaaaaaaaaaaaaaaaaaaaaaaaaaaaaalkkkkkkkkkkkkkkkkkkkkk
aaaaaaaaaaaaaaaaaaaaaaaommmmmnnnmmnnnmmnnnmmmmmoaaaaaaaaaaaaaaaaaaaaaaaaaaaaaaaaaaaaaaaaaaaaaaaaaaaaaaaaaalkkkkkkkkccccckkkkkkkk
aaaaaaaaaaaaaaaaaaaaaaaooooomnnnmmnnnmmnnnmoooooaaaaaaaaaaaaaaaaaaaaaaaaaaaaaaaaaaaaaaaaaaaaaaaaaaaaaaaaaalkkkkkkkccccccckkkkkkk
aaaaaaaaaaaaaaaaaaaaaaaaaaaomnnnnnnnnnnnnnmoaaaaaaaaaaaaaaaaaaaaaaaaaaaaaaaaaaaaaaaaaaaaaaaaaaaaaaaaaaaaaallkkkkkccccccccckkkkkk
aaaaaaaaaaaaaaaaaaaaaaaaaaaomnnnnnnnnnnnnnmoaaaaaaaaaaaaaaaaaaaaaaaaaaaaaaaaaaaaaaaaaaaaaaaaaaaaaaaaaaaaaallkkkkkcdecbcddckkkkkk
aaaaaaaaaaaaaaaaaaaaaaaaaaaomnnnnnnnnnnnnnmoaaaaaaaaaaaaaaaaaaaaaaaaaaaaaaaaaaaaaaaaaaaaaaaaaaaaaaaaaaaaaallkkkkkciigiiiickkkkkk
aaaaaaaaaaaaaaaaaaaaaaaaaaaommmmmmnnnmmmmmmoaaaaaaaaaaaaaaaaaaaaaaaaaaaaaaaaaaaaaaaaaaaaaaaaaaaaaaaaaaaaaallkkkkkciiiiiiickkkkkk
sssssssssssssssssssssssssssoooooomnnnmooooooaaaaaaaaaaaaaaaaaaaaaaaaaaaaaaaaaaaaaaaaaaaaaaaaaaaaaaaaaaaaaallkkkkkccccicccckkkkkk
ssssssssssssssssssssssssssssssssomnnnmoaaaaaaaaaaaaaaaaaaaaaaaaaaaaaaaaaaaaaaaaaaaaaaaaaaaaaaaaaaaaaaaaaaallkkkkkchecicehckkkkkk
sssssssrrrrrsssssssrrrrrssssssssomnnnmoaaaaaaaaaaaaaaaaaaaaaaaaaaaaaaaaaaaaaaaaaaaaaaaaaaaaaaaaaaaaaaaaaaallkkkkkcficijifckkkkkk
ssssrrrrrrrrrrrrrrrrrrrrrrrsssssomnnnmoaaaaaaaaaaaaaaaaaaaaaaaaaaaaaaaaaaaaaaaaaaaaaaaaaaaaaaaaaaaaaaaaaaalkkkkkkciijiciickkkkkk
sssrrrrrrrrrrrrrrrrrrrrrrrrrssssomnnnmoaaaaaaaaaaaaaaaaaaaaaaaaaaaaaaaaaaaaaaaaaaaaaaaaaaaaaaaaaaaaaaaaaaalkkkkkkciiciciickkkkkk
ssrrrrrrrrrrrrrrrrrrrrrrrrrrrrssomnnnmoaaaaaaaaaaaaaaaaaaaaaaaaaaaaaaaaaaaaaaaaaaaaaaaaaaaaaaaaaaaaaaaaaaalkkkkkkccccicccckkkkkk
ssrrrrrrrrrrrrrrrrrrrrrrrrrrrrrsomnnnmoaaaaaaaaaaaaaaaaaaaaaaaaaaaaaaaaaaaaaaaaaaaaaaaaaaaaaaaaaaaaaaaaaaalkkkkkkchecicehckkkkkk
ssrrooooooooooooooooorrrrrroooooomnnnmooooooaaaaaaaaaaaaaaaaaaaaaaaaaaaaaaaaaaaaaaaaaaaaaaaaaaaaaaaaaaaaaallkkkkkcficijifckkkkkk
srrrommmmmmmmmmmmmmmpqqrrrrpmmmmmmnnnmmmmmmoaaaaaaaaaaaaaaaaaaaaaaaaaaaaaaaaaaaaaaaaaaaaaaaaaaaaaaaaaaaaaallkkkkkciijiciickkkkkk
srrromnnnnnnnnnnnnnmpqqrrrrpmnnnnnnnnnnnnnmoaaaaaaaaaaaaaaaaaaaaaaaaaaaaaaaaaaaaaaaaaaaaaaaaaaaaaaaaaaaaaallkkkkkciiciciickkkkkk
srrromnnnnnnnnnnnnnmpqqqqrrpmnnnnnnnnnnnnnmoaaaaaaaaaaaaaaaaaaaaaaaaaaaaaaaaaaaaaaaaaaaaaaaaaaaaaaaaaaaaaallkkkkkccccicccckkkkkk
srrromnnnnnnnnnnnnnmpqqqqqqpmnnnnnnnnnnnnnmoaaaaaaaaaaaaaaaaaaaaaaaaaaaaaaaaaaaaaaaaaaaaaaaaaaaaaaaaaaaaaallkkkkkkciiiiickkkkkkk
srrromnnnmmnnnmmnnnmppppppppmnnnmmnnnmmnnnmoaaaaaaaaaaaaaaaaaaaaaaaaaaaaaaaaaaaaaaaaaaaaaaaaaaaaaaaaaaaaaallkkkkkkcceddcckkkkkkk
srrromnnnmmnnnmmnnnmmmmmmmmmmnnnmmnnnmmnnnmoaaaaaaaaaaaaaaaaaaaaaaaaaaaaaaaaaaaaaaaaaaaaaaaaaaaaaaaaaaaaaallkkkkkkkccccckkkkkkkk
srrromnnnnnnnnnnnnnnnnnnnnnnnnnnnnnnnnnnnnmoaaaaaaaaaaaaaaaaaaaaaaaaaaaaaaaaaaaaaaaaaaaaaaaaaaaaaaaaaaaaaallkkkkkkkkkkkkkkkkkkkk
srrromnnnnnnnnnnnnnnnnnnnnnnnnnnnnnnnnnnnnmoaaaaaaaaaaaaaaaaaaaaaaaaaaaaaaaaaaaaaaaaaaaaaaaaaaaaaaaaaaaaaallkkkkkkkkkkkkkkkkkkkk
srrromnnnnnnnnnnnnnnnnnnnnnnnnnnnnnnnnnnnnmoaaaaaaaaaaaaaaaaaaaaaaaaaaaaaaaaaaaaaaaaaaaaaaaaaaaaaaaaaaaaaallkkkkkkkkkkkkkkkkkkkk
srrromnnnmmnnnmmnnnmmmmmmmmmmnnnmmnnnmmnnnmoaaaaaaaaaaaaaaaaaaaaaaaaaaaaaaaaaaaaaaaaaaaaaaaaaaaaaaaaaaaaaallkkkkkkkkkkkkkkkkkkkk
srrromnnnmmnnnmmnnnmppppppppmnnnmmnnnmmnnnmoaaaaaaaaaaaaaaaaaaaaaaaaaaaaaaaaaaaaaaaaaaaaaaaaaaaaaaaaaaaaaallkkkkkkkkkkkkkkkkkkkk
srrromnnnnnnnnnnnnnmpqqqqqqpmnnnnnnnnnnnnnmoaaaaaaaaaaaaaaaaaaaaaaaaaaaaaaaaaaaaaaaaaaaaaaaaaaaaaaaaaaaaaallkkkkkkkkkkkkkkkkkkkk
sssromnnnnnnnnnnnnnmpqqqrrrpmnnnnnnnnnnnnnmoaaaaaaaaaaaaaaaaaaaaaaaaaaaaaaaaaaaaaaaaaaaaaaaaaaaaaaaaaaaaaallkkkkkkkkkkkkkkkkkkkk
ssssomnnnnnnnnnnnnnmpqqrrrrpmnnnnnnnnnnnnnmoaaaaaaaaaaaaaaaaaaaaaaaaaaaaaaaaaaaaaaaaaaaaaaaaaaaaaaaaaaaaaalllkkkkkkkkkkkkkkkkkkk
ssssommmmmmnnnmmmmmmprrrrrrpmmmmmmmmmmmmmmmossssssssaaaaaaaaaaaaaaaaaaaaaaaaaaaaaaaaaaaaaaaaaaaaaaaaaaaaaalllkkkkkkkkkkkkkkkkkkk
ssssopppppmnnnmppppporrrrrrooooooooooooooooossssssssaaaaaaaaaaaaaaaaaaaaaaaaaaaaaaaaaaaaaaaaaaaaaaaaaaaaaalllkkkkkkkkkkkkkkkkkkk
sssrrrrrqpmnnnmpqrrrrrrrrrrrrrrrrssrrrrrrrrrrrssssssaaaaaaaaaaaaaaaaaaaaaaaaaaaaaaaaaaaaaaaaaaaaaaaaaaaaaallllllllllllllllllllll
ssrrrrrqqpmnnnmpqrrrrrrrrrrrrrrrssssrrrrrrrrrrrsssssaaaaaaaaaaaaaaaaaaaaaaaaaaaaaaaaaaaaaaaaaaaaaaaaaaaaaallllllllllllllllllllll
ssrrrrrqqpmnnnmpqrrrrrrrrrrrrrrssssssrrrrrrrrrrrssssaaaaaaaaaaaaaaaaaaaaaaaaaaaaaaaaaaaaaaaaaaaaaaaaaaaaaaaaaaaaaaaaaaaaaaaaaaaa
ssrrrrrqqpmnnnmpqqrrrrrrrrrrrrrsssssssrrrrrrrrrrrsssaaaaaaaaaaaaaaaaaaaaaaaaaaaaaaaaaaaaaaaaaaaaaaaaaaaaaaaaaaaaaaaaaaaaaaaaaaaa
ssrrrrqqqpmnnnmpqqqrrrrrrrrrrsssssssssssrrrrrrrrrrssaaaaaaaaaaaaaaaaaaaaaaaaaaaaaaaaaaaaaaaaaaaaaaaaaaaaaaaaaaaaaaaaaaaaaaaaaaaa
sssrrrqqqpmnnnmpqqqqrrrrrrrrrssssssssssssssrrrrrrrssaaaaaaaaaaaaaaaaaaaaaaaaaaaaaaaaaaaaaaaaaaaaaaaaaaaaaaaaaaaaaaaaaaaaaaaaaaaa
ssssopppppmnnnmppppporrrrrrooooooooooooooooorrrrrroooooooooooooooooaaaaaaaaaaaaaaaaaaaaaaaaaaaaaaaaaaaaaaaaaaaaaaaaaaaaaaaaaaaaa
ssssommmmmmnnnmmmmmmorrrrrrommmmmmmmmmmmmmmprrrrrrpmmmmmmmmmmmmmmmoaaaaaaaaaaaaaaaaaaaaaaaaaaaaaaaaaaaaaaaaaaaaaaaaaaaaaaaaaaaaa
ssssomnnnnnnnnnnnnnmorrrrrromnnnnnnnnnnnnnmprrrrrrpmnnnnnnnnnnnnnmoaaaaaaaaaaaaaaaaaaaaaaaaaaaaaaaaaaaaaaaaaaaaaaaaaaaaaaaaaaaaa
ssssomnnnnnnnnnnnnnmorrrrrromnnnnnnnnnnnnnmpqrrrrrpmnnnnnnnnnnnnnmoaaaaaaaaaaaaaaaaaaaaaaaaaaaaaaaaaaaaaaaaaaaaaaaaaaaaaaaaaaaaa
sssromnnnnnnnnnnnnnmorrrrrromnnnnnnnnnnnnnmpqqqqqqpmnnnnnnnnnnnnnmoaaaaaaaaaaaaaaaaaaaaaaaaaaaaaaaaaaaaaaaaaaaaaaaaaaaaaaaaaaaaa
srrromnnnmmnnnmmnnnmorrrrrromnnnmmnnnmmnnnmppppppppmnnnmmnnnmmnnnmoaaaaaaaaaaaaaaaaaaaaaaaaaaaaaaaaaaaaaaaaaaaaaaaaaaaaaaaaaaaaa
srrromnnnmmnnnmmnnnmorrrrrromnnnmmnnnmmnnnmmmmmmmmmmnnnmmnnnmmnnnmoaaaaaaaaaaaaaaaaaaaaaaaaaaaaaaaaaaaaaaaaaaaaaaaaaaaaaaaaaaaaa
srrromnnnnnnnnnnnnnmorrrrrromnnnnnnnnnnnnnnnnnnnnnnnnnnnnnnnnnnnnmoaaaaaaaaaaaaaaaaaaaaaaaaaaaaaaaaaaaaaaaaaaaaaaaaaaaaaaaaaaaaa
srrromnnnnnnnnnnnnnmorrrrrromnnnnnnnnnnnnnnnnnnnnnnnnnnnnnnnnnnnnmoaaaaaaaaaaaaaaaaaaaaaaaaaaaaaaaaaaaaaaaaaaaaaaaaaaaaaaaaaaaaa
srrromnnnnnnnnnnnnnmorrrrrromnnnnnnnnnnnnnnnnnnnnnnnnnnnnnnnnnnnnmoaaaaaaaaaaaaaaaaaaaaaaaaaaaaaaaaaaaaaaaaaaaaaaaaaaaaaaaaaaaaa
srrromnnnmmnnnmmnnnmorrrrrromnnnmmnnnmmnnnmmmmmmmmmmnnnmmnnnmmnnnmoaaaaaaaaaaaaaaaaaaaaaaaaaaaaaaaaaaaaaaaaaaaaaaaaaaaaaaaaaaaaa
srrromnnnmmnnnmmnnnmorrrrrromnnnmmnnnmmnnnmppppppppmnnnmmnnnmmnnnmoaaaaaaaaaaaaaaaaaaaaaaaaaaaaaaaaaaaaaaaaaaaaaaaaaaaaaaaaaaaaa
srrromnnnnnnnnnnnnnmorrrrrromnnnnnnnnnnnnnmpqqqqqqpmnnnnnnnnnnnnnmoaaaaaaaaaaaaaaaaaaaaaaaaaaaaaaaaaaaaaaaaaaaaaaaaaaaaaaaaaaaaa
ssrromnnnnnnnnnnnnnmorrrrrromnnnnnnnnnnnnnmpqqqqqqpmnnnnnnnnnnnnnmoaaaaaaaaaaaaaaaaaaaaaaaaaaaaaaaaaaaaaaaaaaaaaaaaaaaaaaaaaaaaa
sssromnnnnnnnnnnnnnmorrrrrromnnnnnnnnnnnnnmpqqrrrqpmnnnnnnnnnnnnnmosssssssaaaaaaaaaaaaaaaaaaaaaaaaaaaaaaaaaaaaaaaaaaaaaaaaaaaaaa
ssssommmmmmnnnmmmmmmorrrrrrommmmmmnnnmmmmmmpqrrrrqpmmmmmmnnnmmmmmmosssssssaaaaaaaaaaaaaaaaaaaaaaaaaaaaaaaaaaaaaaaaaaaaaaaaaaaaaa
srrsopppppmnnnmppppporrrrrropppppmnnnmppppporrrrrropppppmnnnmppppporssssssaaaaaaaaaaaaaaaaaaaaaaaaaaaaaaaaaaaaaaaaaaaaaaaaaaaaaa
srrrrrrrqpmnnnmpqqrrrrrrrrrrrrrqpmnnnmprrrrrrrrrrrrqqqqpmnnnmpqqqqrrrsssssaaaaaaaaaaaaaaaaaaaaaaaaaaaaaaaaaaaaaaaaaaaaaaaaaaaaaa
srrrrrrqqpmnnnmpqrrrrrrrrrrrrrqqpmnnnmprrrrrrrrrrrrrqqqpmnnnmpqrrrrrrrrsssaaaaaaaaaaaaaaaaaaaaaaaaaaaaaaaaaaaaaaaaaaaaaaaaaaaaaa
srrrrrrqqpmnnnmpqrrrrrrrrrrrrrqqpmnnnmprrrrrrrrrrrrrrrqpmnnnmpqqrrrrrrrsssaaaaaaaaaaaaaaaaaaaaaaaaaaaaaaaaaaaaaaaaaaaaaaaaaaaaaa
srrrrrrqqpmnnnmpqqrrrrrrrrrrrqqqpmnnnmpqqrrrrrrrrrrrrrqpmnnnmpqqrrrrrrrsssaaaaaaaaaaaaaaaaaaaaaaaaaaaaaaaaaaaaaaaaaaaaaaaaaaaaaa
srrrrrrqqpmnnnmpqqrrrrrrrrrrqqqqpmnnnmpqqqqrrrrrrrrrrqqpmnnnmpqqqqrrrrrsssaaaaaaaaaaaaaaaaaaaaaaaaaaaaaaaaaaaaaaaaaaaaaaaaaaaaaa
srrrrrrqrpmnnnmpqqqqrrrrrrrrqqqqpmnnnmpqqqqrrrrrrrrqqqqpmnnnmpqqqqrrrrssssaaaaaaaaaaaaaaaaaaaaaaaaaaaaaaaaaaaaaaaaaaaaaaaaaaaaaa
srrsopppppmnnnmppppporrrrrropppppmnnnmppppporrrrrropppppmnnnmppppporrrrsssaaaaaaaaaaaaaaaaaaaaaaaaaaaaaaaaaaaaaaaaaaaaaaaaaaaaaa
srrsommmmmmnnnmmmmmmpqrrrrrpmmmmmmnnnmmmmmmossrrrrommmmmmnnnmmmmmmorrrrrssaaaaaaaaaaaaaaaaaaaaaaaaaaaaaaaaaaaaaaaaaaaaaaaaaaaaaa
ssssomnnnnnnnnnnnnnmpqrrrrrpmnnnnnnnnnnnnnmossrrrromnnnnnnnnnnnnnmorrrrrrsaaaaaaaaaaaaaaaaaaaaaaaaaaaaaaaaaaaaaaaaaaaaaaaaaaaaaa
ssssomnnnnnnnnnnnnnmpqqrrrrpmnnnnnnnnnnnnnmosssrrsomnnnnnnnnnnnnnmorrrrrrsaaaaaaaaaaaaaaaaaaaaaaaaaaaaaaaaaaaaaaaaaaaaaaaaaaaaaa
ssssomnnnnnnnnnnnnnmpqqqqqqpmnnnnnnnnnnnnnmossssssomnnnnnnnnnnnnnmorrrrrrsaaaaaaaaaaaaaaaaaaaaaaaaaaaaaaaaaaaaaaaaaaaaaaaaaaaaaa
sssromnnnmmnnnmmnnnmppppppppmnnnmmnnnmmnnnmossssssomnnnmmnnnmmnnnmorrrrrrsaaaaaaaaaaaaaaaaaaaaaaaaaaaaaaaaaaaaaaaaaaaaaaaaaaaaaa
sssromnnnmmnnnmmnnnmmmmmmmmmmnnnmmnnnmmnnnmossssssomnnnmmnnnmmnnnmorrrrrrsaaaaaaaaaaaaaaaaaaaaaaaaaaaaaaaaaaaaaaaaaaaaaaaaaaaaaa
ssrromnnnnnnnnnnnnnnnnnnnnnnnnnnnnnnnnnnnnmosssrssomnnnnnnnnnnnnnmorrrrrrsaaaaaaaaaaaaaaaaaaaaaaaaaaaaaaaaaaaaaaaaaaaaaaaaaaaaaa
srrromnnnnnnnnnnnnnnnnnnnnnnnnnnnnnnnnnnnnmossrrrsomnnnnnnnnnnnnnmorrrrrrsaaaaaaaaaaaaaaaaaaaaaaaaaaaaaaaaaaaaaaaaaaaaaaaaaaaaaa
srrromnnnnnnnnnnnnnnnnnnnnnnnnnnnnnnnnnnnnmossrrrsomnnnnnnnnnnnnnmorrrrrrsaaaaaaaaaaaaaaaaaaaaaaaaaaaaaaaaaaaaaaaaaaaaaaaaaaaaaa
srrromnnnmmnnnmmnnnmmmmmmmmmmnnnmmnnnmmnnnmosrrrrromnnnmmnnnmmnnnmorrrrrrsaaaaaaaaaaaaaaaaaaaaaaaaaaaaaaaaaaaaaaaaaaaaaaaaaaaaaa
srrromnnnmmnnnmmnnnmppppppppmnnnmmnnnmmnnnmosrrrrromnnnmmnnnmmnnnmorrrrrrsaaaaaaaaaaaaaaaaaaaaaaaaaaaaaaaaaaaaaaaaaaaaaaaaaaaaaa
srrromnnnnnnnnnnnnnmpqqqqqqpmnnnnnnnnnnnnnmorrrrrromnnnnnnnnnnnnnmorrrrrrssaaaaaaaaaaaaaaaaaaaaaaaaaaaaaaaaaaaaaaaaaaaaaaaaaaaaa
srrromnnnnnnnnnnnnnmpqrrrqqpmnnnnnnnnnnnnnmorrrrrromnnnnnnnnnnnnnmorrrrrrrsaaaaaaaaaaaaaaaaaaaaaaaaaaaaaaaaaaaaaaaaaaaaaaaaaaaaa
srrromnnnnnnnnnnnnnmpqrrrrqpmnnnnnnnnnnnnnmorrrrrromnnnnnnnnnnnnnmorrrrrrrssaaaaaaaaaaaaaaaaaaaaaaaaaaaaaaaaaaaaaaaaaaaaaaaaaaaa
srrrommmmmmmmmmmmmmmprrrrrqpmmmmmmmmmmmmmmmorrrrrrommmmmmnnnmmmmmmorrrrrrrrssaaaaaaaaaaaaaaaaaaaaaaaaaaaaaaaaaaaaaaaaaaaaaaaaaaa
srrrooooooooooooooooorrrrrqooooooooooooooooorrrrrropppppmnnnmppppporrssssrrrsaaaaaaaaaaaaaaaaaaaaaaaaaaaaaaaaaaaaaaaaaaaaaaaaaaa
srrrrrrrrrrrrrrrrrrrrrrrrrrrrrrrrrrrrrrrrrrrrrrrrrrqqqqpmnnnmpqqqrrrrrsssrrrssaaaaaaaaaaaaaaaaaaaaaaaaaaaaaaaaaaaaaaaaaaaaaaaaaa
srrrrrrrrrrrrrrrrrrrrrrrrrrrrrrrrrrrrrrrrrrrrrrrrrrqqqqpmnnnmpqqqrrrrrsssrrrrssaaaaaaaaaaaaaaaaaaaaaaaaaaaaaaaaaaaaaaaaaaaaaaaaa
srrrrrrrrrrrrrrrrrrrrrrrrrrrrrrrrrrrrrrrrrrrrrrrrrrqqqqpmnnnmpqqqrrrrrrssrrrrrssaaaaaaaaaaaaaaaaaaaaaaaaaaaaaaaaaaaaaaaaaaaaaaaa
srrrrrrrrrrrrrrrrrrrrrrrrrrrrrrrrrrrrrrrrrrrrrrrrrqqqqqpmnnnmpqqqrrrrrrrsrrrrrrsaaaaaaaaaaaaaaaaaaaaaaaaaaaaaaaaaaaaaaaaaaaaaaaa
srrrrrrrrrrrrrrrrrrrrrrrrrrrrrrrrrrrrrrrrrrrrrrrrqqqqqqpmnnnmpqqrrrrrrrrrrrrssssaaaaaaaaaaaaaaaaaaaaaaaaaaaaaaaaaaaaaaaaaaaaaaaa
srrrrrrrrrsssrrrrrrrrrrrrrrrrrrrrrrrrrrrrrrrrrrrrqqqqqqpmnnnmpqqqqqrrrrrrsssssssaaaaaaaaaaaaaaaaaaaaaaaaaaaaaaaaaaaaaaaaaaaaaaaa
srrrrrrrssssssrrrrrrrrrrrrrsssssrrrrrrrrrrrrrrrrrqopppppmnnnmppppporrrrrroooooooooooooooooooooooooooaaaaaaaaaaaaaaaaaaaaaaaaaaaa
srrrrrrssrssssrrrrrrrrrrrrsssssssrrrrrrrrrrrrrrrrrommmmmmnnnmmmmmmprrrrrrpmmmmmmmmmmmmmmmmmmmmmmmmmoaaaaaaaaaaaaaaaaaaaaaaaaaaaa
srrrrrrrrsssrrrrrrrrrrrrrrsssssssrrrrrrrrrrrrrrrrromnnnnnnnnnnnnnmprrrrrrpmnnnnnnnnnnnnnnnnnnnnnnnmoaaaaaaaaaaaaaaaaaaaaaaaaaaaa
srrrrrrrrrrrrrrrrrrrrrrrrrrssssssrrrrrrrrrrrrrrrrromnnnnnnnnnnnnnmprrrrrrpmnnnnnnnnnnnnnnnnnnnnnnnmoaaaaaaaaaaaaaaaaaaaaaaaaaaaa
srrrrrrrrrrrrrrrrrrrrrrrrrrssssssrrrrrrrrrrrrrrrrromnnnnnnnnnnnnnmprrrrrrpmnnnnnnnnnnnnnnnnnnnnnnnmooooooaaaaaaaaaaaaaaaaaaaaaaa
srrrrrrrrrrrrrrrrrrrrrrrrrrrrssssrrrrrrrrrrrrrrrrromnnnmmnnnmmnnnmppppppppmnnnmmnnnmmnnnmmnnnmmnnnmmmmmmoaaaaaaaaaaaaaaaaaaaaaaa
srrrrrrrrrrrrrrrrrrrrrrrrrrrrrrsrrrrrrrrrrrrrrrrrromnnnmmnnnmmnnnmmmmmmmmmmnnnmmnnnmmnnnmmnnnmmnnnmmmmmmoaaaaaaaaaaaaaaaaaaaaaaa
srrrrrrrrrrrrrrrrrrrrrssrrrrrrrrrrrrrrrrrrrrrrrrrromnnnnnnnnnnnnnnnnnnnnnnnnnnnnnnnnnnnnnnnnnnnnnnnnnmmmoaaaaaaaaaaaaaaaaaaaaaaa
srrrrrrrrrrrrrrrrrrrssssrrrrrrrrrrrrrrrrrrrrrrrrrromnnnnnnnnnnnnnnnnnnnnnnnnnnnnnnnnnnnnnnnnnnnnnnnnnmmmoaaaaaaaaaaaaaaaaaaaaaaa
srrrrrrrrrrrrrrrrrssssssrrrrrrrrrrrrrrrrrrrrrrrrrromnnnnnnnnnnnnnnnnnnnnnnnnnnnnnnnnnnnnnnnnnnnnnnnnnmmmoaaaaaaaaaaaaaaaaaaaaaaa
srrrrrrrrrrrrrrrrrsssssrrrrrrrrrrrrrrrrrrrrrrrrrrromnnnmmnnnmmnnnmmmmmmmmmmnnnmmnnnmmnnnmmnnnmmnnnmmmmmmoaaaaaaaaaaaaaaaaaaaaaaa
srrrrrrrrrrrrrrrrrrrrrrrrrrrrrrrrrrrrrrrrrrrrrrrrromnnnmmnnnmmnnnmppppppppmnnnmmnnnmmnnnmmnnnmmnnnmmmmmmoaaaaaaaaaaaaaaaaaaaaaaa
srrrrrrrrrrrrrrrrrrrrrrrrrrrrrrrrrrrrrrrrrrrrrrrrromnnnnnnnnnnnnnmpqqqrrrpmnnnnnnnnnnnnnnnnnnnnnnnmooooooaaaaaaaaaaaaaaaaaaaaaaa
srrrrrrrrrrrrrrrrrrrrrrrrrrrrrrrrrrrrrrrrrrrrrrrrromnnnnnnnnnnnnnmpqqrrrrpmnnnnnnnnnnnnnnnnnnnnnnnmoaaaaaaaaaaaaaaaaaaaaaaaaaaaa
srrrrrrrrrrrrrrrrrrrrrrrrrrrrrrrrrrrrrrrrrrrrrrrrromnnnnnnnnnnnnnmpqrrrrrpmnnnnnnnnnnnnnnnnnnnnnnnmoaaaaaaaaaaaaaaaaaaaaaaaaaaaa
srrrrrrrrrrrrrrrrrrrrrrrrrrrrrrrrrrrrrrrrrrrrrrrrrommmmmmmmmmmmmmmprrrrrrpmmmmmmmmmmmmmmmmmmmmmmmmmoaaaaaaaaaaaaaaaaaaaaaaaaaaaa
srrrrrrrrrrrrrrrrrrrrrrrrrrrrrrrrrrrrrrrrrrrrrrrrrooooooooooooooooorrrrrroooooooooooooooooooooooooooaaaaaaaaaaaaaaaaaaaaaaaaaaaa
srrrrrrrrrrrrrrrrrrrrrrrrrrrrrrrrrrrrrrrrrrrrrrrrrrrrrrrrrrrrrrrrrrrrrrrrssaaaaaaaaaaaaaaaaaaaaaaaaaaaaaaaaaaaaaaaaaaaaaaaaaaaaa
srrrrrrrrrrrrrrrrrrrrrrrrrrrrrrrrrrrrrrrrrrrrrrrrrrrrrrrrrrrrrrrrrrrrrrrrssaaaaaaaaaaaaaaaaaaaaaaaaaaaaaaaaaaaaaaaaaaaaaaaaaaaaa
srrrrrrrrrrrrrrrrrrrrrrrrrrrrrrrrrrrrrrrrrrrrrrrrrrrrrrrrrrrrrrrrrrrrrrrsssaaaaaaaaaaaaaaaaaaaaaaaaaaaaaaaaaaaaaaaaaaaaaaaaaaaaa
srrrrrrrrrrrrrrrrrrrrrrrrrrrrrrrrrrrrrrrrrrrrrrrrrrrrrrrrrrrrrrrrrrrrrrssssaaaaaaaaaaaaaaaaaaaaaaaaaaaaaaaaaaaaaaaaaaaaaaaaaaaaa
srrrrrrrrrrrrrrrrrrrrrrrrrrrrrrrrrrrrrrrrrrrrrrrrrrrrrrrrrrrrrrrrrrrrrsssssaaaaaaaaaaaaaaaaaaaaaaaaaaaaaaaaaaaaaaaaaaaaaaaaaaaaa
srrrrrrrrrrrrrrrrrrrrrrrrrrrrrrrrrrrrrrrrrrrrrrrrrrrrrrrrrrrrrrrrrrrrssssssaaaaaaaaaaaaaaaaaaaaaaaaaaaaaaaaaaaaaaaaaaaaaaaaaaaaa
srrrrrrrrrrrrrrrrrrrrrrrrrrrrrrrrrrrrrrrrrrrrrrrrrrrrrrrrrrrrrrrrrsssssssssaaaaaaaaaaaaaaaaaaaaaaaaaaaaaaaaaaaaaaaaaaaaaaaaaaaaa
sssssssssssssssssssssssssssssssssssssssssssssssssssssssssssssssssssssssssssaaaaaaaaaaaaaaaaaaaaaaaaaaaaaaaaaaaaaaaaaaaaaaaaaaaaa
"}
