//MAP CONVERTED BY dmm2tgm.py THIS HEADER COMMENT PREVENTS RECONVERSION, DO NOT REMOVE
"a" = (
/turf/dmm_suite/clear_turf,
/area/dmm_suite/clear_area)
"b" = (
/turf/simulated/floor/boss,
/area/dmm_suite/clear_area)
"c" = (
/obj/structure/interactive/fountain,
/turf/simulated/floor/boss,
/area/dmm_suite/clear_area)

(1,1,1) = {"
a
a
b
b
a
a
"}
(2,1,1) = {"
b
c
b
b
c
a
"}
(3,1,1) = {"
b
b
b
b
b
b
"}
(4,1,1) = {"
b
b
b
b
b
b
"}
(5,1,1) = {"
a
c
b
b
c
a
"}
(6,1,1) = {"
a
a
b
b
a
a
"}
