"a" = (/turf/simulated/floor/lava,/area/dungeons/lava)
"b" = (/turf/simulated/floor/basalt,/area/dungeons/lava)
"c" = (/turf/simulated/floor/ash,/area/dungeons/lava)
"d" = (/turf/simulated/wall/rock,/area/dungeons/lava)
"e" = (/turf/simulated/wall/rock,/area/dungeons/lava/safe)
"f" = (/turf/simulated/floor/lava,/area/dungeons/lava/safe)
"g" = (/turf/simulated/floor/basalt,/area/dungeons/lava/safe)
"h" = (/turf/simulated/floor/ash,/area/dungeons/lava/safe)
"i" = (/obj/marker/spawnpoint/ghost,/turf/simulated/floor/basalt,/area/dungeons/lava/safe)
"j" = (/obj/marker/spawnpoint/new_character,/turf/simulated/floor/basalt,/area/dungeons/lava/safe)
"k" = (/turf/simulated/wall/metal,/area/dungeons/lava/safe)
"l" = (/obj/trigger/jumploc/save_and_south,/obj/effect/fake_lighting/gradient{icon_state = "gradient"; dir = 1},/turf/simulated/floor/basalt,/area/dungeons/lava/safe)
"m" = (/turf/simulated/wall/light,/area/dungeons/lava/safe)

(1,1,1) = {"
aaaaaaaaaaaaaaaaaaaaaaaaaaaaaaaaaaaaaaaaaaaaaaaaaaaaaaaaaaaaaaaa
aaaaaaaaaaaaaaaaaaaaaaaaaaaaaaaaaaaaaaaaaaaaaaaaaaaaaaaaaaaaaaaa
aaaaaaaaaaaaaaaaaaaaaaaaaaaaaaaaaaaaaaaaaaaaaaaaaaaaaaaaaaaaaaaa
aaaaaaaaaaaaaaaaaaaaaaaaaaaaaaaaaaaaaaaaaaaaaaaaaaaaaaaaaaaaaaaa
aaaabbbbbbbaaaaaaaaaaaaaaaaaaaaaaaaaaaaaaaaaaaaaaaaaaaaaaaaaaaaa
aaaabbbbbbbaaaaaaaaaaaaaaaaaaaaaaaaaaaaaaaaaaaaaaaaaaaaaaaaaaaaa
aaaabbbbbbbaaaaaaaaaaaaaaaaaaaaaaaaaaaaaaaaaaaaaaaaaaaaaaaaaaaaa
aaaabbbbbbbaaaaaaaaaaaaaaaaaaaaaaaaaaaaaaaaaaaaaaaaaaaaaaaaaaaaa
aaaabbbbbbbaaaaaaaaaaaaaaaaaaaaaaaaaaaaaaaaaaaaaaaaaaaaaaaaaaaaa
aaaabbbbbbbaaaaaaaaaaaaaaaaaaaaaaaaaaaaaaaaaaaaaaaaaaaaaaaaaaaaa
aaaabbbbbbbaaaaaaaaaaaaaaaaaaaaaaaaaaaaaaaaaaaaaaaaaaaaaaaaaaaaa
aaaabbbbbbbbbaaaaaaaaaabbbbbbbbbbbbaaaabbbbbbbbbbbbbbbbbbbbbaaaa
aaaabbbbbbbbbbaaaaaaaabbbbbbbbbbbbbaaaabbbbbbbbbbbbbbbbbbbbbaaaa
aaaabbbbbbbbbbbaaaaaabbbbbbbbbbbbbbaaaabbbbbbbbbbbbbbbbbbbbbaaaa
aaaabbbbbbbbbbbbaaaabbbbbbbbbbbbbbbaaaabbbbbbbbbbbbbbbbbbbbbaaaa
aaaabbbbbbbbbbbbaaaabbbbbbbbbbbbbbbaaaabbbbbbbbcccccccbbbbbbaaaa
aaaabbbbbbbbbbbbaaaabbbbbbbbbbbbbbbaaaabbbbbbcccccccccbbbbbbaaaa
aaaabbbbbbbbbbbbaaaabbbbbbbbbbbbbbbbaaaabbbbbcccccccccbbbbbbaaaa
aaaabbbbbbbbbbbbbaaaabbbbbbbbbbbbbbbaaaabbbbbccccccddcbbbbbbaaaa
aaaabbbbbbbbbbbbbaaaabbbbbbbbbbbbbbbaaaabbbbbccccccddcbbbbbbaaaa
aaaabbbbbbbbbbbbbaaaabbbbbbbbbbbbbbbaaaabbbbbcccccdddcbbbbbbaaaa
aaaabbbbbbbbbbbbbaaaabbbbbbbbbbbbbbbaaaabbbbbccccddddcbbbbbbaaaa
aaaabbbbbbbbbbbbbbaaaabbbbbbbbbbbbbbaaaabbbbcccccddddcbbbbbbaaaa
aaaabbbbbbbbbbbbbbaaaabbbbbbbbbbbbbbbaaaabbbccccdddddcbbbbbbaaaa
aaaabbbbbbbbbbbbbbaaaabbbbbbbbbbbbbbbaaaabbbcccddddddcdbbbbbaaaa
aaaabbbbbbbbbbbbbbaaaaeeeeeeeeeeeeeeefaaabbbcccdddddccddbbbbaaaa
aaaabbbbbbbbbbbbbbbaaaegghheeeeeeggggeaaabbbccccdddcccddbbbbaaaa
aaaabbbbbbbbbbbbbbbaaaegihhggeeeeggjgeaaabbbccccdddcccddbbbbaaaa
aaaabbbbbbbbbbbbbbbaaaeghhhggggeeeegeeaaaabbcccccddccddddbbbaaaa
aaaabbbbbbbbbbbbbbbaaaeghhhggggghhhgeeaaaabbccccccddcddddbbbaaaa
aaaabbbbbbbbbbbbbbbaaaeghhhhhklkhhhheeaaaabbcccccccdcddddbbbaaaa
aaaabbbbbbbbbbbbbbbaaaeehhhhhkmkhhhhgeaaaabbccccccccccdddbbbaaaa
aaaabbbbbbbbbbbbbbbaaaeeehhhhkgkhhhheeaaaabbbbbbcccccccddbbbaaaa
aaaabbbbbbbbbbbbbbbaaaeeehhhhhhhhhhheebaaaabbbbbcccccccddbbbaaaa
aaaabbbbbbbbbbbbbbbaaaegghhhhhhhhhhheebaaaabbbbbcccccccddbbbaaaa
aaaabbbbbbbbbbbbbbbaaaegghhhhhhhhhhhgebaaaaabbbbcccccccddbbbaaaa
aaaabbbbbbbbbbbbbbbaaaeeghhhhhhhhhhhgebaaaaaabbbbbbbccccdbbbaaaa
aaaabbbbbbbbbbbbbbbaaaegghhhhhhhhhhhgebaaaaaabbbbbbbccccbbbbaaaa
aaaabbbbbbbbbbbbbbbaaaeeghheeggghhhheebaaaaaaabbbbbbccccbbbbaaaa
aaaabbbbbbbbbbbbbbbaaaeeehheeegghhhgeebbaaaaaaaabbbbccccbbbbaaaa
aaaabbbbbbbbbbbbbbbbaaeeeeeeeeeghhhggebbaaaaaaaabbbbccccbbbbaaaa
aaaabbbbbbbbbbbbbbbbaaaabbbbbbbbcccbbbbbaaaaaaaaabbbcccccbbbaaaa
aaaabbbbbbbbbbbbbbbbadaabbbbbbbccccbbbbbaaaaaaaaaabbbbbccbbbaaaa
aaaabbbbbbbbbbbbbbbbdddabbbbbbbcccbbbbbaaaaaaaaaaaaabbbccbbbaaaa
aaaabbbbbbbbbbbbbbbbdddabbbdbbbcccbbbbaaaaaaaaaaaaaaabbccbbbaaaa
aaaabbbbbbbbbbbbbbbbddbbbbbdbdccccbbbaaaaaaaaaaaaaaaabbccbbbaaaa
aaaabbbbbbbbbbbbbbbbbbbbbbbdddccccbbaaaaaaaaaaaaaaaaabbcccbbaaaa
aaaabbbbbbbbbbbbbbbbddddbbbbddccccbbaaaaaaaaaaaaaaaaabbcccbbaaaa
aaaabbbbbbbbbbbbbbbbddddbbbdddcccbbbaaaaaaaaaaaaaaaaabbcccbbaaaa
aaaabbbbbbbbbbbbbbbbadddbbbdddcccbbbbaaaaaaaaaaaaaaaabbcccbbaaaa
aaaabbbbbbbbbbbbbbbbaaaabbbdddcccddbbbaaaaaaaaaaaaaaabbcccbbaaaa
aaaabbbbbbbbbbbbbbbbaaaabbbdddcccdddbbbaaaaaaaaaaaaabbbcccbbaaaa
aaaabbbbbbbbbbbbbbbbaaaabbbbddcccddddbbbaaaaaaaaaaabbbbcccbbaaaa
aaaabbbbbbbbbbbbbbbbbaaaabbbddcccddddbbbbaaaaaaaaabbbbbbccbbaaaa
aaaabbbbbbbbbbbbbbbbbaaaabbbddccccddbbbbbbbbbbbbbbbbbbccccbbaaaa
aaaabbbbbbbbbbbbbbbbbaaaabbbbcccccddbbbbbbbbbbbbbbbbbbccccbbaaaa
aaaabbbbbbbbbbbbbbbbbaaaabbbbbccccccccccccccccccccccccccccbbaaaa
aaaabbbbbbbbbbbbbbbbbaaaabbbbbccccccccccccccccccccccccccccbbaaaa
aaaabbbbbbbbbbbbbbbbbaaaabbbbbbbbbbbbbbbbbbbccccccccccccccbbaaaa
aaaabbbbbbbbbbbbbbbbbaaaabbbbbbbbbbbbbbbbbbbbbbbbbbbbbbbbbbbaaaa
aaaaaaaaaaaaaaaaaaaaaaaaaaaaaaaaaaaaaaaaaaaaaaaaaaaaaaaaaaaaaaaa
aaaaaaaaaaaaaaaaaaaaaaaaaaaaaaaaaaaaaaaaaaaaaaaaaaaaaaaaaaaaaaaa
aaaaaaaaaaaaaaaaaaaaaaaaaaaaaaaaaaaaaaaaaaaaaaaaaaaaaaaaaaaaaaaa
aaaaaaaaaaaaaaaaaaaaaaaaaaaaaaaaaaaaaaaaaaaaaaaaaaaaaaaaaaaaaaaa
"}
