"a" = (/turf/unsimulated/void,/area/world/temple01/exterior)
"b" = (/obj/effect/fake_lighting/gradient/black,/obj/effect/fake_lighting/gradient/black{icon_state = "gradient"; dir = 4},/turf/simulated/floor/light/reebe,/area/world/temple01/exterior)
"c" = (/obj/effect/fake_lighting/gradient/black,/turf/simulated/floor/light/reebe,/area/world/temple01/exterior)
"d" = (/obj/effect/fake_lighting/gradient/black,/obj/effect/fake_lighting/gradient/black{icon_state = "gradient"; dir = 8},/turf/simulated/floor/light/reebe,/area/world/temple01/exterior)
"e" = (/obj/effect/fake_lighting/gradient/black{icon_state = "gradient"; dir = 4},/turf/simulated/floor/light/reebe,/area/world/temple01/exterior)
"f" = (/turf/simulated/floor/light/reebe,/area/world/temple01/exterior)
"g" = (/obj/effect/fake_lighting/gradient/black{icon_state = "gradient"; dir = 8},/turf/simulated/floor/light/reebe,/area/world/temple01/exterior)
"h" = (/turf/simulated/wall/clockwork,/area/world/temple01/interior)
"i" = (/turf/simulated/floor/clockwork/reebe,/area/world/temple01/interior)
"j" = (/obj/structure/interactive/door/airlock/brass,/turf/simulated/floor/clockwork/reebe,/area/world/temple01/interior)
"k" = (/turf/simulated/floor/clockwork/alt3,/area/world/temple01/interior)
"l" = (/obj/structure/smooth/window/clockwork,/turf/simulated/floor/clockwork/reebe,/area/world/temple01/interior)
"m" = (/obj/structure/smooth/table/brass,/turf/simulated/floor/clockwork/reebe,/area/world/temple01/interior)
"n" = (/obj/structure/smooth/window/clockwork,/turf/simulated/floor/clockwork/alt3,/area/world/temple01/interior)
"o" = (/obj/structure/smooth/table/brass,/turf/simulated/floor/clockwork/alt3,/area/world/temple01/interior)
"p" = (/obj/effect/fake_lighting/gradient/black{icon_state = "gradient"; dir = 1},/turf/simulated/floor/light/reebe,/area/world/temple01/exterior)
"q" = (/turf/simulated/floor/clockwork/alt2,/area/world/temple01/interior)
"r" = (/obj/structure/interactive/door/airlock/brass,/turf/simulated/floor/clockwork/alt3,/area/world/temple01/interior)
"s" = (/turf/simulated/wall/clockwork,/area/world/temple01/interior/safe)
"t" = (/turf/simulated/wall/rock,/area/world/jungle/cave)
"u" = (/turf/simulated/floor/clockwork/reebe,/area/world/temple01/interior/safe)
"v" = (/obj/marker/teleport_location/clockwork_exit,/turf/simulated/floor/clockwork/alt2,/area/world/temple01/interior/safe)
"w" = (/turf/simulated/floor/clockwork/alt3,/area/world/temple01/interior/safe)
"x" = (/obj/structure/smooth/window/clockwork,/turf/simulated/floor/clockwork/reebe,/area/world/temple01/interior/safe)
"y" = (/turf/unsimulated/void,/area/world/temple01/interior)
"z" = (/obj/structure/smooth/table/brass,/turf/simulated/floor/clockwork/reebe,/area/world/temple01/interior/safe)
"A" = (/obj/structure/interactive/door/airlock/brass,/turf/simulated/floor/clockwork/reebe,/area/world/temple01/interior/safe)
"B" = (/obj/structure/interactive/wishgranter/normal/clockwork/boss,/turf/simulated/floor/clockwork/alt3,/area/world/temple01/interior/safe)
"C" = (/turf/simulated/floor/cave_dirt,/area/world/jungle/cave/clockwork_cave)
"D" = (/obj/structure/scenery/rocks,/turf/simulated/floor/cave_dirt,/area/world/jungle/cave)
"E" = (/turf/simulated/floor/cave_dirt,/area/world/jungle/cave)
"F" = (/obj/structure/scenery/rocks,/turf/simulated/floor/cave_dirt,/area/world/jungle/cave/clockwork_cave)
"G" = (/obj/structure/interactive/wishgranter/normal/clockwork,/turf/simulated/floor/cave_dirt,/area/world/jungle/cave/clockwork_cave)
"H" = (/obj/effect/fake_lighting/gradient/black{icon_state = "gradient"; dir = 8},/obj/effect/fake_lighting/gradient/black{icon_state = "gradient"; dir = 1},/turf/simulated/floor/light/reebe,/area/world/temple01/exterior)
"I" = (/obj/structure/interactive/lighting/bonfire/on,/turf/simulated/floor/cave_dirt,/area/world/jungle/cave)

(1,1,1) = {"
aaaaaaaaaaaaaaaaaaaaaaaaaaaaaaaaaaaaaaaaaaaaaaaaaaaaaaaaaaaaaaaaaaaaaaaaaaaaaaaaaaaaaaaaaaaaaaaaaaaaaayyhhhhhhhhhhhhhhhhhhhhhyyy
abccccccccccccccccccccccccccccccccccccccccccccccccccccccccccccccccccccccccccccccccccccccccccccccccccdayyhqkkkkkhkkkkkhkkkkkqhyyy
aeffffffffffffffffffffffffffffffffffffffffffffffffffffffffffffffffffffffffffffffffffffffffffffffffffgayyhkkkkkkhkkkkkhkkkkkkhyyy
aeffffffffffffffffffffffffffffffffffffffffffffffffffffffffffffffffffffffffffffffffffffffffffffffffffgayyhkkkkkkhhkkkhhkkkkkkhyyy
aeffffffffffffffffffffffffffffffffffffffffffffffffffffffffffffffffffffffffffffffffffffffffffffffffffgayyhkkkkkkkkkkkkkkkkkkkhyyy
aeffffffffffffffffffffffffffffffffffffffffffffffffffffffffffffffffffffffffffffffffffffffffffffffffffgayyhkkkkkkkkkkkkkkkkkkkhyyy
aeffffffffffffffffffffffffffffffffffffffffffffffffffffffffffffffffffffffffffffffffffffffffffffffffffgayhhkkkkkkkkkkkkkkkkkkkhhyy
aeffffffffffffffffffffffffffffffffffffffffffffffffffffffffffffffffffffffffffffffffffffffffffffffffffgayhkkkkkkkkkkkkkkkkkkkkkhyy
aeffffffffffffffffffffffffffffffffffffffffffffffffffffffffffffffffffffffffffffffffffffffffffffffffffgayhqkhhhhhhkkkkkhhhhhhkqhyy
aeffffffffffffffffffffffffffffffffffffffffffffffffffffffffffffffffffffffffffffffffffffffffffffffffffgayhhhhyyyyhhkkkhhyyyyhhhhyy
aeffffffffffffffffffffffffffffffffffffffffffffffffffffffffffffffffffffffffffffffffffffffffffffffffffgayyyyyyyyyyhkkkhyyyyyyyyyyy
aeffffffffffffffffffffffffffffffffffffffffffffffffffffffffffffffffffffffffffffffffffffffffffffffffffgayyyyyyyyyyhkkkhyyyyyyyyyyy
aeffffffffffffffffffffffffffffffffffffffffffffffffffffffffffffffffffffffffffffffffffffffffffffffffffgayyyyyyyyyyhkkkhyyyyyyyyyyy
aeffffffffffffffffffffffffffffffffffffffffffffffffffffffffffffffffffffffffffffffffffffffffffffffffffgayyyyyyyyyyhkkkhyyyyyyyyyyy
aeffffffffffffffffffffffffffffffffffffffffffffffffffffffffffffffffffffffffffffffffffffffffffffffffffgayhhhhhhhyyhkkkhyyyyyyyyyyy
aeffffffffffffffffffffffffffffffffffffffffffffffffffffffffffffffffffffffffffffffffffffffffffffffffffgayhmmmmmhyyhkkkhyyyyyyyyyyy
aeffffffffffffffffffffffffffffffffffffffffffhhhhhhhhhhhhhhhhhhhhhhhhhhhhhhhhhhhhhhhhhfffffffffffffffgahhlllllhhyhkkkhyyyyyyyyyyy
aeffffffffffffffffffffffffffffffffffffffffffhiiiiiiiiiiiiiiiiiiiiiiiiiiiiiiiiiiiiiiihfffffffffffffffgahqkkkkkqhyhkkkhyyyyyyyyyyy
aeffffffffffffffffffffffffffffffffffffffffffhiiiiiiiiiiiiiiiiiiiiiiiiiiiiiiiiiiiiiiihfffffffffffffffgahkkkkkkkhhhkkkhyyyyyyyyyyy
aeffffffffffffffffffffffffffffffffffffffffffhiiiiiiiiiiiiiiiiiiiiiiiiiiiiiiiiiiiiiiihfffffffffffffffgahkkkkkkkhkkkkkhyyyyyyyyyyy
aeffffffffffffffffffffffffffffffffffffffffffhiiiiiiiiiiiiiiiiiiiiiiiiiiiiiiiiiiiiiiihfffffffffffffffgahkkkkkkkrkkkkkhyyyyyyyyyyy
aeffffffffffffffffffffffffffffffffffffffffffhiiiiiiiiiiiiiiiiiiiiiiiiiiiiiiiiiiiiiiihfffffffffffffffgahkkkkkkkhkkkkkhyyyyyyyyyyy
aeffffffffffffffffffffffffffffffffffffffffffhiiiiiiiiiiiiiiiiiiiiiiiiiiiiiiiiiiiiiiihfffffffffffffffgahkkkkkkkhhhhhhhyyyyyyyyyyy
aeffffffffffffffffffffffffffffffffffffffffffhiiiiiiiiiiiiiiiiiiiiiiiiiiiiiiiiiiiiiiihfffffffffffffffgahqkkkkkkhyyyyyyyyyyyyyyyyy
aeffffffffffffffffffffffffffffffffffffffffffhiiiiiiiiiiiiiiiiiiiiiiiiiiiiiiiiiiiiiiihfffffffffffffffgahhhhrhhhhyyyyyyyyyyyyyyyyy
aeffffffffffffffffffffffffffffffffffffffffffhiiiiiiiiiiiiiiiiiiiiiiiiiiiiiiiiiiiiiiihfffffffffffffffgayyhkkkhyyyyyyyyyyyhhhhhhhy
aeffffffffffffffffffffffffffffffffffffffffffhiiiiiiiiiiiiiiiiiiiiiiiiiiiiiiiiiiiiiiihfffffffffffffffgayyhkkkhyyyyyyyyyyyhmmmmmhy
aeffffffffffffffffffffffffffffffffffffffffffhiiiiiiiiiiiiiiiiiiiiiiiiiiiiiiiiiiiiiiihfffffffffffffffgayyhkkkhyyyyyyyyyyhhlllllhh
aeffffffffffffffffffffffffffffffffffffffffffhiiiiiiiiiiiiiiiiiiiiiiiiiiiiiiiiiiiiiiihfffffffffffffffgayhhkkkhhyyyyyyyyyhqkkkkkqh
aeffffffffffffffffffffffffffffffffffffffffffhiiiiiiiiiiiiiiiiiiiiiiiiiiiiiiiiiiiiiiihfffffffffffffffgayhqkkkkhhhhhhhhhhhkkkkkkkh
aeffffffffffffffffffffffffffffffffffffffffffhiiiiiiiiiiiiiiiiiiiiiiiiiiiiiiiiiiiiiiihfffffffffffffffgayhkkkkkkkkkkkkkkkhkkkkkkkh
aeffffffffffffffffffffffffffffffffffffffffffhiiiiiiiiiiiiiiiiiiiiiiiiiiiiiiiiiiiiiiihfffffffffffffffgayhkkkkkkkkkkkkkkkrkkkkkkkh
aeffffffffffffffffffffffffffffffffffffffffffhiiiiiiiiiiiiiiiiiiiiiiiiiiiiiiiiiiiiiiihfffffffffffffffgayhkkkkkkkkkkkkkkkhkkkkkkkh
aeffffffffffffffffffffffffffffffffffffffffffhiiiiiiiiiiiiiiiiiiiiiiiiiiiiiiiiiiiiiiihfffffffffffffffgayhqkkkqhhhhhhhhhhhkkkkkkkh
aeffffffffffffffffffffffffffffffffffffffffffhhhhhhhhhhhhhhhhhhhiiihhhhhhhhhhhhhhhhhhhfffffffffffffffgayhhhhhhhyyyyyyyyyhkkkkkkqh
aeffffffffffffffffffffffffffffffffffffffffffffffffffffffhiiiiiiiiiiiiiiihfffffffffffffffffffffffffffgayyyyyyyyyyyyyyyyyhhhhrhhhh
aeffffffffffffffffffffffffffffffffffffffffffffffffffffffhiiiiiiiiiiiiiiihfffffffffffffffffffffffffffgayyyyyyyyyyyyyyyyyyyhkkkhyy
aeffffffffffffffffffffffffffffffffffffffffffffffffffffffhiiiiiiiiiiiiiiihfffffffffffffffffffffffffffgayyyyyyyyyyyyyyyyyyyhkkkhyy
aeffffffffffffffffffffffffffffffffffffffffffffffffffffffhiiiiiiiiiiiiiiihfffffffffffffffffffffffffffgayyhhhhhhhhhhhhhhhhhhkkkhyy
aeffffffffffffffffffffffffffffffffffffffffffffffffffffffhiiiiiiiiiiiiiiihfffffffffffffffffffffffffffgayyhqkkkkkkkkkkkkkkkkkkkhyy
aeffffffffffffffffffffffffffffffffffffffffffffffffffffffhiiiiiiiiiiiiiiihfffffffffffffffffffffffffffgayyhkkkkkkkkkkkkkkkkkkkkhyy
aeffffffffffffffffffffffffffffffffffffffffffffffffffffffhiiiiiiiiiiiiiiihfffffffffffffffffffffffffffgayyhkkkkkkkkkkkkkkkkkkkqhyy
aeffffffffffffffffffffffffffffffffffffffffffffffffffffffhiiiiiiiiiiiiiiihfffffffffffffffffffffffffffgayyhkkkhhhhhhhhhhhhhhhhhhyy
aeffffffffffffffffffffffffffffffffffffffffffffffffffffffhiiiiiiiiiiiiiiihfffffffffffffffffffffffffffgayyhkkkhyyyyyyyyyyyyyyyyyyy
aeffffffffffffffffffffffffffffffffffffffffffffffffffffffhiiiiiiiiiiiiiiihfffffffffffffffffffffffffffgayyhkkkhyyyyyyyyyyyhhhhhhhy
aeffffffffffffffffffffffffffffffffffffffffffffffffffffffhiiiiiiiiiiiiiiihfffffffffffffffffffffffffffgayyhkkkhyyyyyyyyyyyhmmmmmhy
aeffffffffffffffffffffffffffffffffffffffffffffffffffffffhiiiiiiiiiiiiiiihfffffffffffffffffffffffffffgahhhhrhhhhyyyyyyyyhhlllllhh
aeffffffffffffffffffffffffffffffffffffffffffffffffffffffhhhhssssAsssshhhhfffffffffffffffffffffffffffgahqkkkkkqhyyyyyyyyhqkkkkkqh
aeffffffffffffffffffffffffffffffffffffffffffffffffffffffffffswwwwwwwsfffffffffffffffffffffffffffffffgahkkkkkkkhyyhhhhhhhkkkkkkkh
aeffffffffffffffffffffffffffffffffffffffffffffffffffffffffffxwwwwwwwxfffffffffffffffffffffffffffffffgahkkkkkkkhyyhkkkkkhkkkkkkkh
aeffffffffffffffffffffffffffffffffffffffffffffffffffffffffffxwwwwwwwxfffffffffffffffffffffffffffffffgahkkkkkkkhyyhkkkkkrkkkkkkkh
aeffffffffffffffffffffffffffffffffffffffffffffffffffffffffffxwwwBwwwxfffffffffffffffffffffffffffffffgahkkkkkkkhyyhkkkkkhkkkkkkkh
aeffffffffffffffffffffffffffffffffffffffffffffffffffffffffffxwwwwwwwxfffffffffffffffffffffffffffffffgahkkkkkkkhyyhkkkhhhkkkkkkkh
aeffffffffffffffffffffffffffffffffffffffffffffffffffffffffffxwwwwwwwxfffffffffffffffffffffffffffffffgahqkkkkkqhyyhkkkhyhkkkkkkqh
aeffffffffffffffffffffffffffffffffffffffffffffffffffffffffffswwwwwwwsfffffffffffffffffffffffffffffffgahhhhrhhhhyyhkkkhyhhhhrhhhh
aeffffffffffffffffffffffffffffffffffffffffffhhlllllllllllllhssssAsssshlllllllllllllhhfffffffffffffffgayyhkkkhyyyyhkkkhyyyhkkkhyy
aeffffffffffffffffffffffffffffffffffffffffffhiiiiiiiiiiiiiiiiiiiiiiiiiiiiiiiiiiiiiiihfffffffffffffffgayyhkkkhyyyyhkkkhyyyhkkkhyy
aeffffffffffffffffffffffffffffffffffffffffffhiiiiiiiiiiiiiiiiiiiiiiiiiiiiiiiiiiiiiiihfffffffffffffffgayhhkkkhhyyhhkkkhhyyhkkkhyy
aeffffffffffffffffffffffffffffffffffffffffffhiiiiiiiiiiiiiiiiiiiiiiiiiiiiiiiiiiiiiiihfffffffffffffffgayhqkkkkhhhhkkkkqhyyhkkkhyy
aeffffffffffffffffffffffffffffffffffffffffffhiiiiiiiiiiiiiiiiiiiiiiiiiiiiiiiiiiiiiiihfffffffffffffffgayhkkkkkkkkkkkkkkhyyhkkkhyy
aeffffffffffffffffffffffffffffffffffffffffffhiiiiiiiiiiiiiiiiiiiiiiiiiiiiiiiiiiiiiiihfffffffffffffffgayhkkkkkkkkkkkkkkhyyhkkkhyy
aeffffffffffffffffffffffffffffffffffffffffffhiiiiiiiiiiiiiiiiiiiiiiiiiiiiiiiiiiiiiiihfffffffffffffffgayhkkkkkkkkkkkkkkhyyhkkkhyy
aeffffffffffffffffffffffffffffffffffffffffffhiiiiiiiiiiiiiiiiiiiiiiiiiiiiiiiiiiiiiiihfffffffffffffffgayhqkkkqhhhhqkkkqhyyhkkkhyy
aeffffffffffffffffffffffffffffffffffffffffffhhhjhhhhhhhhhhhhhhhhhhhhhhhhhhhhhhhhhjhhhfffffffffffffffgayhhhhhhhyyhhhhhhhyyhkkkhyy
aeffffffffffffffffffffffffffffffffffffffffffhiiiiihiiihhiiiiiiiiiiiiiiiiihhiiihiiiiihfffffffffffffffgayyyyyyyyyyyyyyyyyyyhkkkhyy
aeffffffffffffffffffffffffffffffffffffffffffhiiiiihiiihhiiihhhhjjjhhhhiiihhiiihiiiiihfffffffffffffffgayyyyyyyyyyyyyyyyyyyhkkkhyy
aeffffffffffffffffffffffffffffffffffffffffffhiiiiiiiiihhiiihkkkkkkkkkhiiihhiiiiiiiiihfffffffffffffffgayyyyyyyyyyyyyyyyyyyhkkkhyy
aeffffffffffffffffffffffffffffffffffffffffffhiiiiiiiiihhiiihkkkkkkkkkhiiihhiiiiiiiiihfffffffffffffffgayyyyyyyyyyyyyyyyyyyhkkkhyy
aefffffffffffffffffffffffffffffffffffffffffhhhhhhhhiiiiiiiihkkkkkkkkkhiiiiiiiihhhhhhhhffffffffffffffgayyyyyyyyyyyyyyyyyyyhkkkhyy
aeffffffffffffffffffffffffffffffffffffffffflmkkkkkhiiiiiiiihkkknnnkkkhiiiiiiiihkkkkkmlffffffffffffffgayyyyyyyyyyyyyyyyyyyhkkkhyy
aeffffffffffffffffffffffffffffffffffffffffflmkkkkkhhhhhhhhhhkkknonkkkhhhhhhhhhhkkkkkmlffffffffffffffgayyyyyyhhhhhhhhhyyhhhhrhhhh
aeffffffffffffffffffffffffffffffffffffffffflmkkkkkjiiiiiiiijkkknnnkkkjiiiiiiiijkkkkkmlffffffffffffffgayyyyyyhqkkkkkqhyyhkkkkkkqh
aeffffffffffffffffffffffffffffffffffffffffflmkkkkkhhhhhhhhhhkkkkkkkkkhhhhhhhhhhkkkkkmlffffffffffffffgayyyyyyhkkkkkkkhhhhkkkkkkkh
aeffffffffffffffffffffffffffffffffffffffffflmkkkkkhhkkkkkkkhkkkkkkkkkhkkkkkkkhhkkkkkmlffffffffffffffgayyyyyyhkkkkkkkhkkhkkkkkkkh
aefffffffffffffffffffffffffffffffffffffffffhhhhjhhhhkkkkkkkhkkkkkkkkkhkkkkkkkhhhhjhhhhffffffffffffffgayyyyyyhkkkkkkkrkkrkkkkkkkh
aeffffffffffffffffffffffffffffffffffffffffffhiiiiiihkklllkkhhhhhhhhhhhkknnnkkhiiiiiihfffffffffffffffgayyyyyyhkkkkkkkhkkhkkkkkkkh
aeffffffffffffffffffffffffffffffffffffffffffhiiiiiijkklolkkhiiiiiiiiihkknonkkjiiiiiihfffffffffffffffgayyyyyyhkkkkkkkhhhhkkkkkkkh
aeffffffffffffffffffffffffffffffffffffffffffhiiiiiihkklllkkjiiiiiiiiijkknnnkkhiiiiiihfffffffffffffffgayyyyyyhqkkkkkkhyyhqkkkkkqh
aeffffffffffffffffffffffffffffffffffffffffffhhhhhhhhkkkkkkkhiiiiiiiiihkkkkkkkhhhhhhhhfffffffffffffffgayyyyyyhhhhrhhhhyyhhhhhhhhh
aeffffffffffffffffffffffffffffffffffffffffffhiiiiiihkkkkkkkhihhlllhhihkkkkkkkhiiiiiihfffffffffffffffgayyyyyyyhkkkkkhyyyyyyyyyyyy
aeffffffffffffffffffffffffffffffffffffffffffhihhhiihhhhhhhhhjhfffffhjhhhhhhhhhiihhhihfffffffffffffffgayyyyyyyhkkkkkhyyyyyyyyyyyy
aeffffffffffffffffffffffffffffffffffffffffffhiiihiiiiiiiiiiiihfffffhiiiiiiiiiiiihiiihfffffffffffffffgayyyyyyyhkkkkkhyyyyyyyyyyyy
aefffffffffffffffffffffffffffffffffffffffffhhhhjhhhhhhhhhhhhhhfffffhhhhhhhhhhhhhhjhhhhffffffffffffffgayyyyhhhhkkkkkhhhhyyyyyyyyy
aeffffffffffffffffffffffffffffffffffffffffflmiiiiiiiiiihiiiiihfffffhiiiiihiiiiiiiiiimlffffffffffffffgayyyyhmlqkkkkkqlmhyyyyyyyyy
aeffffffffffffffffffffffffffffffffffffffffflmiiiiiiiiiihiqiqilfffffliqiqihiiiiiiiiiimlffffffffffffffgayyyyhmlkkkkkkklmhyyyyyyyyy
aeffffffffffffffffffffffffffffffffffffffffflmiiiiiiiiiijiiiiilfffffliiiiijiiiiiiiiiimlffffffffffffffgayyyyhmlkkkkkkklmhyyyyyyyyy
aeffffffffffffffffffffffffffffffffffffffffflmiiiiiiiiiihiqiqilfffffliqiqihiiiiiiiiiimlffffffffffffffgayyyyhmlkkkkkkklmhyyyyyyyyy
aeffffffffffffffffffffffffffffffffffffffffflmiiiiiiiiiihiiiiihfffffhiiiiihiiiiiiiiiimlffffffffffffffgayyyyhmlqkkkkkqlmhyyyyyyyyy
aefffffffffffffffffffffffffffffffffffffffffhhhhhhhhhhhhhhhjhhhhlllhhhhjhhhhhhhhhhhhhhhffffffffffffffgayyyyhhhhkkkkkhhhhyyyyyyyyy
aeffffffffffffffffffffffffffffffffffffffffffhiiiiiiiiiiiiiihkkkkkkkkkhiiiiiiiiiiiiiihfffffffffffffffgayyyyyyyhkkkkkhyyyyyyyyyyyy
aeffffffffffffffffffffffffffffffffffffffffffhjhhhhhhhhhhhhhhkkkkkkkkkhhhhhhhhhhhhhhjhfffffffffffffffgayyyyyyyhkkkkkhyyyyyyyyyyyy
aeffffffffffffffffffffffffffffffffffffffffffhiiiiiiiiiiiiiihkkkkkkkkkhiiiiiiiiiiiiiihfffffffffffffffgayyyyyyyhkkkkkhyyyyyyyyyyyy
aeffffffffffffffffffffffffffffffffffffffffffhiiiiiiiiiiiiiihkkkkkkkkkhiiiiiiiiiiiiiihfffffffffffffffgatttthhhhhjhjhhhhhttttttttt
aeffffffffffffffffffffffffffffffffffffffffffhiiiiiiiiiiiiiijkkkkkkkkkjiiiiiiiiiiiiiihfffffffffffffffgatttthqiiiiiiiiiqhttttttttt
aeffffffffffffffffffffffffffffffffffffffffffhiiiiiiiiiiiiiihkkkkkkkkkhiiiiiiiiiiiiiihfffffffffffffffgattthhiiiiiiiiiiihhtttDDDtt
aeffffffffffffffffffffffffffffffffffffffffffhiiiiiiiiiiiiiihkkkkkkkkkhiiiiiiiiiiiiiihfffffffffffffffgattthhiihiihiihiihhtttDEEDt
aefffffffffffffffffffffffffffffffffffffffffhhhhhhhhhhhhhhhhhhhhkkkhhhhhhhhhhhhhhhhhhhhffffffffffffffgatttiiiiiiiiiiiiiiitttDEEEt
aefffffffffffffffffffffffffffffffffffffffffhmmmmmmmmmmmmmmmmmmhrrrhmmmmmmmmmmmmmmmmmmhffffffffffffffgatttDEEEEEEEEEEEEEDttttEEEt
aefffffffffffffffffffffffffffffffffffffffffhllllllllllllllllllhkkkhllllllllllllllllllhffffffffffffffgattDEEEEEDEEEEEEEEDtttttEtt
aefffffffffffffffffffffffffffffffffffffffffhiiiiiiiiiiiiiiiiiiiiiiiiiiiiiiiiiiiiiiiiihffffffffffffffgattDEEEEDtDEEEEEEEDDDttEEtt
aefffffffffffffffffffffffffffffffffffffffffhiiiiiiiiiiiiiiiiiiiiiiiiiiiiiiiiiiiiiiiiihffffffffffffffgattDEEEDtttDEEEEEEEEDDtDttt
aefffffffffffffffffffffffffffffffffffffffffhiiiiiiiiiiiiiiiiiiiiiiiiiiiiiiiiiiiiiiiiihffffffffffffffgattDEEDttttDEEEttEEEEEEEttt
aefffffffffffffffffffffffffffffffffffffffffhssxxAxxsssxxAxxsssxxAxxsssxxAxxsssxxAxxsshffffffffffffffgattDEEDtttDEEEtttDEEEEEEEtt
aeffffffffffffffffffffffffffffffffffffffffffsuuuuuuusuuuuuuusuuuuuuusuuuuuuusuuuuuuusfffffffffffffffgattDEEEDtDEEEDtttDEEEEEEEDt
aeffffffffffffffffffffffffffffffffffffffffffxuuuuuuuxuuuuuuuxuuuuuuuxuuuuuuuxuuuuuuuxfffffffffffffffgattDEEEEDEEEEDtttDEEEEEEEDt
aeffffffffffffffffffffffffffffffffffffffffffxuuuuuuuxuuuuuuuxuuuuuuuxuuuuuuuxuuuuuuuxfffffffffffffffgatttEEEEEEEEEDtttDEEEIEEEDt
aaaaaaaaaaaaaaaaaaaaaaffffffffffffffffffffffxuuuvuuuxuuuvuuuxuuuvuuuxuuuvuuuxuuuvuuuxfffffffffffffffgatttDEEEEEEEEDtttDEEEEEEEDt
aaaaaaaaaaaaaaaaaaaaaaffffffffffffffffffffffxuuuuuuuxuuuuuuuxuuuuuuuxuuuuuuuxuuuuuuuxfffffffffffffffgatttDEEEEEEEEDtttDEEEEEEEDt
aaaaaaaaaaaaaaaaaaaaaaffffffffffffffffffffffxuuuuuuuxuuuuuuuxuuuuuuuxuuuuuuuxuuuuuuuxfffffffffffffffgatttttEEEEEEEDttttEEEEEEEDt
aaaaaaaaaaaaaaaaaaaaaaffffffffffffffffffffffsuuuuuuusuuuuuuusuuuuuuusuuuuuuusuuuuuuusfffffffffffffffgatttttDEEEEEEEtttttEEEEEEtt
aaaaaaaaaaaaaaaaaaaaaaffffffffffffffffffffffsssxxxsssssxxxsssssxxxsssssxxxsssssxxxsssfffffffffffffffgatttttDEEEEEEEEtttttDDEEEtt
aaaaaaaaaaaaaaaaaaaaaaffffffffffffffffffffffffszzzsfffszzzsfffszzzsfffszzzsfffszzzsfffffffffffffffffgattttttEEEEEEEEDDtttttDDttt
aaaaaaaaaaaaaaaaaaaaaaffffffffffffffffffffffffsssssfffsssssfffsssssfffsssssfffsssssfffffffffffffffffgattttttEEEEEEEEEEEttttttttt
aaaaaaaaaaaaaaaaaaaaaaffffffffffffffffffffffffffffffffffffffffffffffffffffffffffffffffffffffffffffffgatttttDEEEEEEEEEEEDDttttttt
aaaaaaaaaaaaaaaaaaaaaaffffffffffffffffffffffffffffffffffffffffffffffffffffffffffffffffffffffffffffffgatttttDEEEEEEEEEEEEEEtttttt
aaaaaaaaaaaaaaaaaaaaaaffffffffffffffffffffffffffffffffffffffffffffffffffffffffffffffffffffffffffffffgatttttEEEEDDDDEEEEEEEEEtttt
aaaaaaaaaaaaaaaaaaaaaaffffffffffffffffffffffffffffffffffffffffffffffffffffffffffffffffffffffffffffffgatttttCCCCttttEEEEEEEEEDttt
aaaaaaaaaaaaaaaaaaaaaaffffffffffffffffffffffffffffffffffffffffffffffffffffffffffffffffffffffffffffffgattttFCCCCtttttDDEEEEEEEDDD
aaaaaaaaaaaaaaaaaaaaaaffffffffffffffffffffffffffffffffffffffffffffffffffffffffffffffffffffffffffffffgatttFCCCCCFFttttttDEEEEEEEE
aaaaaaaaaaaaaaaaaaaaaaffffffffffffffffffffffffffffffffffffffffffffffffffffffffffffffffffffffffffffffgattFCCCCCCCCCFtttttEEEEEEEE
aaaaaaaaaaaaaaaaaaaaaaffffffffffffffffffffffffffffffffffffffffffffffffffffffffffffffffffffffffffffffgattFCCCCCCCCCCFttttttDEEEEE
aaaaaaaaaaaaaaaaaaaaaaffffffffffffffffffffffffffffffffffffffffffffffffffffffffffffffffffffffffffffffgattFCCCCCCCCCCCCCtttttEEEEE
aaaaaaaaaaaaaaaaaaaaaaffffffffffffffffffffffffffffffffffffffffffffffffffffffffffffffffffffffffffffffgattFCCCCGCCCCCCCCFttttttDDD
aaaaaaaaaaaaaaaaaaaaaaffffffffffffffffffffffffffffffffffffffffffffffffffffffffffffffffffffffffffffffgattFCCCCCCCCCCCCCtttttttttt
aaaaaaaaaaaaaaaaaaaaaaffffffffffffffffffffffffffffffffffffffffffffffffffffffffffffffffffffffffffffffgatttCCCCCCCCCCCCttttttttttt
aaaaaaaaaaaaaaaaaaaaaaffffffffffffffffffffffffffffffffffffffffffffffffffffffffffffffffffffffffffffffgattttFFFCCCCFFFtttttttttttt
aaaaaaaaaaaaaaaaaaaaaappppppppppppppppppppppppppppppppppppppppppppppppppppppppppppppppppppppppppppppHatttttttFFCtttttttttttttttt
aaaaaaaaaaaaaaaaaaaaaaaaaaaaaaaaaaaaaaaaaaaaaaaaaaaaaaaaaaaaaaaaaaaaaaaaaaaaaaaaaaaaaaaaaaaaaaaaaaaaaatttttttttttttttttttttttttt
"}
