"a" = (/turf/simulated/wall/rock/basalt,/area/world/cult/exterior)
"b" = (/turf/simulated/floor/chasm/end,/area/world/cult/exterior)
"c" = (/turf/simulated/floor/basalt,/area/world/cult/exterior)
"d" = (/turf/simulated/wall/cult,/area/world/cult/interior)
"e" = (/turf/simulated/floor/chasm,/area/world/cult/exterior)
"f" = (/turf/simulated/floor/cult,/area/world/cult/interior)
"g" = (/turf/simulated/floor/cult,/area/world/cult/exterior)
"h" = (/turf/simulated/floor/basalt,/area/world/cult/interior)
"i" = (/turf/simulated/wall/cult,/area/world/cult/exterior)
"j" = (/obj/marker/mob_spawn/cult/cultist,/turf/simulated/floor/cult,/area/world/cult/interior)
"k" = (/obj/marker/mob_spawn/cult/behemoth,/turf/simulated/floor/cult,/area/world/cult/interior)
"l" = (/obj/marker/mob_spawn/cult/artificer,/turf/simulated/floor/cult,/area/world/cult/interior)
"m" = (/obj/marker/mob_spawn/cult/artificer,/turf/simulated/floor/basalt,/area/world/cult/interior)
"n" = (/obj/marker/mob_spawn/cult/cultist,/turf/simulated/floor/basalt,/area/world/cult/interior)
"o" = (/obj/marker/mob_spawn/cult/master,/turf/simulated/floor/cult,/area/world/cult/interior)
"p" = (/obj/marker/mob_spawn/cult/behemoth,/turf/simulated/floor/basalt,/area/world/cult/interior)
"q" = (/turf/simulated/wall/cult,/area/world/cult/interior/safe)
"r" = (/turf/simulated/floor/cult,/area/world/cult/interior/safe)
"s" = (/turf/simulated/floor/basalt,/area/world/cult/interior/safe)
"t" = (/turf/simulated/floor/chasm/end,/area/world/cult/exterior/safe)
"u" = (/turf/simulated/floor/basalt,/area/world/cult/exterior/safe)
"v" = (/turf/simulated/wall/rock/basalt,/area/world/cult/exterior/safe)
"w" = (/turf/simulated/floor/grass,/area/world/cult/exterior/safe)
"x" = (/obj/structure/interactive/wishgranter/normal/cult_hideout,/turf/simulated/floor/grass,/area/world/cult/exterior/safe)
"y" = (/turf/simulated/floor/grass,/area/world/cult/interior/safe)
"z" = (/obj/structure/smooth/table/wood/poor,/turf/simulated/floor/grass,/area/world/cult/interior/safe)
"A" = (/obj/structure/smooth/table/wood/poor,/turf/simulated/floor/cult,/area/world/cult/interior/safe)
"B" = (/obj/structure/smooth/table/wood/poor,/obj/structure/interactive/lighting/candle,/turf/simulated/floor/cult,/area/world/cult/interior/safe)
"C" = (/obj/structure/smooth/table/wood/poor,/obj/structure/interactive/lighting/candle,/turf/simulated/floor/grass,/area/world/cult/interior/safe)
"D" = (/obj/structure/interactive/lighting/cult_pylon,/turf/simulated/floor/cult,/area/world/cult/exterior)
"F" = (/obj/structure/interactive/lighting/cult_pylon,/turf/simulated/floor/basalt,/area/world/cult/exterior)
"G" = (/obj/structure/interactive/lighting/cult_pylon,/turf/simulated/floor/basalt,/area/world/cult/exterior/safe)

(1,1,1) = {"
aaaaaaaaaaeeeeeeeeeeeeeeeeeeeeeeeeeeeeeeeeeeeeeeeeeeeeeeeeeeeeeeeeeeeeaaaaaaaaaaaaaaaaaaaaaaaaaaaaaaaaaaaaaaaaaaaaaaaaaaaaaaaaaa
aaaaaaaaaaeeeeeeeeeeeeeeeeeeeeeeeeeeeeeeeeeeeeeeeeeeeeeeeeeeeeeeeeeeeebbbaaaaaaaaaaaaaaaaaaaaaaaaaaaaaaaaaaaaaaaaaaaaaaaaaaaaaaa
aaaaaaaaaeeeeeeeeeeeeeeeeeeeeeeeeeeeeeeeeeeeeeeeeeeeeeeeeeeeeeeeeeeeeebbbbbbbbbbbbbbbbbbbbaaaaaaaaaaaaaaaaaaaaaaaaaaaaaaaaaaaaaa
aaaaaaaaaabbbbbbbbbbbbbbbbbbbbbbbbbbbbbbbbbbbbbbbbbbbbbbbbbbbbbbbbbbbbbbbbbbbbbbbbbbbbbbbbbbbbbbbbaaaaaaaaaaaaaaaaaaaaaaaaaaaaaa
aaaaaaaaabbbbbbbbbbbbbbbbbbbbbbbbbbbbbbbbbbbbbbbbbbbbbbbbbbbbbbbbbbbbbbbbbbbbbbbbbbbbbbbbbbbbbbbbbbaaaaaaaaaaaaaaaaaaaaaaaaaaaaa
aaaaaaaaabbbbbbbbbbbbbbbbbbbbbbbbbbbbbbbbbbbbbbbbbbbbbbbbbbbbbbbbbbbbbbbbbbbbbbbbbbbbbbbbbbbbbbbbbbbaaaaaaaaaaaaaaaaaaaaaaaaaaaa
aaaaaaaabbbbbbbbbbbbbbbbbbbbbbbbbbbbbbbbbbbbbbbbbbbbbbbbbbbbbbbbbbbbbbbbbbbbbbbbbbbbbbbbbbbbbbbbbbbbbbbaaaaaaaaaaaaaaaaaaaaaaaaa
aaaaaaaabbbbbbbbbbbbbbbbbbbbbbbbbbbbbbbbbbbbbbbbbbbbbbbbbbbbbbbbbbbbbbbbbbbbbbbbbbbbbbbbbbbbbbbbbbbbbbbbaaaaaaaaaaaaaaaaaaaaaaaa
aaaaaaabbbbbbbbbbbbbbbbbbbbbbbbbbbbbbbbbbbbbbbbbbbbbbbbbbbbbbbbbbbbbbbbbbbbbbbbbbbbbbbbbbbbbbbbbbbbbbbbbbbaaaaaaaaaaaaaaaaaaaaaa
aaaaaaabbbbbbbbbbbbbbbbbbbbbbbbbbbbbbbbbbbbbbbbbbbbbbbbbbbbbbbbbbbbbbbbbbbbbbbbbbbbbbbbbbbbbbbbbbbbbbbbbbbbaaaaaaaaaaaaaaaaaaaaa
aaaaaabbbbbbbbbbbbbbbbbbbbcccccbbbbbbbbbbbbbbbbbbbbbbbbbbbbbbbbbbbbbbbbbbbbbbbbbbbbbbbbbbbbbbbbbbbbbbbbbbbbbaaaaaaaaaaaaaaaaaaaa
aaaaaabbbbbbbbbbbbbbbbbbccccccccbbbbbbbbbbbbbbbbbbbbbbbddddddddddddddeeeeeeeeeebbbbbbbbbbbbbbbbbbbbbbbbbbbbbbbaaaaaaaaaaaaaaaaaa
aaaaaaabbbbbbbbbbbbbbbbccccccccccbbbbbbbbbbbbbbbbbbbbbbdffffffffffffdeeggggggeebbbbbbbbbbbbbbbbbbbbbbbbbbbbbbbbaaaaaaaaaaaaaaaaa
aaaaaabbbbbbbbbbbbbbbccccccccccccbbbbbbbbbbbbbbbbbbbbbbdfofflfffffffdgggggggccebcccbbbbbbbbbbbbbbbbbbbbbbbbbbbbbaaaaaaaaaaaaaaaa
aaaaaaabbbbbbbbbbbbbbcccddffhfhfddbbbbbbbbbbbbbbbbbbbbbdfffffffffffffgggggggcceccccccbccbbbbbbbbbbbbbbbbbbbbbbbbbaaaaaaaaaaaaaaa
aaaaaabbbbbbbbbbbbbbbcccdffhhhhffdbbbbbbbbbbbbbbbbbbbbbdfffffffffffffggggccgcccccccccccbbbbbbbbbcccbbbbbbbbbbbbbbbaaaaaaaaaaaaaa
aaaaaabbbbbbbbbbbbbbbcccfhhhhhffffbbbbbbbbbbbbbbbbbbbbbdfkffffffffffdgggggcccccccccccbbbbbbbbbbcccccbbbbbbbbbbbbbbbaaaaaaaaaaaaa
aaaaaabbbbbbbbbbbbbbbbcchhffhfhfffbbbbbbbbbbbbbbbbbbbbbdffffffffffffdccgggggccccccccbbbbbbbbbbcccccccbbbbbbbbbbbbbbbaaaaaaaaaaaa
aaaaabbbbbbbbbbbbbbbbbcchffhhfhhffbbbbbbbbbbbbbbbbbbbbbdffffffffffffdcccggggccccccccbbbbbbbbbbccccccccbbbbbbbbbbbbbbaaaaaaaaaaaa
aaaaabbbbbbbbbbbbbbbbbccfffhfffhffbbbbbbbbbbbbbbbbbbbbbdffjfffffffffdcccggggccccccccbbbbbbbbcccccccccccbbbbbbbbbbbbbbaaaaaaaaaaa
aaaaabbbbbbbbbbbbbbbbbccfhhhfffhffbbbbbbbbbbbbbbbbbbbbbdffffffffffffdddddffddddcccbbbbbbbbbddffhhffddccbbbbbbbbbbbbbbbaaaaaaaaaa
aaaaabbbbbbbbbbbbbbbbbbcffhhffffffbbbbbbbbbbbbbbbbbbbbbdffffffffffffddffffffffdccccbbbbbbbbdfjfhhfffdccbbbbbbbbbbbbbbbbaaaaaaaaa
aaaabbbbbbbbbbbbbbbbbbbcdhhffffffdbbbbbbbbbbbbbbbbbbbbbdffffffffffjfddfjffffjfdccccccbbbbbbdfffhhffjfccbbbbbbbbbbbbbbbbbaaaaaaaa
aaaabbbbbbbbbbbbbbbbbbbcddddffddddbbbbbbbbbbbbbbbbbbbbbdffffffffffffddffffffffdiggggggggggidffffhffffcccbbbbbbbbbbbbbbbbaaaaaaaa
aaaabbbbbbbbbbbbbbbbbbbbbbbiggibbbbbbbbbbbbbbbbbbbbbbbbddddddffdddddddfffffffffggggggggggggfffffhhhhfcccbbbbbbbbbbbbbbbbbaaaaaaa
aaaabbbbbbbbbbbbbbbbbbbbbbbDggDbbbbbbbbbbbbbbbbbbbbbbbbbbbbbiggieeeeedfjfffffffggggggggggggffjffffhhhcccbbbbbbbbbbbbbbbbbbaaaaaa
aaaabbbbbbbbbbbbbbbbbbbbbbbggggbbbbbbbbbbbbbbbbbbbbbbbbbbbbbDggDeeeeedffffffffdiggggggggggidffffhhhhhcccbbbbbbbbbbbbbbbbbbaaaaaa
aaabbbbbbbbbbbbbbbbbbbbbbbcggggbbbbbbbbbbbbbbbbbbbbbbbbbbbbbggggeeeeedffffffffdccccccccccccdffffhhfffccccbbbbbbbbbbbbbbbbbbaaaaa
aaabbbbbbbbbbbbbbbbbbbbbbccggcgbbbbbbbbbbbbbbbbbbbbbbbbbbbbbggggeeeeedffffffffdccccbbbbbbccdffffffffdcccccbbbbbbbbbbbbbbbbbaaaaa
aaabbbbbbbbbbbbbbbbbbbbbbccgccgbbbbbbbbbbbbbbbbbbbbbbbbbbbbbggggeeeeeddddffddddccbbbbbbbbbcddddffddddcccccccbbbbbbbbbbbbbbbbaaaa
aaabbbbbbbbbbbbbbbbbbbbbcccgcggbbbbbbbbbbbbbbbbbbbbbbbbbbbbbggggeeeeebbbiggibbbbbbbbbbbbbbbbdffffffdcccccccccbbbbbbbbbbbbbbbbaaa
aaabbbbbbbbbbbbbbbbbbbbbcccccggbbbbbbbbbbbbbbbbbbbbbbbbbbbbbggggeeeeebbbDggDbbbbbbbbbbbbbbbbdfffffffcccccccccccbbbbbbbbbbbbbbaaa
aaabbbbbbbbbbbbbbbbbbbccccccgggbbbbbbbbbbbbbbbbbbbbbbbbbbbbbggggeeeeebbbggggbbbddddddddddddddfffffffcccccccccccccbbbbbbbbbbbbaaa
aaabbbbbbbbbbbbbbbbbbccccccggggbbbbbbbbbbbbbbbbbbbbbbbbbbbbbggggeeeeebbbggggbbbdffffffffffffdffffffdccccccccccccccbbbbbbbbbbbbaa
aaabbbbbbbbbbbbbbbbbcccccccDggDbbbbbbbbbbbbbbbbbbbbbbbbbbbbbggggeeeeebbbggggbbbdflflffffffffdffffffddddddddddddddddddddddddddddd
aaabbbbbbbbbbbbbbbbbccddddddffddddddbbbbbbbbddddddddddddddbbDggDeeeeebbbggggbbbdffffffffffffdffffffdffffffffffffffffdfffffffffff
aaaabbbbbbbbbbbbbbbbccdffffffffffffdbbbbbbbbdffffffffffffdbbiggieeeeebbbggggbbbdfjffffffffffdffffffdffffffffffffffffdfffffffffff
aaaabbbbbbbbbbbbbbbbccdffffffffffffdbbbbbbbbdfkffkfffffffddddffddddeeeeeDggDeeedffffffffffffdffffffdffjfffffffffffffdfffffffffff
aaaaabbbbbbbbbbbbbbbccdffffffffffffdbbbbbbbbdffffffffffffdffffffffdeeeeeiggieeedffffffffffffffffffffffffffffffffffffffffffffffff
aaaaabbbbbbbbbbbbbbcccdffffffffffffdbbbbbbbbdffffffffffffdffffffffdeeeeiiggiieedffffffffffffffffffffffffkfffffffffffffffffffffff
aaaaabbbbbbbbbbbbbbcccdffffffffffffdbbbbbbbbdfkffffffffffdffjfffffdigggggggggeedffffffffffffdffffffdffjfffffffffffffdfffffffffff
aaaaaabbbbbbbbbbbbbcccdffffffffffffdbbbbbbbcdffffffffffffffffffffffggggggggggeedffffffffffffdffffffdffffffffffffffffdfffffffffff
aaaaaabbbbbbbbbbbbbcccdffffffffffffdbbbbbbccdffffffffffffffffffjfffggggggggggeedffffffffffffdffffffdffffffffffffffffdfffffffffff
aaaaabbbbbbbbbbbbbbcccdffffffffffffdbbbbbbccdffffffffffffdfjffffffdigggggggggeedffffffffffffdffffffddddddddddddddddddddddddddddd
aaaaabbbbbbbbbbbbbbcccdffffffffffffdbbbbbbccdffffffffffffdffffffffdcccciiggiieedffffffffffffdffffffdcccccccccccccccccaaaaaaaaaaa
aaaaabbbbbbbbbbbbbbbccdffffffffffffdbbbbbcccdffffffffffffdffffffffdeeccciggieeeddddddddddddddfffffffcccccccccccceeeeeeaaaaaaaaaa
aaaabbbbbbbbbbbbbbbbbcdffffffffffffdbbbbbcccdffffffffffffddffffffddeeeccggggeeeeeeeeccccccccdfffffffccccccccceeeeeeeeeeeaaaaaaaa
aaaabbbbbbbbbbbbbbbbbcdffffffffffffdbbbbbcccdffffffffffffdeeccceeeeeeeeciggieeeeeeeeeeecccccdffffffdcccccceeeeeeeeeeeeeeeaaaaaaa
aaabbbbbbbbbbbbbbbbbbbddddddffddddddbcbbbbccddddddffddddddeeccceeeeeeddddffddddeeeeeeeeeeccddddffddddcccceeeeeeeeeeeeeeeeeeaaaaa
aaabbbbbbbbbbbbbbbbbbbbbdffffffffdbbccbbbbccccdffffffffdeeeeeccceeeeedffffffffdeeeeeeeeecccdffffffffdccceeeeeeeeeeeeeeeeeeeeaaaa
abbbbbbbbbbbbbbbbbbbbbbbfffffffffdbccbbbccccccdffffffffdeeeeeccceeeeedffffffffdeeeeeeeeecccdffffffffhcceeeeeeeeeeeeeeeeeeeeeeaaa
abbbbbbbbbbbbbbbbbbbbbbbfffhfhhffdiDggggggggDidffffffffdiiDggggggggDidffffffffdiDggggggggDidfffffffhhceeeeeeeeeeeeeeeeeeeeeeeeaa
abbbbbbbbbbbbbbbbbbbbbbbffhhhhffffggggggggggggffffffffffgggggggggggggfffjffffffggggggggggggffffffhhhheeeeeeeeeeeeeeeeeeeeeeeeeaa
abbbbbbbbbbbbbbbbbbbbbbchhhhhfffffggggggggggggffffjfffffgggggggggggggffffffffffggggccggggggffkfffffhheeeeeeeeeeeeeeeeeeeeeeeeeaa
abbbbbbbbbbbbbbbbbbbbbcchhhhhffffdiDggggggggDidffffffffdiiDggggggggDidffffffjfdiDccccccggDidfffffffhfeeeeeeeeeeeeeeeeeeeeeeeeeaa
abbbbbbbbbbbbbbbbbbbbbccffffhffffdccccccccccccdfjfffjffdcccccccccccccdffphhfffdcccccccccceedfjflfffffeeeeeeeeeeeeeeeeeeeeeeeeeea
abbbbbbbbbbbbbbbbbbbbcccdffffffffdbbbcccccccccdffffffffdcceeeeeeeeeeedfffhhfffdccccccccceeedffffffffdeeeeeeeeeeeeeeeeeeeeeeeeeaa
abbbbbbbbbbbbbbbbbbbbbccddddffddddbbbbbbbbccccddffffffddceeeeeeeeeeeeddfffhhfddcccccceeeeeeddddffddddeeeeeeeeeeeeeeeeeeeeeeeeeaa
abbbbbbbbbbbbbbbbbbbbbbcccciggibbbbbbbbbbbbbcccccccccccceeeeeeeeeeeeeeeeeeecccccccceeeeeeeeeeeiggiccceeeeeeeeeeeeeeeeeeeeeeeeaaa
abbbbbbbbbbbbbbbbbbbbbbbcccDggFbcbbbbbbbbbbbcccccccccceeeeeeeeeeeeeeeeeeeeeecccccceeeeeeeeeeeeDggDccceeeeeeeeeeeeeeeeeeeeeeeeaaa
abbbbbbbbbbbbbbbbbbbbbbbcccgcggccbbbbbbbbbbbbccccccceeeeeeeeeeeeeeeeeeeeeeeeeccceeeeeeeeeeeeeeggggcceeeeeeeeeeeeeeeeeeeeeeeeeaaa
abbbbbbbbbbbbbbbbbbbbbbbbccggggcccbbbbbbbbbbbbccccceeeeeeeeeeeeeeeeeeeeeeeeeeeeeeeeeeeeeeeeeeeggggcceeeeeeeeeeeeeeeeeeeeeeeeaaaa
abbbbbbbbbbbbbbbbbbbbbbbbccgggcccccbbbbbbbbbbbeccceeeeeeeeeeeeeeeeeeeeeeeeeeeeeeeeeeeeeeeeeeeeggggcceeeeeeeeeeeeeeeeeeeeeeeeaaaa
abbbbbbbbbbbbbbbbbbbbbbbbbcgggcccccbbbddddddddddddddddddddddddddddddeeeeeeeeeeeeeeeeeeeeeeeeeeggggceeeeeeeeeeeeeeeeeeeeeeeeeaaaa
abbbbbbbbbbbbbbbbbbbbbbbbbcggggccccbbbdffffffffffffffffffffffffffffdeeeeeeeeeeeeeeeeeeeeeeeeeeggggeeeeeeeeeeeeeeeeeeeeeeeeeeeaaa
abbbbbbbbbbbbbbbbbbbbbbbbbbgcggcccbbbbdfddddfddddfddddfddddffffffffdeeeeeeeeeeeeeeeeeeeeeeeeeeggggeeeeeeeeeeeeeeeeeeeeeeeeeeeaaa
abbbbbbbbbbbbbbbbbbbbbbbbbcggccccbbbbbdfdffdfdffdfdffffdfffffffffffdeeeeeeeeeeeeeeeeeeeeeeeeeeggggeeeeeeeeeeeeeeeeeeeeeeeeeeeaaa
abbbbbbbbbbbbbbbbbbbbbbbbbcggggccbbbbbdfddddfdffdfddddfddddffffffffdeeeeeeeeeeeeeeeeeeeeeeeeeeggggeeeeeeeeeeeeeeeeeeeeeeeeeeeaaa
abbbbbbbbbbbbbbbbbbbbbbccccFggDcbbbbbbdfdffdfdffdffffdffffdffffffffdeeeeeeeeeeeeeeeeeeeeeeeeeeDggDeeeeeeeeeeeeeeeeeeeeeeeeeeeaaa
abbbbbbbbbbbbbbbbbbbbbbcccciggicbbbbbbdfddddfddddfddddfddddffffffffdeeeeeeeeeeeeeeeeeeeeeeeeeeiggieeeeeeeeeeeeeeeeeeeeeeeeeeeaaa
abbbbbbbbbbbbbbbbbbbbbccddddffddddbbbbdffffffffffffffffffffffffffffdeeeeeeeeeeeeeeeeeeeeeccddddffddddeeeeeeeeeeeeeeeeeeeeeeeeaaa
abbbbbbbbbbbbbbbbbbbbbccdffffffffdbbbbdffffffffffffffffffffffffffffdeeeeeeeeeeeeeeeeeeeecccdffffffffdeeeeeeeeeeeeeeeeeeeeeeeeaaa
abbbbbbbbbbbbbbbbbbbbbcchffhhfffffbbbbdffffffffffffffffffffffffffffdeeeeeeeeeeeeeeeeeeeeccchfffffffffeeeeeeeeeeeeeeeeeeeeeeeeaaa
abbbbbbbbbbbbbbbbbbbbbcchfhhffffffbbbbdffffffffffffffffffffffffffffdeeeeeeeeeeeeeeeeeeeeccchfffffffffeeeeeeeeeeeeeeeeeeeeeeeeaaa
abbbbbbbbbbbbbbbbbbbbbcchhhfffffffbbbbdffffffffffffffffffffffffffffdeeeeeeeeeeeeeeeeeeeeccchhfkffffffeeeeeeeeeeeeeeeeeeeeeeaaaaa
abbbbbbbbbbbbbbbbbbbbbbchhhhhfffffbbbbdffffffffffffffffffffffffffffdeeeeeeeeeeeeeeeeeeeeccchhhfffffffeeeeeeeeeeeeeeeeeeeeeeeaaaa
abbbbbbbbbbbbbbbbbbbbbbbhhffhhffffbbbbdffffffffffffffffffffffffffffdeeeeeeeeeeeeeeeeeeeeecchhhhffffffeeeeeeeeeeeeeeeeeeeeeeaaaaa
abbbbbbbbbbbbbbbbbbbbbbbfhhffhffffbbbbdffffffffffffffffffffffffffffdeeeeeeeeeeeeeeeeeeeeecchhmffffjffeeeeeeeeeeeeeeeeeeeeeeaaaaa
abbbbbbbbbbbbbbbbbbbbbbbdffffffffdbbbbdffffffffffffffffffffffffffffdeeeeeeeeeeeeeeeeeeeeeecdhhffffffdeeeeeeeeeeeeeeeeeeeeeeaaaaa
abbbbbbbbbbbbbbbbbbbbbbbddddffddddbbbbdffffffffffffffffffffffffffffdeeeeeeeeeeeeeeeeeeeeeeeddddffddddeeeeeeeeeeeeeeeeeeeeeeeaaaa
abbbbbbbbbbbbbbbbbbbbbbbbeeiggieebbbbbdffffffffffffffffffffffffffffdbbeeeebbbbbbbbbbbbbbbbbbbbiggibbbbbbbbbbbbbbbbbbbbbbbbbbaaaa
abbbbbbbbbbbbbbbbbbbbbbbbeecgggeebbbbbdffffffffffffffffffffffffffffdbbeeeebbbbbbbbbbbbbbbbbbbbggggbbbbbbbbbbbbbbbbbbbbbbbbbbbaaa
abbbbbbbbbbbbbbbbbbbbbbbbeeggggeebbbbbdffffffffffffffffffffffffffffdbbeeeebbbbbbbbbbbbbbbbbbbbggggbbbbbbbbbbbbbbbbbbbbbbbbbbbaaa
abbbbbbbbbbbbbbbbbbbbbbbbeeggggeebbbbbdffffffffffffffffffffffffffffdbbeeeebbbbbbbbbbbbbbbbbbbbggggbbbbbbbbbbbbbbbbbbbbbbbbbbbaaa
abbbbbbbbbbbbbbbbbbbbbbbbeeggggeebbbbbdffffffffffffffffffffffffffffdbbeeeebbbbbbbbbbbbbbbbbbbbggggbbbbbbbbbbbbbbbbbbbbbbbbbbbaaa
abbbbbbbbbbbbbbbbbbbbbbbbccgccgeebbbbbdffffffffffffffffffffffffffffdbbeeeebbbbbbbbbbbbbbbbbbbbggggbbbbbbbbbbbbbbbbbbbbbbbbbbaaaa
abbbbbbbbbbbbbbbbbbbbbbbcccgcggeebbbbbdffffffffffffffffffffffffffffdbbeeeebbbbbbbbbbbbbbbbbbbbggggbbbbbbbbbbbbbbbbbbbbbbbbbbaaaa
abbbbbbbbbbbbbbbbbbbbbcccccgcggeebbbbbdffffffffffffffffffffffffffffdbbeeeebbbbbbbbbbbbbbbbbbbbggggbbbbbbbbbbbbbbbbbbbbbbbbbaaaaa
abbbbbbbbbbbbbbbbbbbcccccccccggeebbbbbdffffffffffffffffffffffffffffdbbeeeebbbbbbbbbbbbbbbbbbbbggggbbbbbbbbbbbbbbbbbbbbbbbbbaaaaa
abbbbbbbbbbbbbbbbbbcccccccccgggeebbbbbdffffffffffffffffffffffffffffdbbeeeebbbbbbbbbbbbbbbbbbbbggggbbbbbbbbbbbbbbbbbbbbbbbbaaaaaa
abbbbbbbbbbqqqqqqqqqqqqqqcccgggeebbbbbddddddddqqqqqqrrqqqqqqddddddddbbeeeebbbbbbbbbbbbbbbbbbbbggggbbbbbbbbbbbbbbbbbbbbbbbaaaaaaa
abbbbbbbbbbqrrrryyrrrrrrqcciggieebbbbbbbbbbbbbqrrrrrrrrrrrrqbbbbbbbbbbeeeebbbbbbbbbbbbbbbbbbbbiggibbbbbbbbbbbbbbbbbbbbbbbaaaaaaa
abqqqqqqqqqqrrrCzwwrryrrqqqqrrqqqqbbbbbbbbbbbbqrrrrrrrrrrrrqbbbbbbbbbbbbbbbbbbbbbbbbbbbbbbbbbbiggibbbbbbbbbbbbbbbbbbbbbbaaaaaaaa
abqrrrrrrrrqrryywwwwwwrrqrrrrrrrrqbbbbbbbbbbbbqrrrrrrrrrrrrqbbbbbbbbbbbbbbbbbbbbbbbbbbbbbbbddddffddddbbbbbbbbbbbbbbbbbbbbaaaaaaa
abqrrrrrrrrqrrywwwwwwwrrqrrrrrrrrqbbbbbbbbbbbbqrrrrrrrrrrrrqbbbbbbbbbbbbbbbbbbbbbbbbbbbbbbcdffffffffdbbbbbbbbbbbbbbbbbbbbbaaaaaa
abqrrrrrrrrqrwwwwxwwwrrrqrrrrrrrrqqrrrrrrrrrrqqrrrrrrrrrrrrqbbbbbbbbbbbbbbbbbbbbbbbbbbbbbccffffffffffcbbbbbbbbbbbbbbbbbbbbaaaaaa
abqrrrrrrrrrrwwwwwwwwwrrrrrrrrrrrrrrrrrrrrrrrrrrrrrrrrrrrrrqbbbbbbbbbbbbbbbbbbbbbbbbbbbbcccffffffffffcbbbbbbbbbbbbbbbbbbbbbaaaaa
abqrrssrrrrrrrrwwwwwwwrrrrrrrrrrrrrrrrrrrrrrrrrrrrrrrrrrrrrqbbbbbbbbbbbbbbbbbbbbbbbbbbbbcccfjfffhhfffccbbbbbbbbbbbbbbbbbbbbaaaaa
abqrrrsrrrrqrrrrwwwwwrrrqrrrrrrrrqqrrrrrrrrrrqqrrrrrrrrrrrrqbbbbbbbbbbbbbbbbbbbbbbbbbbbbcccffffffhhhhccbbbbbbbbbbbbbbbbbbbbaaaaa
abqrrrssrrrqrrwwwwwwwrrrqrrrrrrrrqbbbbbbbbbbbbqrrrrrrrrrrrrqbbbbbbbbbbbbbbbbbbbbbbbbbbbbbccffffhhffhhccbbbbbbbbbbbbbbbbbbbaaaaaa
abqrrrrssrrqrrwwrrrrwwrBqrrrrrrrrqbbbbbbbbbbbbqrrrrrrrrrrrrqbbbbbbbbbbbbbbbbbbbbbbbbbbbbbbcfflffhffffcccbbbbbbbbbbbbbbbbbaaaaaaa
abqqqqqsssqqrrwrrrrrrrrAqqqqqqqqqqbbbbbbbbbbbbqrrrrrrrrrrrrqbbbbbbbbbbbbbbbbbbbbbbbbbbbbbbcdffffhnffdcccbbbbbbbbbbbbbbbbbaaaaaaa
abttuuuuuuuqrrrrrrrAAAAAquuuuuttttbbbbbbbbbbbbqrrrrrrrrrrrrqbbbbbbbbbbbbbbbbbbbbbbbbbbbbbbbddffffhfddcccccbbbbbbbbbbbbbbbaaaaaaa
abtGuuuuuuuqqqqqqrrqqqqqquuuutttttbbbbbbbbbbbbqqqqqqqqqqqqqqbbbbbbbbbbbbbbbbbbbbbbbbbbbbbbbbbbbbbcccccccccbbbbbbbbbbbbbbbbaaaaaa
abttttuuuuuuuqrrrrrrrrquuuuuttttttbbbbbbbbbbbbbbbbbbbbbbbbbbbbbbbbbbbbbbbbbbbbbbbbbbbbbbbbbbbbbbbbcccccccbbbbbbbbbbbbbbbbaaaaaaa
abttttttuuuuurrrrrrrrrruuuutttttttbbbbbbbbbbbbbbbbbbbbbbbbbbbbbbbbbbbbbbbbbbbbbbbbbbbbbbbbbbbbbbbbbbbcccbbbbbbbbbbbbbbbbbaaaaaaa
abttttttttuuussssssrrrsuuuttttttttbbbbbbbbbbbbbbbbbbbbbbbbbbbbbbbbbbbbbbbbbbbbbbbbbbbbbbbbbbbbbbbbbbbbbbbbbbbbbbbbbbbbbbbbaaaaaa
abttttttttuuusssrrrrrssuutttttttttbbbbbbbbbbbbbbbbbbbbbbbbbbbbbbbbbbbbbbbbbbbbbbbbbbbbbbbbbbbbbbbbbbbbbbbbbbbbbbbbbbbbbbbbaaaaaa
abtttttttttuussssrrrsssuutttttttttbbbbbbbbbbbbbbbbbbbbbbbbbbbbbbbbbbbbbbbbbbbbbbbbbbbbbbbbbbbbbbbbbbbbbbbbbbbbbbbbbbbbbbbbaaaaaa
abtttttttttuurssssrrrssuttttttttttbbbbbbbbbbbbbbbbbbbbbbbbbbbbbbbbbbbbbbbbbbbbbbbbbbbbbbbbbbbbbbbbbbbbbbbbbbbbbbbbbbbbbbbbaaaaaa
abtttttttttturrrssrrrsrtttttttttttbbbbbbbbbbbbbbbbbbbbbbbbbbbbbbbbbbbbbbbbbbbbbbbbbbbbbbbbbbbbbbbbbbbbbbbbbbbbbbbbbbbbbbbbaaaaaa
abtttttttttttqrrrrssrrqtttttttttttbbbbbbbbbbbbbbbbbbbbbbbbbbbbbbbbbbbbbbbbbbbbbbbbbbbbbbbbbbbbbbbbbbbbbbbbbbbbbbbbbbbbbbbaaaaaaa
abtttttttttttqqrrrsrrqqtttttttttttbbbbbbbbbbbbbbbbbbbbbbbbbbbbbbbbbbbbbbbbbbbbbbbbbbbbbbbbbbbbbbbbbbbbbbbbbbbbbbbbbbbbbbbaaaaaaa
abttttttttttttuuuuuuuuutttttttttttbbbbbbbbbbbbbbbbbbbbbbbbbbbbbbbbbbbbbbbbbbbbbbbbbbbbbbbbbbbbbbbbbbbbbbbbbbbbbbbbbbbbbbbaaaaaaa
aatttttttttttttttuuuuuttttttttttttbbbbbbbbbbbbbbbbbbbbbbbbbbbbbbbbbbbbbbbbbbbbbbbbbbbbbbbbbbbbbbbbbbbbbbbbbbbbbbbbbbbbbbaaaaaaaa
aattttttttttttttttuuuuuuttttttttttbbbbbbbbbbbbbbbbbbbbbbbbbbbbbbbbbbbbbbbbbbbbbbbbbbbbbbbbbbbbbbbbbbbbbbbbbbbbbbbbbbbbbbaaaaaaaa
aavtttttttttttttttttuuuuuuttttttttbbbbbbbbbbbbbbbbbbbbbbbbbbbbbbbbbbbbbbbbbbbbbbbbbbbbbbbbbbbbbbbbbbbbbbbbbbbbbbbbbbbbbaaaaaaaaa
aavtttttttttttttttttuuuuuuGtttttttbbbbbbbbbbbbbbbbbbbbbbbbbbbbbbbbbbbbbbbbbbbbbbbbbbbbbbbbbbbbbbbbbbbbbbbbbbbbbbbbbbbbaaaaaaaaaa
aavvttttttttttttttttuuuuuuutttttttbbbbbbbbbbbbbbbbbbbbbbbbbbbbbbbbaabbbbbbbbbbbbbbbbbbbbbbbabbbbbbbbbbbbbbbbbbbbbbbbbaaaaaaaaaaa
aavvvttttttttttttttttuuuuuutttttttbbbbbbbbbbbbbbbbbbbbbbbbbbbbbbbbabbbbbbbbbbbbbbbbbbbbbbbaabbabbbbbbbbbbbbbbbbbbbbbaaaaaaaaaaaa
aavvvvttttttttttttttttGuttttttttttbbbbbbbbbbbbbbabbbbbbbbbbbbbbbaaaabbbbbbbbbbbbbbbbbbbbbaaaaaabbbbbbbbbbbbbbbbbbaabaaaaaaaaaaaa
aaaaaabbbbbbbbbbbbbbbbbbbbbbbbbbbbbbbbbbbbbbbbaaabbbbbbbbbbbbbbaaaaaaabbbbbbbbbbbbbbbbbbaaaaaaabbbbbbbbbbbbbbbbbbaaaaaaaaaaaaaaa
aaaaaaabbbbbbbbbbbbbbbbbbbbbbbbbbbbbbbbbbbbaaaaaaabbbbbbbbbbbaaaaaaaaaaabbbbbbbbbbbbbbaaaaaaaaaaaabbbbbbbbbbbbbaaaaaaaaaaaaaaaaa
aaaaaaaabbbbbbbbbbbbbbbbbbbbbbbbbbbbbbbbbaaaaaaaaaabbbbbbbbbaaaaaaaaaaaaaabbbbbbbbbbaaaaaaaaaaaaaaaaabbbbbbbaaaaaaaaaaaaaaaaaaaa
aaaaaaaaabbbbbbbbbbbbbbbbaaabbbbbbbbbbaaaaaaaaaaaaaaaaabbbaaaaaaaaaaaaaaaaaabbbbbbaaaaaaaaaaaaaaaaaaaabbbbaaaaaaaaaaaaaaaaaaaaaa
aaaaaaaaaaabbbbbbbbaaaaaaaaabbbbbbbbaaaaaaaaaaaaaaaaaaaaaaaaaaaaaaaaaaaaaaaaaaabaaaaaaaaaaaaaaaaaaaaaaaaaaaaaaaaaaaaaaaaaaaaaaaa
aaaaaaaaaaaaaaaaaaaaaaaaaaaaaaaaaaaaaaaaaaaaaaaaaaaaaaaaaaaaaaaaaaaaaaaaaaaaaaaaaaaaaaaaaaaaaaaaaaaaaaaaaaaaaaaaaaaaaaaaaaaaaaaa
aaaaaaaaaaaaaaaaaaaaaaaaaaaaaaaaaaaaaaaaaaaaaaaaaaaaaaaaaaaaaaaaaaaaaaaaaaaaaaaaaaaaaaaaaaaaaaaaaaaaaaaaaaaaaaaaaaaaaaaaaaaaaaaa
"}
