"a" = (/turf/simulated/wall/rock/basalt,/area/world/cult/exterior)
"b" = (/turf/simulated/floor/chasm/end,/area/world/cult/exterior)
"c" = (/turf/simulated/floor/basalt,/area/world/cult/exterior)
"d" = (/turf/simulated/wall/cult,/area/world/cult/interior)
"e" = (/turf/simulated/floor/chasm,/area/world/cult/exterior)
"f" = (/mob/living/simple/npc/cult/cultist,/turf/simulated/floor/cult,/area/world/cult/interior)
"g" = (/turf/simulated/floor/cult,/area/world/cult/exterior)
"h" = (/mob/living/simple/npc/cult/cultist,/turf/simulated/floor/basalt,/area/world/cult/interior)
"i" = (/turf/simulated/wall/cult,/area/world/cult/exterior)
"j" = (/mob/living/simple/npc/cult/behemoth,/turf/simulated/floor/cult,/area/world/cult/interior)
"k" = (/mob/living/simple/npc/cult/artificer,/turf/simulated/floor/cult,/area/world/cult/interior)
"l" = (/mob/living/simple/npc/cult/artificer,/turf/simulated/floor/basalt,/area/world/cult/interior)
"m" = (/obj/structure/interactive/lighting/cult_pylon,/turf/simulated/floor/cult,/area/world/cult/interior)
"n" = (/turf/simulated/floor/cult/darker,/area/world/cult/interior/safe)
"o" = (/turf/simulated/floor/cult,/area/world/cult/interior)
"p" = (/turf/simulated/floor/basalt,/area/world/cult/interior)
"q" = (/turf/simulated/wall/cult,/area/world/cult/interior/safe)
"r" = (/turf/simulated/floor/cult,/area/world/cult/interior/safe)
"s" = (/turf/simulated/floor/basalt,/area/world/cult/interior/safe)
"t" = (/turf/simulated/floor/chasm/end,/area/world/cult/exterior/safe)
"u" = (/turf/simulated/floor/basalt,/area/world/cult/exterior/safe)
"v" = (/turf/simulated/wall/rock/basalt,/area/world/cult/exterior/safe)
"w" = (/turf/simulated/floor/colored/grass,/area/world/cult/exterior/safe)
"x" = (/obj/structure/interactive/wishgranter/normal/cult_hideout,/turf/simulated/floor/colored/grass,/area/world/cult/exterior/safe)
"y" = (/turf/simulated/floor/colored/grass,/area/world/cult/interior/safe)
"z" = (/obj/structure/smooth/table/wood/poor,/turf/simulated/floor/colored/grass,/area/world/cult/interior/safe)
"A" = (/obj/structure/smooth/table/wood/poor,/turf/simulated/floor/cult,/area/world/cult/interior/safe)
"B" = (/obj/structure/smooth/table/wood/poor,/obj/structure/interactive/lighting/candle,/turf/simulated/floor/cult,/area/world/cult/interior/safe)
"C" = (/obj/structure/smooth/table/wood/poor,/obj/structure/interactive/lighting/candle,/turf/simulated/floor/colored/grass,/area/world/cult/interior/safe)
"D" = (/obj/structure/interactive/lighting/cult_pylon,/turf/simulated/floor/cult,/area/world/cult/exterior)
"E" = (/turf/simulated/floor/cult/darker,/area/world/cult/interior)
"F" = (/obj/structure/interactive/lighting/cult_pylon,/turf/simulated/floor/basalt,/area/world/cult/exterior)
"G" = (/obj/structure/interactive/lighting/cult_pylon,/turf/simulated/floor/basalt,/area/world/cult/exterior/safe)
"H" = (/turf/simulated/floor/stair/cult{icon_state = "stair"; dir = 1},/area/world/cult/interior)
"I" = (/turf/simulated/floor/stair/cult{icon_state = "stair"; dir = 4},/area/world/cult/interior)
"J" = (/turf/simulated/floor/stair/cult{icon_state = "stair"; dir = 8},/area/world/cult/interior)
"K" = (/turf/simulated/floor/stair/cult,/area/world/cult/interior)
"L" = (/obj/structure/interactive/lighting/cult_pylon,/turf/simulated/floor/cult/darker,/area/world/cult/interior/safe)
"M" = (/turf/simulated/floor/stair/cult{icon_state = "stair"; dir = 8},/area/world/cult/interior/safe)

(1,1,1) = {"
aaaaaaaaaaeeeeeeeeeeeeeeeeeeeeeeeeeeeeeeeeeeeeeeeeeeeeeeeeeeeeeeeeeeeeaaaaaaaaaaaaaaaaaaaaaaaaaaaaaaaaaaaaaaaaaaaaaaaaaaaaaaaaaa
aaaaaaaaaaeeeeeeeeeeeeeeeeeeeeeeeeeeeeeeeeeeeeeeeeeeeeeeeeeeeeeeeeeeeebbbaaaaaaaaaaaaaaaaaaaaaaaaaaaaaaaaaaaaaaaaaaaaaaaaaaaaaaa
aaaaaaaaaeeeeeeeeeeeeeeeeeeeeeeeeeeeeeeeeeeeeeeeeeeeeeeeeeeeeeeeeeeeeebbbbbbbbbbbbbbbbbbbbaaaaaaaaaaaaaaaaaaaaaaaaaaaaaaaaaaaaaa
aaaaaaaaaabbbbbbbbbbbbbbbbbbbbbbbbbbbbbbbbbbbbbbbbbbbbbbbbbbbbbbbbbbbbbbbbbbbbbbbbbbbbbbbbbbbbbbbbaaaaaaaaaaaaaaaaaaaaaaaaaaaaaa
aaaaaaaaabbbbbbbbbbbbbbbbbbbbbbbbbbbbbbbbbbbbbbbbbbbbbbbbbbbbbbbbbbbbbbbbbbbbbbbbbbbbbbbbbbbbbbbbbbaaaaaaaaaaaaaaaaaaaaaaaaaaaaa
aaaaaaaaabbbbbbbbbbbbbbbbbbbbbbbbbbbbbbbbbbbbbbbbbbbbbbbbbbbbbbbbbbbbbbbbbbbbbbbbbbbbbbbbbbbbbbbbbbbaaaaaaaaaaaaaaaaaaaaaaaaaaaa
aaaaaaaabbbbbbbbbbbbbbbbbbbbbbbbbbbbbbbbbbbbbbbbbbbbbbbbbbbbbbbbbbbbbbbbbbbbbbbbbbbbbbbbbbbbbbbbbbbbbbbaaaaaaaaaaaaaaaaaaaaaaaaa
aaaaaaaabbbbbbbbbbbbbbbbbbbbbbbbbbbbbbbbbbbbbbbbbbbbbbbbbbbbbbbbbbbbbbbbbbbbbbbbbbbbbbbbbbbbbbbbbbbbbbbbaaaaaaaaaaaaaaaaaaaaaaaa
aaaaaaabbbbbbbbbbbbbbbbbbbbbbbbbbbbbbbbbbbbbbbbbbbbbbbbbbbbbbbbbbbbbbbbbbbbbbbbbbbbbbbbbbbbbbbbbbbbbbbbbbbaaaaaaaaaaaaaaaaaaaaaa
aaaaaaabbbbbbbbbbbbbbbbbbbbbbbbbbbbbbbbbbbbbbbbbbbbbbbbbbbbbbbbbbbbbbbbbbbbbbbbbbbbbbbbbbbbbbbbbbbbbbbbbbbbaaaaaaaaaaaaaaaaaaaaa
aaaaaabbbbbbbbbbbbbbbbbbbbcccccbbbbbbbbbbbbbbbbbbbbbbbbbbbbbbbbbbbbbbbbbbbbbbbbbbbbbbbbbbbbbbbbbbbbbbbbbbbbbaaaaaaaaaaaaaaaaaaaa
aaaaaabbbbbbbbbbbbbbbbbbccccccccbbbbbbbbbbbbbbbbbbbbbbbddddddddddddddeeeeeeeeeebbbbbbbbbbbbbbbbbbbbbbbbbbbbbbbaaaaaaaaaaaaaaaaaa
aaaaaaabbbbbbbbbbbbbbbbccccccccccbbbbbbbbbbbbbbbbbbbbbbdmoooooooooomdeeggggggeebbbbbbbbbbbbbbbbbbbbbbbbbbbbbbbbaaaaaaaaaaaaaaaaa
aaaaaabbbbbbbbbbbbbbbccccccccccccbbbbbbbbbbbbbbbbbbbbbbdoooooooooooodgggggggccebcccbbbbbbbbbbbbbbbbbbbbbbbbbbbbbaaaaaaaaaaaaaaaa
aaaaaaabbbbbbbbbbbbbbcccddoopopoddbbbbbbbbbbbbbbbbbbbbbdooooooooooooogggggggcceccccccbccbbbbbbbbbbbbbbbbbbbbbbbbbaaaaaaaaaaaaaaa
aaaaaabbbbbbbbbbbbbbbcccdmoppppomdbbbbbbbbbbbbbbbbbbbbbdoooooooooooooggggccgcccccccccccbbbbbbbbbcccbbbbbbbbbbbbbbbaaaaaaaaaaaaaa
aaaaaabbbbbbbbbbbbbbbcccopppppoooobbbbbbbbbbbbbbbbbbbbbdoooooooooooodgggggcccccccccccbbbbbbbbbbcccccbbbbbbbbbbbbbbbaaaaaaaaaaaaa
aaaaaabbbbbbbbbbbbbbbbccppoopopooobbbbbbbbbbbbbbbbbbbbbdoooooooooooodccgggggccccccccbbbbbbbbbbcccccccbbbbbbbbbbbbbbbaaaaaaaaaaaa
aaaaabbbbbbbbbbbbbbbbbccpooppoppoobbbbbbbbbbbbbbbbbbbbbdoooooooooooodcccggggccccccccbbbbbbbbbbccccccccbbbbbbbbbbbbbbaaaaaaaaaaaa
aaaaabbbbbbbbbbbbbbbbbccooopooopoobbbbbbbbbbbbbbbbbbbbbdoooooooooooodcccggggccccccccbbbbbbbbcccccccccccbbbbbbbbbbbbbbaaaaaaaaaaa
aaaaabbbbbbbbbbbbbbbbbccopppooopoobbbbbbbbbbbbbbbbbbbbbdoooooooooooodddddooddddcccbbbbbbbbbddooppooddccbbbbbbbbbbbbbbbaaaaaaaaaa
aaaaabbbbbbbbbbbbbbbbbbcooppoooooobbbbbbbbbbbbbbbbbbbbbdooooooooooooddmoooooomdccccbbbbbbbbdmooppoomdccbbbbbbbbbbbbbbbbaaaaaaaaa
aaaabbbbbbbbbbbbbbbbbbbcdppooooomdbbbbbbbbbbbbbbbbbbbbbdooooooooooooddoooooooodccccccbbbbbbdoooppooooccbbbbbbbbbbbbbbbbbaaaaaaaa
aaaabbbbbbbbbbbbbbbbbbbcddddooddddbbbbbbbbbbbbbbbbbbbbbdmoooooooooomddoofooooodiDggggggggDidofoopoooocccbbbbbbbbbbbbbbbbaaaaaaaa
aaaabbbbbbbbbbbbbbbbbbbbbbbiggibbbbbbbbbbbbbbbbbbbbbbbbddddddoodddddddoooooooooggggggggggggoooooppppocccbbbbbbbbbbbbbbbbbaaaaaaa
aaaabbbbbbbbbbbbbbbbbbbbbbbDggDbbbbbbbbbbbbbbbbbbbbbbbbbbbbbiggieeeeedoooooooooggggggggggggoooooofpppcccbbbbbbbbbbbbbbbbbbaaaaaa
aaaabbbbbbbbbbbbbbbbbbbbbbbggggbbbbbbbbbbbbbbbbbbbbbbbbbbbbbDggDeeeeedoooofooodiDggggggggDidoooopppppcccbbbbbbbbbbbbbbbbbbaaaaaa
aaabbbbbbbbbbbbbbbbbbbbbbbcggggbbbbbbbbbbbbbbbbbbbbbbbbbbbbbggggeeeeedoooooooodccccccccccccdooooppoooccccbbbbbbbbbbbbbbbbbbaaaaa
aaabbbbbbbbbbbbbbbbbbbbbbccggcgbbbbbbbbbbbbbbbbbbbbbbbbbbbbbggggeeeeedmoooooomdccccbbbbbbccdmoooooomdcccccbbbbbbbbbbbbbbbbbaaaaa
aaabbbbbbbbbbbbbbbbbbbbbbccgccgbbbbbbbbbbbbbbbbbbbbbbbbbbbbbggggeeeeeddddooddddccbbbbbbbbbcddddooddddcccccccbbbbbbbbbbbbbbbbaaaa
aaabbbbbbbbbbbbbbbbbbbbbcccgcggbbbbbbbbbbbbbbbbbbbbbbbbbbbbbggggeeeeebbbiggibbbbbbbbbbbbbbbbdoooooodcccccccccbbbbbbbbbbbbbbbbaaa
aaabbbbbbbbbbbbbbbbbbbbbcccccggbbbbbbbbbbbbbbbbbbbbbbbbbbbbbggggeeeeebbbDggDbbbbbbbbbbbbbbbbdooooooocccccccccccbbbbbbbbbbbbbbaaa
aaabbbbbbbbbbbbbbbbbbbccccccgggbbbbbbbbbbbbbbbbbbbbbbbbbbbbbggggeeeeebbbggggbbbddddddddddddddooooooocccccccccccccbbbbbbbbbbbbaaa
aaabbbbbbbbbbbbbbbbbbccccccggggbbbbbbbbbbbbbbbbbbbbbbbbbbbbbggggeeeeebbbggggbbbdmoooooooooomdoooooodccccccccccccccbbbbbbbbbbbbaa
aaabbbbbbbbbbbbbbbbbcccccccDggDbbbbbbbbbbbbbbbbbbbbbbbbbbbbbggggeeeeebbbggggbbbdoooooooooooodooooooddddddddddddddddddddddddddddd
aaabbbbbbbbbbbbbbbbbccddddddooddddddbbbbbbbbddddddddddddddbbDggDeeeeebbbggggbbbdoooooooooooodoooooodmooooooooooooooooooooooooooo
aaaabbbbbbbbbbbbbbbbccdmoooooooooomdbbbbbbbbdmoooooooooomdbbiggieeeeebbbggggbbbdoooooooooooodoooooodofoooooooooooooooooooooooooo
aaaabbbbbbbbbbbbbbbbccdoooooooooooodbbbbbbbbdooooooooooooddddooddddeeeeeDggDeeedoooooooooooodoooooodoooooooooooooooooooooooooooo
aaaaabbbbbbbbbbbbbbbccdoooooooooooodbbbbbbbbdoooooooooooodmoooooomdeeeeeiggieeedoooooooooooooooooooooooofooooooooooooooooooooooo
aaaaabbbbbbbbbbbbbbcccdoooooooooooodbbbbbbbbdoooooooooooodoooooooodeeeeiiggiieedoooooooooooooooooooooooooooooooooooooooooooooooo
aaaaabbbbbbbbbbbbbbcccdoooooooooooodbbbbbbbbdoooooooooooodooofoooodiggggggggieedoooooooooooodoooooodoooooooooooooooooooooooooooo
aaaaaabbbbbbbbbbbbbcccdoooooooooooodbbbbbbbcdoooooooooooooooooooooogggggggggieedoooooooooooodoooooodofoooooooooooooooooooooooooo
aaaaaabbbbbbbbbbbbbcccdoooooooooooodbbbbbbccdoooooooooooooofooooooogggggggggieedoooooooooooodoooooodmooooooooooooooooooooooooooo
aaaaabbbbbbbbbbbbbbcccdoooooooooooodbbbbbbccdoooooooooooodoooooooodiggggggggieedoooooooooooodooooooddddddddddddddddddddddddddddd
aaaaabbbbbbbbbbbbbbcccdoooooooooooodbbbbbbccdoooooooooooodoooooooodcccciiggiieedmoooooooooomdoooooodcccccccccccccccccaaaaaaaaaaa
aaaaabbbbbbbbbbbbbbbccdoooooooooooodbbbbbcccdoooooooooooodmoooooomdeeccciggieeeddddddddddddddooooooocccccccccccceeeeeeaaaaaaaaaa
aaaabbbbbbbbbbbbbbbbbcdoooooooooooodbbbbbcccdooooooooooooddooooooddeeeccggggeeeeeeeeccccccccdoooooooccccccccceeeeeeeeeeeaaaaaaaa
aaaabbbbbbbbbbbbbbbbbcdmoooooooooomdbbbbbcccdmoooooooooomdeeccceeeeeeeeciggieeeeeeeeeeecccccdoooooodcccccceeeeeeeeeeeeeeeaaaaaaa
aaabbbbbbbbbbbbbbbbbbbddddddooddddddbcbbbbccddddddooddddddeeccceeeeeeddddooddddeeeeeeeeeeccddddooddddcccceeeeeeeeeeeeeeeeeeaaaaa
aaabbbbbbbbbbbbbbbbbbbbbdmoooooomdbbccbbbbccccdmoooooomdeeeeeccceeeeedmoooooomdeeeeeeeeecccdmoooooomdccceeeeeeeeeeeeeeeeeeeeaaaa
abbbbbbbbbbbbbbbbbbbbbbbooookoooodbccbbbccccccdoofooooodeeeeeccceeeeedoooooooodeeeeeeeeecccdoooooooopcceeeeeeeeeeeeeeeeeeeeeeaaa
abbbbbbbbbbbbbbbbbbbbbbbooopoppoodiDggggggggDidoooooooodiiDggggggggDidooooofoodiDggggggggDidoooooooppceeeeeeeeeeeeeeeeeeeeeeeeaa
abbbbbbbbbbbbbbbbbbbbbbboolpppooooggggggggggggoooooooooogggggggggggggooooooooooggggggggggggooooooppppeeeeeeeeeeeeeeeeeeeeeeeeeaa
abbbbbbbbbbbbbbbbbbbbbbcpppppoooooggggggggggggoofooooooogggggggggggggooooofooooggggccggggggooooooooppeeeeeeeeeeeeeeeeeeeeeeeeeaa
abbbbbbbbbbbbbbbbbbbbbccpppppoooodiDggggggggDidoooooooodiiDggggggggDidoooooooodiDccccccggDidooooooopoeeeeeeeeeeeeeeeeeeeeeeeeeaa
abbbbbbbbbbbbbbbbbbbbbccoooopoooodccccccccccccdoooooooodcccccccccccccdoopppooodcccccccccceedoooooooooeeeeeeeeeeeeeeeeeeeeeeeeeea
abbbbbbbbbbbbbbbbbbbbcccdmoooooomdbbbcccccccccdmoooooomdcceeeeeeeeeeedmooppoomdccccccccceeedmoooooomdeeeeeeeeeeeeeeeeeeeeeeeeeaa
abbbbbbbbbbbbbbbbbbbbbccddddooddddbbbbbbbbccccddooooooddceeeeeeeeeeeeddoooppoddcccccceeeeeeddddooddddeeeeeeeeeeeeeeeeeeeeeeeeeaa
abbbbbbbbbbbbbbbbbbbbbbcccciggibbbbbbbbbbbbbcccccccccccceeeeeeeeeeeeeeeeeeecccccccceeeeeeeeeeeiggiccceeeeeeeeeeeeeeeeeeeeeeeeaaa
abbbbbbbbbbbbbbbbbbbbbbbcccDggFbcbbbbbbbbbbbcccccccccceeeeeeeeeeeeeeeeeeeeeecccccceeeeeeeeeeeeDggDccceeeeeeeeeeeeeeeeeeeeeeeeaaa
abbbbbbbbbbbbbbbbbbbbbbbcccgcggccbbbbbbbbbbbbccccccceeeeeeeeeeeeeeeeeeeeeeeeeccceeeeeeeeeeeeeeggggcceeeeeeeeeeeeeeeeeeeeeeeeeaaa
abbbbbbbbbbbbbbbbbbbbbbbbccggggcccbbbbbbbbbbbbcccceeeeeeeeeeeeeeeeeeeeeeeeeeeeeeeeeeeeeeeeeeeeggggcceeeeeeeeeeeeeeeeeeeeeeeeaaaa
abbbbbbbbbbbbbbbbbbbbbbbbccgggcccccbbbbbbbbbbbebbeeeeeeeeeeeeeeeeeeeeeeeeeeeeeeeeeeeeeeeeeeeeeggggcceeeeeeeeeeeeeeeeeeeeeeeeaaaa
abbbbbbbbbbbbbbbbbbbbbbbbbcgggcccccbbbddddddddddddddddddddddddddddddeeeeeeeeeeeeeeeeeeeeeeeeeeggggceeeeeeeeeeeeeeeeeeeeeeeeeaaaa
abbbbbbbbbbbbbbbbbbbbbbbbbcggggccccbbbdEEEEEEEEEEEEEEEEEEEEEEEEEEEEdeeeeeeeeeeeeeeeeeeeeeeeeeeggggeeeeeeeeeeeeeeeeeeeeeeeeeeeaaa
abbbbbbbbbbbbbbbbbbbbbbbbbbgcggcccbbbbdEEEEEEEEEEEEEEEEEEEEEEEEEEEEdeeeeeeeeeeeeeeeeeeeeeeeeeeggggeeeeeeeeeeeeeeeeeeeeeeeeeeeaaa
abbbbbbbbbbbbbbbbbbbbbbbbbcggccccbbbbbdEEEEEEEEEEEEEEEEEEEEEEEEEEEEdeeeeeeeeeeeeeeeeeeeeeeeeeeggggeeeeeeeeeeeeeeeeeeeeeeeeeeeaaa
abbbbbbbbbbbbbbbbbbbbbbbbbcggggccbbbbbdEEEEEEEEEEEEEEEEEEEEEEEEEEEEdeeeeeeeeeeeeeeeeeeeeeeeeeeggggeeeeeeeeeeeeeeeeeeeeeeeeeeeaaa
abbbbbbbbbbbbbbbbbbbbbbccccFggDcbbbbbbdEEEEEEEEEEEEEEEEEEEEEEEEEEEEdeeeeeeeeeeeeeeeeeeeeeeeeeeDggDeeeeeeeeeeeeeeeeeeeeeeeeeeeaaa
abbbbbbbbbbbbbbbbbbbbbbcccciggicbbbbbbdEEEEEEEEEEEEEEEEEEEEEEEEEEEEdeeeeeeeeeeeeeeeeeeeeeeeeeeiggieeeeeeeeeeeeeeeeeeeeeeeeeeeaaa
abbbbbbbbbbbbbbbbbbbbbccddddooddddbbbbdEEEEEEEEEEEHHEEHHEEEEEEEEEEEdeeeeeeeeeeeeeeeeeeeeeccddddooddddeeeeeeeeeeeeeeeeeeeeeeeeaaa
abbbbbbbbbbbbbbbbbbbbbccdmoooooomdbbbbdEEEEEEEEEEImoHHomJEEEEEEEEEEdeeeeeeeeeeeeeeeeeeeecccdooooooomdeeeeeeeeeeeeeeeeeeeeeeeeaaa
abbbbbbbbbbbbbbbbbbbbbccpooppooooobbbbdEEEEEEEEEEIooooooJEEEEEEEEEEdeeeeeeeeeeeeeeeeeeeecccpoooooooooeeeeeeeeeeeeeeeeeeeeeeeeaaa
abbbbbbbbbbbbbbbbbbbbbccpophooofoobbbbdEEEEEEEEEEEIooooJEEEEEEEEEEEdeeeeeeeeeeeeeeeeeeeecccpoooooooooeeeeeeeeeeeeeeeeeeeeeeeeaaa
abbbbbbbbbbbbbbbbbbbbbccpppooooooobbbbdEEEEEEEEEEEIooooJEEEEEEEEEEEdeeeeeeeeeeeeeeeeeeeecccppooooooooeeeeeeeeeeeeeeeeeeeeeeaaaaa
abbbbbbbbbbbbbbbbbbbbbbcpppppjoooobbbbdEEEEEEEEEEIooooooJEEEEEEEEEEdeeeeeeeeeeeeeeeeeeeecccpppoooooooeeeeeeeeeeeeeeeeeeeeeeeaaaa
abbbbbbbbbbbbbbbbbbbbbbbppooppoooobbbbdEEEEEEEEEEImoKKomJEEEEEEEEEEdeeeeeeeeeeeeeeeeeeeeeccppppooooooeeeeeeeeeeeeeeeeeeeeeeaaaaa
abbbbbbbbbbbbbbbbbbbbbbboppfopoooobbbbdEEEEEEEEEEEKKEEKKEEEEEEEEEEEdeeeeeeeeeeeeeeeeeeeeeccpppoooooooeeeeeeeeeeeeeeeeeeeeeeaaaaa
abbbbbbbbbbbbbbbbbbbbbbbdmoooooomdbbbbdEEEEEEEEEEEEEEEEEEEEEEEEEEEEdeeeeeeeeeeeeeeeeeeeeeecdppooooomdeeeeeeeeeeeeeeeeeeeeeeaaaaa
abbbbbbbbbbbbbbbbbbbbbbbddddooddddbbbbdEEEEEEEEEEEEEEEEEEEEEEEEEEEEdeeeeeeeeeeeeeeeeeeeeeeeddddooddddeeeeeeeeeeeeeeeeeeeeeeeaaaa
abbbbbbbbbbbbbbbbbbbbbbbbeeiggieebbbbbdEEEEEEEEEEEEEEEEEEEEEEEEEEEEdbbeeeebbbbbbbbbbbbbbbbbbbbiggibbbbbbbbbbbbbbbbbbbbbbbbbbaaaa
abbbbbbbbbbbbbbbbbbbbbbbbeecgggeebbbbbdEEEEEEEEEEEEEEEEEEEEEEEEEEEEdbbeeeebbbbbbbbbbbbbbbbbbbbDggDbbbbbbbbbbbbbbbbbbbbbbbbbbbaaa
abbbbbbbbbbbbbbbbbbbbbbbbeeggggeebbbbbdEEEEEEEEEEEEEEEEEEEEEEEEEEEEdbbeeeebbbbbbbbbbbbbbbbbbbbggggbbbbbbbbbbbbbbbbbbbbbbbbbbbaaa
abbbbbbbbbbbbbbbbbbbbbbbbeeggggeebbbbbdEEEEEEEEEEEEEEEEEEEEEEEEEEEEdbbeeeebbbbbbbbbbbbbbbbbbbbggggbbbbbbbbbbbbbbbbbbbbbbbbbbbaaa
abbbbbbbbbbbbbbbbbbbbbbbbeeggggeebbbbbdEEEEEEEEEEEEEEEEEEEEEEEEEEEEdbbeeeebbbbbbbbbbbbbbbbbbbbggggbbbbbbbbbbbbbbbbbbbbbbbbbbbaaa
abbbbbbbbbbbbbbbbbbbbbbbbccgccgeebbbbbdEEEEEEEEEEEEEEEEEEEEEEEEEEEEdbbeeeebbbbbbbbbbbbbbbbbbbbggggbbbbbbbbbbbbbbbbbbbbbbbbbbaaaa
abbbbbbbbbbbbbbbbbbbbbbbcccgcggeebbbbbdEEEEEEEEEEEEEEEEEEEEEEEEEEEEdbbeeeebbbbbbbbbbbbbbbbbbbbggggbbbbbbbbbbbbbbbbbbbbbbbbbbaaaa
abbbbbbbbbbbbbbbbbbbbbcccccgcggeebbbbbdEEEEEEEEEEEEEEEEEEEEEEEEEEEEdbbeeeebbbbbbbbbbbbbbbbbbbbggggbbbbbbbbbbbbbbbbbbbbbbbbbaaaaa
abbbbbbbbbbbbbbbbbbbcccccccccggeebbbbbdEEEEEEEEEEEEEEEEEEEEEEEEEEEEdbbeeeebbbbbbbbbbbbbbbbbbbbggggbbbbbbbbbbbbbbbbbbbbbbbbbaaaaa
abbbbbbbbbbbbbbbbbbcccccccccgggeebbbbbdEEEEEEEEEEEEEEEEEEEEEEEEEEEEdbbeeeebbbbbbbbbbbbbbbbbbbbggggbbbbbbbbbbbbbbbbbbbbbbbbaaaaaa
abbbbbbbbbbqqqqqqqqqqqqqqcccgggeebbbbbddddddddqqqqqqnnqqqqqqddddddddbbeeeebbbbbbbbbbbbbbbbbbbbDggDbbbbbbbbbbbbbbbbbbbbbbbaaaaaaa
abbbbbbbbbbqrrrryyrrrrrrqcciggieebbbbbbbbbbbbbqLnnnnnnnnnnLqbbbbbbbbbbeeeebbbbbbbbbbbbbbbbbbbbiggibbbbbbbbbbbbbbbbbbbbbbbaaaaaaa
abqqqqqqqqqqrrrCzwwrryrrqqqqrrqqqqbbbbbbbbbbbbqnnnnnnnnnnnnqbbbbbbbbbbbbbbbbbbbbbbbbbbbbbbbbbbiggibbbbbbbbbbbbbbbbbbbbbbaaaaaaaa
abqrrrrrrrrqrryywwwwwwrrqrrrrrrrrqbbbbbbbbbbbbqnnnnnnnnnnnnqbbbbbbbbbbbbbbbbbbbbbbbbbbbbbbbddddooddddbbbbbbbbbbbbbbbbbbbbaaaaaaa
abqrrrrrrrrqrrywwwwwwwrrqrrrrrrrrqbbbbbbbbbbbbqnnnnnnnnnnnnqbbbbbbbbbbbbbbbbbbbbbbbbbbbbbbcdmoooooomdbbbbbbbbbbbbbbbbbbbbbaaaaaa
abqrrrrrrrrqrwwwwxwwwrrrqrrrrrrrrqqrrrrrrrrrrqqnnnnnnnnnnnnqbbbbbbbbbbbbbbbbbbbbbbbbbbbbbccoooooooooocbbbbbbbbbbbbbbbbbbbbaaaaaa
abqrrrrrrrrrrwwwwwwwwwrrrrrrrrrrrrrrrrrrrrrrrrMnnnnnnnnnnnnqbbbbbbbbbbbbbbbbbbbbbbbbbbbbcccoooooooooocbbbbbbbbbbbbbbbbbbbbbaaaaa
abqrrssrrrrrrrrwwwwwwwrrrrrrrrrrrrrrrrrrrrrrrrMnnnnnnnnnnnnqbbbbbbbbbbbbbbbbbbbbbbbbbbbbcccoooooppoooccbbbbbbbbbbbbbbbbbbbbaaaaa
abqrrrsrrrrqrrrrwwwwwrrrqrrrrrrrrqqrrrrrrrrrrqqnnnnnnnnnnnnqbbbbbbbbbbbbbbbbbbbbbbbbbbbbcccooooooppppccbbbbbbbbbbbbbbbbbbbbaaaaa
abqrrrssrrrqrrwwwwwwwrrrqrrrrrrrrqbbbbbbbbbbbbqnnnnnnnnnnnnqbbbbbbbbbbbbbbbbbbbbbbbbbbbbbccooooppooppccbbbbbbbbbbbbbbbbbbbaaaaaa
abqrrrrssrrqrrwwrrrrwwrBqrrrrrrrrqbbbbbbbbbbbbqnnnnnnnnnnnnqbbbbbbbbbbbbbbbbbbbbbbbbbbbbbbcooooopoooocccbbbbbbbbbbbbbbbbbaaaaaaa
abqqqqqsssqqrrwrrrrrrrrAqqqqqqqqqqbbbbbbbbbbbbqnnnnnnnnnnnnqbbbbbbbbbbbbbbbbbbbbbbbbbbbbbbcdmoooppoodcccbbbbbbbbbbbbbbbbbaaaaaaa
abttuuuuuuuqrrrrrrrAAAAAquuuuuttttbbbbbbbbbbbbqLnnnnnnnnnnLqbbbbbbbbbbbbbbbbbbbbbbbbbbbbbbbddoooopoddcccccbbbbbbbbbbbbbbbaaaaaaa
abtGuuuuuuuqqqqqqrrqqqqqquuuutttttbbbbbbbbbbbbqqqqqqqqqqqqqqbbbbbbbbbbbbbbbbbbbbbbbbbbbbbbbbbbbbbcccccccccbbbbbbbbbbbbbbbbaaaaaa
abttttuuuuuuuqrrrrrrrrquuuuuttttttbbbbbbbbbbbbbbbbbbbbbbbbbbbbbbbbbbbbbbbbbbbbbbbbbbbbbbbbbbbbbbbbcccccccbbbbbbbbbbbbbbbbaaaaaaa
abttttttuuuuurrrrrrrrrruuuutttttttbbbbbbbbbbbbbbbbbbbbbbbbbbbbbbbbbbbbbbbbbbbbbbbbbbbbbbbbbbbbbbbbbbbcccbbbbbbbbbbbbbbbbbaaaaaaa
abttttttttuuussssssrrrsuuuttttttttbbbbbbbbbbbbbbbbbbbbbbbbbbbbbbbbbbbbbbbbbbbbbbbbbbbbbbbbbbbbbbbbbbbbbbbbbbbbbbbbbbbbbbbbaaaaaa
abttttttttuuusssrrrrrssuutttttttttbbbbbbbbbbbbbbbbbbbbbbbbbbbbbbbbbbbbbbbbbbbbbbbbbbbbbbbbbbbbbbbbbbbbbbbbbbbbbbbbbbbbbbbbaaaaaa
abtttttttttuussssrrrsssuutttttttttbbbbbbbbbbbbbbbbbbbbbbbbbbbbbbbbbbbbbbbbbbbbbbbbbbbbbbbbbbbbbbbbbbbbbbbbbbbbbbbbbbbbbbbbaaaaaa
abtttttttttuurssssrrrssuttttttttttbbbbbbbbbbbbbbbbbbbbbbbbbbbbbbbbbbbbbbbbbbbbbbbbbbbbbbbbbbbbbbbbbbbbbbbbbbbbbbbbbbbbbbbbaaaaaa
abtttttttttturrrssrrrsrtttttttttttbbbbbbbbbbbbbbbbbbbbbbbbbbbbbbbbbbbbbbbbbbbbbbbbbbbbbbbbbbbbbbbbbbbbbbbbbbbbbbbbbbbbbbbbaaaaaa
abtttttttttttqrrrrssrrqtttttttttttbbbbbbbbbbbbbbbbbbbbbbbbbbbbbbbbbbbbbbbbbbbbbbbbbbbbbbbbbbbbbbbbbbbbbbbbbbbbbbbbbbbbbbbaaaaaaa
abtttttttttttqqrrrsrrqqtttttttttttbbbbbbbbbbbbbbbbbbbbbbbbbbbbbbbbbbbbbbbbbbbbbbbbbbbbbbbbbbbbbbbbbbbbbbbbbbbbbbbbbbbbbbbaaaaaaa
abttttttttttttuuuuuuuuutttttttttttbbbbbbbbbbbbbbbbbbbbbbbbbbbbbbbbbbbbbbbbbbbbbbbbbbbbbbbbbbbbbbbbbbbbbbbbbbbbbbbbbbbbbbbaaaaaaa
aatttttttttttttttuuuuuttttttttttttbbbbbbbbbbbbbbbbbbbbbbbbbbbbbbbbbbbbbbbbbbbbbbbbbbbbbbbbbbbbbbbbbbbbbbbbbbbbbbbbbbbbbbaaaaaaaa
aattttttttttttttttuuuuuuttttttttttbbbbbbbbbbbbbbbbbbbbbbbbbbbbbbbbbbbbbbbbbbbbbbbbbbbbbbbbbbbbbbbbbbbbbbbbbbbbbbbbbbbbbbaaaaaaaa
aavtttttttttttttttttuuuuuuttttttttbbbbbbbbbbbbbbbbbbbbbbbbbbbbbbbbbbbbbbbbbbbbbbbbbbbbbbbbbbbbbbbbbbbbbbbbbbbbbbbbbbbbbaaaaaaaaa
aavtttttttttttttttttuuuuuuGtttttttbbbbbbbbbbbbbbbbbbbbbbbbbbbbbbbbbbbbbbbbbbbbbbbbbbbbbbbbbbbbbbbbbbbbbbbbbbbbbbbbbbbbaaaaaaaaaa
aavvttttttttttttttttuuuuuuutttttttbbbbbbbbbbbbbbbbbbbbbbbbbbbbbbbbaabbbbbbbbbbbbbbbbbbbbbbbabbbbbbbbbbbbbbbbbbbbbbbbbaaaaaaaaaaa
aavvvttttttttttttttttuuuuuutttttttbbbbbbbbbbbbbbbbbbbbbbbbbbbbbbbbabbbbbbbbbbbbbbbbbbbbbbbaabbabbbbbbbbbbbbbbbbbbbbbaaaaaaaaaaaa
aavvvvttttttttttttttttGuttttttttttbbbbbbbbbbbbbbabbbbbbbbbbbbbbbaaaabbbbbbbbbbbbbbbbbbbbbaaaaaabbbbbbbbbbbbbbbbbbaabaaaaaaaaaaaa
aaaaaabbbbbbbbbbbbbbbbbbbbbbbbbbbbbbbbbbbbbbbbaaabbbbbbbbbbbbbbaaaaaaabbbbbbbbbbbbbbbbbbaaaaaaabbbbbbbbbbbbbbbbbbaaaaaaaaaaaaaaa
aaaaaaabbbbbbbbbbbbbbbbbbbbbbbbbbbbbbbbbbbbaaaaaaabbbbbbbbbbbaaaaaaaaaaabbbbbbbbbbbbbbaaaaaaaaaaaabbbbbbbbbbbbbaaaaaaaaaaaaaaaaa
aaaaaaaabbbbbbbbbbbbbbbbbbbbbbbbbbbbbbbbbaaaaaaaaaabbbbbbbbbaaaaaaaaaaaaaabbbbbbbbbbaaaaaaaaaaaaaaaaabbbbbbbaaaaaaaaaaaaaaaaaaaa
aaaaaaaaabbbbbbbbbbbbbbbbaaabbbbbbbbbbaaaaaaaaaaaaaaaaabbbaaaaaaaaaaaaaaaaaabbbbbbaaaaaaaaaaaaaaaaaaaabbbbaaaaaaaaaaaaaaaaaaaaaa
aaaaaaaaaaabbbbbbbbaaaaaaaaabbbbbbbbaaaaaaaaaaaaaaaaaaaaaaaaaaaaaaaaaaaaaaaaaaabaaaaaaaaaaaaaaaaaaaaaaaaaaaaaaaaaaaaaaaaaaaaaaaa
aaaaaaaaaaaaaaaaaaaaaaaaaaaaaaaaaaaaaaaaaaaaaaaaaaaaaaaaaaaaaaaaaaaaaaaaaaaaaaaaaaaaaaaaaaaaaaaaaaaaaaaaaaaaaaaaaaaaaaaaaaaaaaaa
aaaaaaaaaaaaaaaaaaaaaaaaaaaaaaaaaaaaaaaaaaaaaaaaaaaaaaaaaaaaaaaaaaaaaaaaaaaaaaaaaaaaaaaaaaaaaaaaaaaaaaaaaaaaaaaaaaaaaaaaaaaaaaaa
"}
