"a" = (/turf/simulated/wall/rock/basalt,/area/world/lava/safezone)
"b" = (/turf/simulated/floor/lava,/area/world/lava/exterior)
"c" = (/turf/simulated/wall/rock/basalt,/area/world/lava/exterior)
"d" = (/turf/simulated/floor/basalt,/area/world/lava/exterior)
"e" = (/turf/simulated/floor/cult/darker,/area/world/lava/safezone)
"f" = (/turf/simulated/floor/stair/cult{icon_state = "stair"; dir = 1},/area/world/lava/safezone)
"g" = (/turf/simulated/floor/stair/cult{icon_state = "stair"; dir = 4},/area/world/lava/safezone)
"h" = (/obj/structure/interactive/lighting/cult_pylon,/turf/simulated/floor/cult,/area/world/lava/safezone)
"i" = (/turf/simulated/floor/cult,/area/world/lava/safezone)
"j" = (/turf/simulated/floor/stair/cult{icon_state = "stair"; dir = 8},/area/world/lava/safezone)
"k" = (/turf/simulated/floor/basalt,/area/world/lava/safezone)
"l" = (/turf/simulated/floor/stair/cult,/area/world/lava/safezone)
"m" = (/turf/simulated/floor/colored/ash/dark,/area/world/lava/exterior)
"n" = (/turf/simulated/wall/metal/reinforced,/area/world/lava/exterior)
"o" = (/turf/simulated/floor/tile/dark,/area/world/lava/exterior)
"p" = (/turf/simulated/floor/plating,/area/world/lava/exterior)
"q" = (/turf/simulated/wall/metal/reinforced,/area/world/lava/lab)
"r" = (/turf/simulated/floor/chasm,/area/world/lava/exterior)
"s" = (/turf/simulated/floor/colored/ash/dark,/area/world/lava/safezone)
"t" = (/turf/simulated/wall/cult,/area/world/lava/safezone)
"u" = (/obj/structure/interactive/lighting/tube{icon_state = "tube"; dir = 4},/turf/simulated/floor/basalt,/area/world/lava/exterior)
"v" = (/turf/simulated/floor/tile/dark,/area/world/lava/lab)
"w" = (/mob/living/simple/npc/goliath,/turf/simulated/floor/basalt,/area/world/lava/exterior)
"x" = (/mob/living/simple/npc/goliath,/turf/simulated/floor/colored/ash/dark,/area/world/lava/exterior)
"y" = (/turf/simulated/floor/plating,/area/world/lava/lab)
"z" = (/obj/structure/interactive/lighting/tube{icon_state = "tube"; dir = 8},/turf/simulated/floor/tile/dark,/area/world/lava/lab)
"A" = (/obj/structure/smooth/table/reinforced/dark,/turf/simulated/floor/tile/dark,/area/world/lava/lab)
"B" = (/obj/structure/interactive/lighting/tube{icon_state = "tube"; dir = 1},/turf/simulated/floor/tile/dark,/area/world/lava/lab)
"C" = (/obj/structure/smooth/table/reinforced/dark,/obj/structure/interactive/lighting/tube{icon_state = "tube"; dir = 8},/turf/simulated/floor/tile/dark,/area/world/lava/lab)
"D" = (/obj/structure/interactive/lighting/tube{icon_state = "tube"; dir = 4},/turf/simulated/floor/tile/dark,/area/world/lava/lab)
"E" = (/obj/structure/interactive/lighting/tube,/turf/simulated/floor/tile/dark,/area/world/lava/lab)
"F" = (/obj/structure/smooth/table/reinforced/dark,/obj/structure/interactive/lighting/tube{icon_state = "tube"; dir = 4},/turf/simulated/floor/tile/dark,/area/world/lava/lab)
"G" = (/obj/structure/smooth/table/reinforced/dark,/obj/structure/interactive/lighting/tube,/turf/simulated/floor/tile/dark,/area/world/lava/lab)
"H" = (/obj/structure/interactive/grille,/obj/structure/smooth/window/reinforced,/turf/simulated/floor/plating,/area/world/lava/lab)
"I" = (/turf/simulated/floor/colored/necro_grass,/area/world/lava/safezone)
"J" = (/obj/structure/interactive/wishgranter/normal/hell,/turf/simulated/floor/colored/necro_grass,/area/world/lava/safezone)
"K" = (/turf/simulated/floor/colored/ash/rocky,/area/world/lava/safezone)
"L" = (/turf/simulated/floor/colored/ash/rocky,/area/world/lava/exterior)
"M" = (/turf/simulated/wall/wood/boat,/area/world/lava/interior/chapel)
"N" = (/turf/simulated/floor/wood/boat,/area/world/lava/interior/chapel)
"O" = (/turf/simulated/floor/basalt,/area/world/lava/exterior/chapel)
"P" = (/turf/simulated/wall/rock/basalt,/area/world/lava/exterior/chapel)
"Q" = (/turf/simulated/floor/colored/ash/dark,/area/world/lava/exterior/chapel)
"R" = (/turf/simulated/floor/colored/necro_grass,/area/world/lava/exterior/chapel)
"S" = (/obj/structure/interactive/wishgranter/normal/hell/chapel,/turf/simulated/floor/colored/necro_grass,/area/world/lava/exterior/chapel)
"T" = (/turf/simulated/floor/carpet,/area/world/lava/interior/chapel)
"U" = (/turf/simulated/floor/colored/ash/dark,/area/world/lava/interior/chapel)

(1,1,1) = {"
aaaaaaaaaaaaaaaaaaaaaaaaaaaaaaaaaaaaaaacccccccccccccccccccccccccccccccccccccccccccccccccccccccbbbbbbbbbbbccddddddddddddccccccccc
aaaaaattttttttttttaaaaaaaattttttttaaaaacccccccccccccmmmmmmcccdddddcccccccccccccccccccccccccccccbbbbbbbbbbbcdddddddddddccccbccccc
aaaaaaeeeeeeeeeeetttaaaeeeeeeeeeettttttccccccccccmmmmdddddddddddddddcccccccccccccbbbbbbbbbbbbbbbbbbbbbbbbbccdddddddddccccbbccccc
aaaaaeeeeeeeeeeeeeetaaeeeeeeeeeeeeeeeetcccccccmmmmdddddddddddddddddccccccccbbbbbbbbbbbbbbbbbbbbbbbbbbbbbbbbccddddddddcccbbbbcccc
aaaaeeeeeeeeeeeeeeetaeeeeeeeeeeeeeeeeetccccccmmdddddddddddddddddddccccccccbbbbbbbbbbbbbbbbbbbbbbbbbbbbbbbbcccdddddddcccbbbbbcccc
aaaeeeeffeeffeeeeeeeeeeeeeeeeeeeeeeeeetccmmmmmdddddddddddddddddddccccccccbbbbbbbbbbbbbbbbbbbbbbbbbbbbbbbbbbcccddddddcccbbbbbcccc
aaaeeeghiffihjeeeeeeeeeeeeeeeeeeeeeeeetcmmmddddddddddddddddddddccccccccbbbbbbbbbbbbbbbbbbbbbbbbbbbbbbbbbbbbbccddddddccbbbbbbcccc
aaeeeegiiiiiijeeeeeettttttttteeeeeeeeettmmdddddddddddddddddddddccccccccbbbbbbbbbbbbbbbbbbbbbbbbbbbbbbbbbbbbbbccdddddcbbbbbbbbccc
ateeeeegiiiijKKeeeeKthiiiiihteeeeeeeeettddddddddddddddddddddddddccccccbbbbbbbbbbbbbbbbbbbbbbbbbbbbbbbbbbbbbbbccdddddcbbbbbbbbccc
ateeeeegiiiijKKKKKKKtiiiiiiiteeeeeeekkkkddddddddddddddccccccdddddcccbbbbbbbbbbbbbbbbbbbbbbbbbbbbbbbbbbbbbbbbbddddddddbbbbbbbbbcc
ateeeegiiiiiijKKKKKKtiiiiiiiteeeeeekkkkKLdddccccdddddccccccccddddddbbbbbbbbbbbbbbbbbbbbbbbbbbbbbbbbbbbbbbbbbbddddddddbbbbbbbbbbc
aaeeeeghillihjKKKKKKtiiiiiiiteeeeeekkkKKdddcccccmdddccccccccccddddddbbbbbbbbbbbbbbbbbbbbbbbbbbbbbbbbbbbbbbbbbbddddddbbbbbbbbbbbc
aaeeeeellKKllKKKeeKKtiiiiiiiteeeeeeeKKKkddcccccmmddcccccccccbbbdddddddbbbbbbbbbbbbbbbbbbbbbbbbbbbbbbbbbbbbbbbbbdddddbbbbbbbbbbcc
aaeeeeeeeKKKKKKeeKKKthiiiiihteeeeeKKKKkkddccccmmmdcccccccccbbbbbbddddddbbbbbbbbbbbbbbbbbbbbbbbbbbbbbbbbbbbbbbbbddddbbbbbbbbbbbcc
aaaeeeeeeeKKKKeeeeKKttttltttteeKKKKKKKttdddccmmmddccccccbbbbbbbbbbdddddddbbbbbbbbbbbbbbbbbbbbbbbbbbbbbbbbbbbbbbddddbbbbbbbbbbccc
aaaeeeeeeeKKKKKKKKKKKeeeeeeKKeKKKKKKkkttddddmmmddddccccbbbbbbbbbbbbbddddddddbbbbbbbbbbbbbbbbbbbbbbbbbbbbbbbbbbbddddbbbbbbbbbcccc
aatttttttKKKKKeKKKKKKKKKKKKKKKKKKKKKKKtccddddddddddddcbbbbbbbbbbbbbbbbddddddddbbbbbbbbbbbbbbbbbbbbbbbbbbbbbbbbdddddbbbbbbbbbcccc
aathiiihtKKKKeeeeeeKeKKKKKeKKKKKKKeKKKtccdddddddddddddbbbbbbbbbbbbbbbdddddddddddbbbbbbbbbbbbbbbbbbbbbbbbbbbbbbdddddbbbbbbbbbcccc
attiiiiiteKKttttfttttKKetttttttttttKKKtccddLdccccddddddbbbbbbbbbbbbddddddddddddddbbbbbbbbbbbbbbbbbbbbbbbbbbbbbdddddbbbbbbbbccccc
atiiiiiitKKKthiiiiihtKKKthiiiiiiihtKKetccdLLLcccccdmddddbbbbbbbbbddddddddddddddddddbbbbbbbbbbbbbbbbbbbbbbbbbbbdddddbbbbbbbcccccc
atiiiiiitKKKtiiiiiiitKKKtiiiiiiiiitKKKtccLLLcccccccmmddddbbbbbbddddddddbbbbbddddddddbbbbbbbbbbbbbbbbbbbbbbbbbbbddddbbbbbbbcccccc
atiiiiiitKKKtiiiiiiitKKKtiiiiiiiiitKKKeLLLLcccccccccmmdddbbbbdddddddddbbbbbbbbdddddddccbbbbbbbbbbbbbbbbbbbbbbbbdddddbbbbbbcccccc
atiiiiiiteKKtiiiiiiitKeKtiiiiiiiiitKKKeLLLcccccccccccmmddddddddddddddbbbbbbbbbbbbddddccbbbbbbbbbbbbbbbbbbbbbbbbdddddbbbbbbbccccc
atiiiiiiteKKtiiiiiiitKKKtiiiiiiiiitKKKKLLcccccccccccccmmdddddddddddbbbbbbbbbbbbbbdddddccbbbbbbbbbbbbbbbbbbbbbbbdddddbbbbbbbbcccc
atiiiiiijeKethiiiiihtKKKthiiiiiiihtKKKKKaacccccccbcccccmmddddddddddbbbbccccbbbbbbbddddcccbbbbbbbbbbbbbbbbbbbbbbddddddbbbbbbbbccc
athiiiihteKKtttttttttKKKttltttttttteKKKKtaccccccbbbcccccmdddddddddbbbbccccccbbbbbbddddccccbbbbbbbbbbbbbbbbbbbbbddddddbbbbbbbbccc
attttttttKKKKKKKKKKKKKKKKeeeeKeKKKKKKKKetaccccccbbbbccccmmdddddddbbbbbccddcccbbbbbbddddcccbbbbbbbbbbbbbbbbbbbbbdddddddbbbbbbbbcc
aateeeeeeKeKKKKKKKKKKKeKKKKKKKKKKKKKKKKetacccccbbbbbbccccmdddddddbbbbccddddcccbbbbbddddcccbbbbbbbbbbbbbbbbbbbbbdddddddbbbbbbbbbc
aaeeeeeeeKKKKKKIIIKKKKKKKKKKKKKKKKKKKKeetaccccbbbbbbbbcccmmdddddbbbbbccdddddccbbbbbdddddcccbbbbbbbbbbbbbbbbbbbddddddddbbbbbbbbbc
aaeeeeeeeeKKKKIIIIIKKKKKeeeeeeetteKKKssettccbbbbbbbbbbbcccmdddddbbbbbcddddddccbbbbbbddddcccbbbbbbbbbbbbbbbbbbbdddddddbbbbbbbbbbb
aaaeeeeeeeeKKKIIJIIKKKKeeeeeeetttKKKKsssttcbbbbbbbbbbbbcccmdddddbbbbbccddddddccbbbbbddddcccbbbbbbbbbbbbbbbbbbbdddddbbbbbbbbbbbbb
aateeeeeeeeKKKIIIIIKKKeeeeeeettacmLLmmmmmdddbbbbbbbbbbbcccmdddddbbbbbccddddddccbbbbbddddccbbbbbbbbbbbbbbbbbbbbdddddbbbbbbbbbbbbb
aateeeeeeeeeKKKIIIKKKeeeeeeeetacmmmmmmmddddddbbbbbbbbbbcccmdddddbbbbbbccdddddccbbbbddddcccbbbbbbbbbbbbbbbbbbbbddddbbbbbbbbbbbbbb
aateeeeeeeeeeKKKKKKeeeeeeeaaaacmmmmmmdddddddddbbbbbbbbbcccmdddddbbbbbbcccdddccbbbbbddddcccbbbbbbbbbbbbbbbbbbbbddddbbbbbbbbbbbbbb
aaaaeeeeeeeeeeKKKKeeeeeeeaaaaacmmmmddddddddddddbbbbbbbbcccmdddddbbbbbbbcccddccbbbbdddddcccbbbbbbbbbbbbbbbbbbbbddddbbbbbbbbbbbbbb
aaaaeeeeeeetteKKKKeetteeaaaaccmmmmddddddddddddddbbbbbbddddddddddbbbbbbbbccccccbbbbddddcccbbbbbbbbbbbbbbbbbbbbbdddddbbbbbbbbbbbbb
aaaaaaatttttteKKKKKetttaaaaaccmmmdddddddddddddddbbbbbddddddddddbbbbbbbbbbbbccbbbbbddddcccbbbbbbbbbbbbbbbbbbbbbbddddbbbbbbbbbbbbb
cccccccccccddLLLLLLLddcccccccmmmdddddddddddddddddbbbdddddddddddbcccbbbbbbbbbbbbbbddddcccbbbbbbbbbbbbbbbbbbbbbbdddddbbbbbbbbbbbbb
cccccccccccdLLLLLLLLdccccccccmmmddddddddddddddddddbbddddddddcccccccbbbbbbbbbbbbddddddcccbbbbbbbbbbbbbbbbbbbbbddddddbbbbbbbbbbbbb
cccccccccddLLLLLdddddcccccccmmmdcccdddddddddddddddddddddddddccccccccccbbbbbbbdddddddcccbbbbbbbbbbbbbbbbbbbbbdddddddbbbbbbbbbbbbb
cccccccccdLLLddddddccccccccmmmdccccdddddddddddddddddddddddddcccccccccccbbbbbddddddddccbbbbbbbbbbbbbbbbbbbbbbdddddddbbbbbbbbbbbbc
ccmmmcccddLddddddddcccccmmmmmdcccccddddddddddddddddddddddddccccccccccccmddddddddwddcccbbbbbbbbbbbbbbbbbbbbbddddddddbbbbbbbbbbbbc
cmmmmmccddddddddddcccccmmmmddccccccbdddddddddddddddddddddddccccccccccmmmdddddddddddccbbbbbbbbbbbbbbbbbbbbbdddddddddbbbbbbbbbbbbc
cmmmmmmddddddddddccccmmmmddddcccccbbbbbbdddddddddddwdddddddcccmmmmmmmmdddddddddddddccbbbbbbbbbbbbbbbbbbbbdddddddddbbbbbbbbbbbbcc
cmmdddddddddddddcccmmmddddddcccccbbbbbbbbbbdddddddddddddddcccmmdddddddddddddddddddddbbbbbbbbbbbbbbbbbbbbbddddddddbbbbbbbbbbbbbcc
cmmmddddddddddddmmmmdddddddccccccbbbbbbbbbbbbbddwdddddddccccmmddddddddddddddwdddddwddbbbbbbbbbbbbbbbbbbbddddddddbbbbbbbbbbbbbbcc
ccmmddddddddddddddddddddddccccccbbbbbbbbbbbbbddddddddddccccmmddddddddddddbddddddddddddbbbbbbbbbbbbbbbbbbddddddddbbbbbbbbbbbbbccc
cccmmdddddddddddddddddddddcccccbbbbbbbbbbbbbddddddddwddccmmmddddddddddbbbbddddbbdddddddbbbbbbbbbbbbbbbbbddddddddbbbbbbbbbbbbcccc
ccccmddddddddddccdddccddddccccbbbbbbbbbbbbddddddddddddddmmddddddddddbbbbbbddddbbdddddddbbbbbbbbbbbbbbbbbddddddddbbbbbbbbbbbbcccc
ccccmmdddddddccccccccdddddccbbbbbbbbbbbbbddddddddddddddddddddddddddbbbbbbbddddbbbddddddddbbbbbbbbbbbbbbbddddddddbbbbbbbbbbbbcccc
ccccccdddddddccccccccddddccccbbbbbbbcccbddddddddbddddddddddddddddbbbbbbbbddddbbbbbddddddddbbbbbbbbbbbbbbddddddddbbbbbbbbbbbbbccc
ccccccddddddcccccccbbbdddccccccccccccccddddddddbbdddddddccddcccbbbbbbbbbbddddbbbbbbdddddddbbbbbbbbbbbbbddddddddbbbbbbbbbbbbbbccc
ccccccddddddcccbcbbbbbdddcccccccccccccdddddddbbbbbddddddcccccccccbbbbbbbbddddbbbbbbbdddddddbbbbbbbbbbbbddddddddbbbbbbbbbbbbbbccc
cccccccddddcccbbbbbbbbdddddccccccdddddddddddbbbbbbddddddccccccccccbbbbbbddddbbbbbbbbdddddddbbbbbbbbbbbbddddddddbbbbbbbbbbbbbbccc
cccccccddddcccbbbbbbbddddddddddddddddddddbbbbbbbbbddddddccccccccccccbbbbddddbbbbbbbbbdddddddbbbbbbbbbbbdddddddbbbbbbbbbbbbbbbccc
cccccccdwdcccbbbbbbbdddddddddddddddddddbbbbbbbbbbbddddddccccccccccccbbbbdddbbbbbbbbbbbddddddbbbbbbbbbbbbddddddbbbbbbbbbbbbbbbbcc
cccccccdddccccbbbbbbdddddddddddddddddbbbbbbbbbbbbbdddddddcccccccccccbbbddddbbbbbbbbbbbbddddddbbbbbbbbbbbbddddddbbbbbbbbbbbbbbbcc
cccccccddddcccbbbbbbdddddddddddddddddbbbbbbbbbbbbbddddddddcccccccccccbdddddbbbbbbbbbbbbbbddddbbbbbbdccbbbddddddbbbbbbbbbbbbbbbcc
cccccccddddcccbbbbbbdddddqqqqqqqqqqqqqqqqqqqbbbbbbbddddddddccccccccmcmddddcbbbbbbbbbbbbbbdddddbbbbddcccbbddddddbbbbbbbbbbbbbbccc
ccccccccddddcccbbbbbdddddqvvBvvqvvBvvqvvBvvqbbbbbbbbddddddddccccccmmmmddddcbbbbbbbbbbbbbbbdddddbbbccccccbbdddddbbbbbbbbbbbbbbccc
ccccccccddddcccbbbbddddddqvvvvvvvvvvvvvvvvvqbbbbbbbbddddddddddccmmmmmddddccbbbbbbbbbbbbbbbdddddbbcccbbccbbdddddbbbbbbbbbbbbbbbcc
ccccccccdddddccbbbbddddddqvvvvvqvvvvvqvvvvvqbbbbbbbbbdddddddddcmmmmmddddccbbbbbbbbbbbbbbbbdddddbcccbbbbcbbbddddbbbbbbbbbbbbbbbcc
cccccccccddddcccbbbddddddqzvvvDqqvvvqqzvvvDqqqbbbbbbbnddddddddcmmmddddcccbbbbbbbbbbbbbbbbbbddddbcccbddbccbbddddbbbbbbbbbbbbbbbcc
cccccccccddddcccbbbddddddqvvvvvqvvvvvqvvvvvqvvvbbbbbppddddddddmmdddddccccbbbbbbbbbbbbbbbbbbdddbbbccddddccbbddddbbbbbbbbbbbbbbbbc
cccccccccddwdcccbbbddddddqvvvvvqzvvvDqvvvvvqvvvvvoooppddddddddddddddccccbbbbbbbbbbbbbbbbbbbdddbbbccddddccbbdddddbbbbbbbbbbbbbbcc
cccccccccdddddccbbbddddddqAAGAAqvvvvvqAAGAAqvvvyyppppdddddddddddddddcccbbbbbbbbbbbbbbbbbbbbdddbbbcmddddccbbdddddbbbbbbbbbbbbbbcc
ccmmmmccccddddcccbbdddddqqqqqqqqqvvvqqqqqqqqzvvyvyppdddddddddddddddccccbbbbbbbbbbbbbbbbbbbddddbbbcmmdddccbbdddddbbbbbbbbbbbbbbcc
ccmmxmmcccddddcccbbdddddqAvvvvvqvvvvvqvvBvvqvvvyyyvpdddddddddddddcccccbbbbbbbbbbbbbbbbbbbbddddbbbcmmmddccbbdddddbbbbbbbbbbbbbbcc
cmmmmmmcccdddddcccbdddddqCvvvvDqzvvvvvvvvvvvvvvyyvvydddddccdddddcccccbbbbbbbbbbbbbbbbbbbbbddddbbbcmmmmdccbbdddddbbbbbbbbbbbbbbcc
cmmmmdddcccddddccccbddddqAvvvvvqvvvvvqvvEvvqvvvvvvyyAyccccccdddcccccbbbbbbbbbbbbbbbbbbbbbdddddbbbcmmmmmccbbdddddbbbbbbbbbbbbbbcc
cmmmmmdddccdddddccccddddqqqqqvqqqvvvqqqqqqqqzvvyvyyvFqcccccccddccccbbbbbbbbbOOOOPPPPbbbbbdddddbbbccmmmmccbddddddbbbbbbbbbbbbbbcc
cmxmmmmdddddddddddcccddddddqvvvvBvvvvqAAAAAqvvvvvvvvAqbbccccccdcccbbbbbbbbbOOQQOOOPPPbbbbdddddbbcccmmmcccbdddwddbbbbbbbbbbbbbbcc
cdmmmmmddddddddddddccddddddqzvvAvvvvDqzvvvvvvvvvvvvvAqbbbbbcccdcccbbbbbbbbOOQRRRQOOPPPbbbddwdddbcccmmmcccbdddddddbbbbbbbbbbbbbcc
cccmmmmmddddddddddddccmmdddqvvvAvvvvvqvvvvvqvvvvGAAAAqbbbbbbccdcccbbbbbbbbOQQRSRQQOPPPbbbdddddddcccmmccccbdddddddbbbbbbbbbbbbbcc
cccccmmmdcddddddddddccmddduqAAAqvvvvvqvvvvvqqHHHqHHHqqbbbbbbbcddccbbbbbbbOOQQRRRQQQPPPbbbdddddddcccmmdcccmmmdddddbbbbbbbbbbbbccc
ccccccmmccccddddddddmmmddddvvvvvvvvvvqvvvvvqbbbbbbbbbbbbbbbbbcddcbbbbbbbbbQQQQQQQQQPPbbbbbddddddccccmmdcccmmmdddddbbbbbbbbbbbccc
cccccccccccccccccddddddddddvvvvvvvvvDqCvvvDqbbbbbbbbbbbbbbbbccdccbbbbbbbbbQMMMNMMMQPPbbbbbdddddddccccmmdcccmmmddddbbbbbbbbbbbbcc
cbbbbbbbccbbccbbcddddddddddvvvvvvvvvvqAvvvvHbbbbbbbbbbbbbbbcccdccbbbbbbbbOQMNNNNNMQPbbbbbbbddddddddcccmddcccmmmdddbbbbbbbbbbbccc
cbbbbbbbbbbbbbbbbddddwdddduqvvvvvvvvvqAvvvvHbbbbbbbbbbbbbbcccddccbbbbbbbbOQMNTTTNMQbbbbbbbbbddddddddccmmdccccmmmdddbbbbbbbbbbccc
cbbbbbbbbbbbbbbbbddddddddddqvvvvvvvvvqAvvvvHbbbbbbbbbbbbbbccddccbbbbbbbbbOQMNTTTNMObbbbbbbbbddddddddcccmddddccmmdddddbbbbbbbbccc
cbbbbbbbbbbbbbbbddddddddbbbqzvvvvvvvDqCvvvDqbbbbbbbbbbbbbcccdcccbbbbbbbbbOQMNTTTNMObbbbbbbbbbdddddddcccmmdddccmmmdddddbbbbbbbccc
cbbbbbbbbbbbbbbbdddddbddbbbqAAAAGAAAAqAAAAAqbbbbbbbbbbbbbccddcccbdbbbbbbbbQMNTTTNMOObbbbbbbbbbddddddcccmmddddccmmddddddbbbbbcccc
cdbbbbbbbbbbbbbddddddbbbbbbqqHHHqHHHqqqHHHqqbbbbbbbbbbbbccddccccdddbbbbbbbQMNTTTNMOObbbbbbbbbbdddddddccmmddddddmmdddddddbbbbbccc
cddbbbbbbbbbbbddddddbbbbbbbbbbbbbbbbbbbbbbbbbbbbbbbbbbbcccdccccmmdddbbbbbbQMNTTTNMOObbbbbbbbbbdddddddcmmdddddddmdddddddddbbbcccc
cdddbbbbbbbbbbdddccbbbbbbbbbbbbbbbbbbbbbbbbbbbbbbbbbbbcccddcccmmdddddbbbbbOMNTTTNMOObbbbbbbbbbbddddddcmmdddddddddddddddddbbbcccc
cddddbbbbbbbbbdddccbbbbbbbbbbbbbbbbbbbbbbbbbbbbbbbbbbccccdcccmmdddddddbbbbOMNNUUNMOObbbbbbbbbbbddddddddmddddddddddddddddddbccccc
cdddddddddbbbddddcccbbbbbbbbbbbbbbbbbbbbbbbbbbbbbbbcccccddccmmdddddbbbbbbbOMMMUMMMOObbbbbbbbbbbbdddddddddddddddddddddddddddccccc
cddwdddddddbbdddddcccbbbbbbbbbbbbbbbbbbbbbbbbbbbcccccccccddmmdddddbbbbbbbbOOOOQQOOObbbbbbbbbbbbbbddddddddddddddddddddddddddccccc
cdddddddddddddddddccccbbbbbbbbbbbbbbbbbbbbbbbbbccccccccmmdddddddddbbbbbbbbbOOOQOOOObbbbbbbbbbbbbbbddddddddddddddddddddddddddcccc
cddddddddddddddddddccccbbbbbbbbbbbbbbbbbbbbbbbccccccccmmdddddddddbbbbbbbbbbbOOOOOObbbbbbbbbbbbbbbbbdddddddddddddddddddddddddcccc
ccccccdddddddddddddcccccbbbbbbbbbbbbbbbbbbbbbccccccccmmddddddddddbbbbbbbbbbbbOOOOObbbbbbbbddbbbbbbbdddddddddddddddddddddddddcccc
ccccccccccdddddddddddccccbbbbbbbbbbbbbbbbbbcccccccccmmddddddddddcbbbbbbbbbbbbbbOOQbbbbdddddddddbbbbdddddddddddddddddddddddddcccc
cccccccccccccdddddddddccccccccbbbbbbbbbbbcccccccmcccmmddddddddddcbbbbbbbbbbbbbbbdmmdddddddddddddbbbbddddddddddddddddddddddddcccc
ccccccccccccccccddddddddcccccccccccbbbbbcccccccmmmmmmdddddddddddccbbbbbbbbbbbbbbddmdddddddddddddbbbbddddddddddddddddddddddddcccc
ccccccccccccccccccdddwdddcccccccccccbbbbccbccccmmdddddddddddddddccbbbbbbbbbbbbbccddrrdddddddddddbbbbbbbddddddddddddddddddddbbccc
ccccmmmbbbbbcccccccdddddddmmmmmccccccbbbbbbbcmmmddddddddddddddddcccbbbbbbbbbbcccccrrrrdddddddddddbbbbbbbdddddddddddddddddddbbccc
cccmmmdbbbbbbbbcccccdddddddddmmmcccccbbbbbbccmmdddddddddddddddddcccccbbbbbbbccccccrrrddddwddddddbbbbbbbbddddddddddddddddddbbbccc
cccmmmddbbbbbbcccccccdddddddddmmcccccbbbbbcccmdddddddddddddddddcccccmddddcccccccccrrdddddddddddbbbbbbbbdddddddddddddddddddbbbccc
ccmmmddddbbbbccccccccddddddddddmmccccbbbbcccmmdddwdddddddddddddcccccmddddccccccccccrdddddddddddbbbbbbbdddddddddddddddddddbbbcccc
ccmmmddddbbbbcccccccccdddddddddmmccbbbbbccccmddddddddddddddddddcccccmdddddmmmccccccccddddddddddbbbbbddddddddddddddddddddbbbccccc
cmmmdddddbbcccccccccccccdddddddmmccbbbbbccrrddddddddddddddddddcccccmmdddddddmmmccccrrdddddddddddbbbddddddddddddddddddddbbbcccccm
cmmmwddddcccccccccccccccdddddddcccbbbbbccccrdddddddddddddddddccccccmddddddddddmmcccrrrdddddddddddddddddddddddddddddddddbbcccccmm
cmmdddddccccccccccccccrdddwddddcccbbbbccccrrrddddddddddddddddccccccmdddddddddddmmcccrrrdddddddddddddddddddddddddddddddbbbccccmmm
cmmddddcccccccccccccrrrdddddddcccbbbbccccccrrrddddddddddddddccccccmmddddddddddddmmcccrrdddddddddddddddddddddddddddddbbbbccccmmmm
cmddddddccccccccccrrrrrdddddddccbbbbcccccccrrrdddddddwddddddccccccmmdddddddddddddmmcccdddddddddddddddddddddddddddmmdbbbccmmmmmmm
cmddddddccccccrrrrrrrrddddddbbbbbbbcccccccccrrrddddddddddddccccccmmddddbbbddddddddmcccddddddddddddddddddddddddddmmmmbbmmmmmmmmmm
cmddddddcccccrrrrrrrrddddddddbbbbbcccccccccccrrrddddddddddccccccmmddddbbbbbdddddddmmcccddddddddddddddddddddddddmmmmmmmmmmmmmmmmm
cmddddddddccrrrrrrrrddddddddddbbcccccccccccccccrdddddddddccccccmmddddbbbbbbbddddddddddddddddddddddddddddddddddddmmmmmmmmmmmmmrrc
cdddddddddccrrrrrrdddddddddddbbbbccccccccccccccccdddddddccccccmmdddddbbbbbbbddddddddddddddddddddddddddddddddwdddcbbmmmmmmmmccrrc
crdddddddddrrdddddddddddccddddbbbcccccccbbbcccccccdddddccccccmmddddddbbbbbbbbddddddddddddddddddddddddddddddddddccbcmmmcccccrrrrc
crrddddddddrdddddddddddccccdddbbbcccccdbbdddmmcccccdddddccccmmdddddddbbbbbbbbddddddddccmmmdddddwdddddddddddddddccccccccccrrrrrrc
crrrdddddddddddddddddddccccddddbbbcccbbbdddddmmccccdddddcdccmmddddddddbbbbbbbbddddddddccmmdddddddddddddddddddddccccccccrrrrrrrrc
crcrdddddddddddddwddddddccccddddbbbcbbbdddddddmmccccddddddddmddddddddddbbbbbbbddddddddcccmmddddddddddddrrrrccccccccccrrrrrrrdrcc
cccrrddddddddddddddddddddccccddddbbbbbddddddddmmmcccdddddddddddddwddddddbbbbbbbddddddddccmmmdddddddddrrrrrrcccccccrrrrrrrrrrdrcc
ccccrdddddcccddddddddddddddccddddbbbbddddddddddmmmccddddddddcdddddddddddbbbbbbbddddddddcccmmmrrrrrrrdrrrrrrrrrccrrrrrrrrrrrrdrcc
cccccrdddcccccddddddddddddddccddddbbddddddddddddmmcccddddddccccdddddddddddbbbbddddddddddcccrrrrrrrrrddddddddddddddwddddddwdddrcc
cccccrrdddccccdddddbbbbddddddccdddddddddddddddddmmccdddddddcccccdddddddddddddddddddddwddcccccdrrrrrrrrrdcrrrdrrrrrdrrrrrrdrrrrcc
cccccrrddddcccdbbbbbbbbddddddddddddddddddwdddddddmdddddddddmmcccccddddddddddddddddddddddcccccccccrrrcrrccrrrdrrrrrdrrrrrrdrrrrcc
ccccccrrdddddddbbbbbbbbbbbbdddddddddddddddddddddddddddddddddmmcccccdddddddddddddddddddddcccccccccrccccccccrrdrrrrrdrrrrrrdrrrrcc
ccccccrrrddddddbbbbbbbbbbbbbdddddddddddddddddddddddddddddddddmmcccccdddddddddddddddddddcccccccccccccccccccrrdrrrrrdrrrrrrdrrrccc
ccccccrrrrrdddddbbbbbbbbbbbbbddddddbddddddddddddddddddddddddddmmcccccddddddddddddddddddccccccccccccccccccccrdrrrrrdrrrrrrdrrrccc
ccccccrrrrrrdddddddbbbbbbcbbbbbbbbbbdddddddddrrrrrrrrrrrdddddddmmmccccdddddddddddddddccccccccccccccccrrcccrrdrrrrrrrrrrrrdrrrccc
cccccccrrrrrrrddddddbbbbccccccbbbbddddddddrrrrrrrrrrrrrrrddddddddmmmccddddddddddddcccccccccccccccccrrrrrrrrrdrrrrrrrrrrrrdrrrccc
cccccccrrrrrrdrrrddddbbbccccccmmmmdddddrrrrrrrrrrrrrrrrrrrrrdddddddmmcddddddddddcccccccccccccccccrrrrrddddddwddrrrrrrrrrrdrrcccc
ccccccccrrrrrrrdrrrddddcccccccmmmddddddrrrrrrrrrrrrrrrrrrrrrrrddddddddddddddddccccccccccccccccccrrrrrrdrrrrrrrrrrrrrrcrrddrccccc
cccccccccrrrrrrrrrrrrccccccccmmdddddrrrrrrrrrrrrrrrrrrrrrrrrrrrrrddddddddccccccccccccccccccccccccccrrrrrrrrrrrrrrrcccccrrrrccccc
cccccccccrrrdrrrrrrrrcccccccrrrrrrrrrrrrrrrrrrrrrrrrrrrrrrrrrrrrrddddddcccccccccccccccccccccccccccccccrrrrrrrccccccccccccccccccc
ccccccccccrrrrrrrrrrrccccccrrrrrrrrrrrrrrrrrrrrrrrrrrrrrrrrrrrrrrrrrrrcccccccccccccccccccccccccccccccccccccccccccccccccccccccccc
"}
