"a" = (/turf/simulated/wall/rock,/area/world/jungle/exterior)
"b" = (/turf/simulated/wall/river,/area/world/jungle/exterior)
"c" = (/turf/simulated/wall/rock/basalt,/area/world/jungle/exterior)
"d" = (/turf/simulated/floor/chasm,/area/world/jungle/exterior)
"e" = (/turf/simulated/floor/colored/jungle_grass,/area/world/jungle/exterior)
"f" = (/turf/simulated/wall/metal/rusted,/area/world/jungle/exterior)
"g" = (/turf/simulated/floor/basalt,/area/world/jungle/exterior)
"h" = (/turf/simulated/floor/colored/dirt/jungle,/area/world/jungle/exterior)
"i" = (/obj/structure/scenery/jungle_grass,/turf/simulated/floor/colored/jungle_grass,/area/world/jungle/exterior)
"j" = (/obj/structure/scenery/jungle_trees,/turf/simulated/floor/colored/jungle_grass,/area/world/jungle/exterior)
"k" = (/obj/structure/scenery/rocks,/turf/simulated/floor/colored/dirt/jungle,/area/world/jungle/exterior)
"l" = (/obj/structure/scenery/jungle_rock,/turf/simulated/floor/colored/jungle_grass,/area/world/jungle/exterior)
"m" = (/turf/simulated/floor/lava,/area/world/jungle/exterior)
"n" = (/turf/simulated/floor/wood/dock,/area/world/jungle/exterior)
"o" = (/obj/structure/scenery/jungle_trees_small,/turf/simulated/floor/colored/jungle_grass,/area/world/jungle/exterior)
"p" = (/turf/simulated/floor/cave_dirt,/area/world/jungle/exterior)
"q" = (/obj/structure/scenery/jungle_grass,/obj/structure/scenery/jungle_grass,/turf/simulated/floor/colored/jungle_grass,/area/world/jungle/exterior)
"r" = (/obj/structure/scenery/rocks,/turf/simulated/floor/cave_dirt,/area/world/jungle/exterior)
"s" = (/obj/structure/scenery/rocks,/turf/simulated/floor/basalt,/area/world/jungle/exterior)
"t" = (/obj/structure/interactive/wishgranter/normal/jungle,/turf/simulated/floor/colored/jungle_grass,/area/world/jungle/village)
"u" = (/obj/structure/scenery/jungle_rock,/turf/simulated/floor/colored/dirt/jungle,/area/world/jungle/exterior)
"v" = (/obj/structure/scenery/rocks,/turf/simulated/floor/colored/jungle_grass,/area/world/jungle/exterior)
"w" = (/turf/simulated/wall/rock,/area/world/jungle/cave)
"x" = (/turf/simulated/floor/cave_dirt,/area/world/jungle/cave)
"y" = (/obj/structure/scenery/rocks,/turf/simulated/floor/cave_dirt,/area/world/jungle/cave)
"z" = (/turf/simulated/wall/river,/area/world/jungle/cave)
"A" = (/turf/simulated/wall/rock,/area/world/jungle/village)
"B" = (/turf/simulated/wall/metal/rusted,/area/world/jungle/village)
"C" = (/turf/simulated/floor/colored/jungle_grass,/area/world/jungle/village)
"D" = (/turf/simulated/floor/colored/dirt/jungle,/area/world/jungle/village)
"E" = (/turf/simulated/floor/basalt,/area/world/jungle/village)
"F" = (/obj/structure/scenery/rocks,/turf/simulated/floor/colored/dirt/jungle,/area/world/jungle/village)
"G" = (/turf/simulated/floor/lava,/area/world/jungle/village)
"H" = (/turf/simulated/wall/rock/basalt,/area/world/jungle/cave)
"I" = (/turf/simulated/floor/chasm,/area/world/jungle/cave)
"J" = (/turf/simulated/floor/basalt,/area/world/jungle/cave)
"K" = (/obj/structure/scenery/rocks,/turf/simulated/wall/rock,/area/world/jungle/exterior)
"L" = (/turf/simulated/floor/lava,/area/world/jungle/cave)
"M" = (/turf/simulated/floor/colored/dirt/jungle,/area/world/jungle/cave)
"N" = (/obj/structure/scenery/rocks,/turf/simulated/floor/colored/dirt/jungle,/area/world/jungle/cave)
"O" = (/obj/structure/scenery/rocks,/turf/simulated/floor/basalt,/area/world/jungle/village)
"P" = (/obj/structure/scenery/jungle_grass,/turf/simulated/floor/colored/jungle_grass,/area/world/jungle/village)
"Q" = (/obj/structure/scenery/jungle_rock,/turf/simulated/floor/colored/jungle_grass,/area/world/jungle/village)
"R" = (/obj/structure/scenery/jungle_rock,/turf/simulated/floor/cave_dirt,/area/world/jungle/exterior)
"S" = (/turf/simulated/floor/asteroid,/area/world/jungle/exterior)
"T" = (/turf/simulated/floor/asteroid,/area/world/desert/cave)

(1,1,1) = {"
wwwwwwwwwwwwwwwwwwwwwwwwwwwwaaaaaaaaaaaaaaaaaaaaaaaaaaaaaaaaaaaaaaaaaaaaaaaabbbbbbbbbbbbbbbbaaeeeeeAAAAAAAAAAAAAAAAAAAAAAAAAAAAA
wwwwwwwwwwwwwHHHHHHHHHHHHHHHaaaaaaaaaaaaaaaaaaaaaaaaaaaaaaaaaaaaaaaaaaaaaaabbbbbbbbbbbbbbbbbbaeeeeeAAAAAAAAAAAAAAAAAAAAAAAAAAAAA
wwwwwwwwwwHHHHHHHHHHIHHHHHHHcaaaaaaaaaaaaaaaaaaaaaaaaaaaaaaaaaaaaaaaaaeeeebbbbbbbbbbbbbbbbbbbbbeeeeBBBBBBBBAAAAAAAAAAAAAAAAAAAAA
wwwwwwwwwHHHHHHIIIIIIIJJJHHHceeeeeeeeeeeeeeeaaaaaaaaaaaeeeeeeeeeeeeeeeeeeebbbbbbbbbbbbbbbbbbbbbeeeeCDOOOOOOOOOOOOOPQPPPPPAAAAAAA
wwwwwwwwHHHHIIIIIIIIJJJJHHHcceeeeeeeeeeeeeeeeeeebbeeeeeeeeeeeiiiiiijeeeeebbbbbbbbbbbbbbbbbbbbbbbeeeCDEEEEOOOOOOEEDQQPPPPPAAAAAAA
wwwwwwwHHHHIIIIIIJJJJHHccccceeeeiiiiiiiieeeeeeebbbeeeeeeeeiiiiiiiiiiiieeebbbbbbbbbbbbbbbbbbbbbbbbeeCDDEEEEEOOEEDFDQPPPPPPCAAAAAA
wwwwwwHHHIIIIIIIJJJJJHHceeeeeeeiijiiiiiieeeeeeeebbbeeeeeeiiiliijiiiiiieebbbbbbbbbbbbbbbbbbbbbbbbbbBBDDDEEEEOEDFFFDQPPPPPPCCCAAAA
wwwwwHHHIIIIIIIJJJJJHHcceeeeeeiiiiiiiiiieeeeeeeebbbbeeeeiiiilliiiiiiiieebbbbbbbbbbbbbbbbbbbbbbbbbbBDDEDEEEOEFFFDCQQPPPPPPCCAAAAA
wwwwHHHIIIIIIIJJJJJJHHceeeeeeiiilliiiiiieeeeeeeeebbbeeeeijiiilliiiiiieeebbbbbbbbbbbbbbbbbbbbbbbbbbBEEEDDEEDFFDDQQQPPPPPPPCCAAAAA
wwwwHHHIIIIIJJJLLJJJHHcgeeeeeijiilliijieeeeeeeeeebbbbeeeeeeiiiliiiiijeeebbbbbbbbbbbbbbbbbbbbbbbbEBBEEEEDDFFFQQQQPPPPPPPPPCCCAAAA
wwwHHHHIIIIJJLLLLJJHHHHgeeeeeiiiiilliiieeeeeeeehhnnnneeeeeeeeiiioeeiieeeebbbbbbbbbbbbbbbbbbbbbbEEBEEDDDDDFDPQPPPPPPPPPPPPPPCAAAA
wwwHHHIIIIIJJLLLJJJHHHHggeeeeiiiiiiliieeeeehhhhhennnnhhheeeehheeeeeeiiieeebbbbbbbbbbbbbbbbbbbbbDDBDDDCCCDDQQQPPPPPPPPPPPPPPCCAAA
wwwHHIIIIIIJLLLLJJJHHHHHggeeeeiiiiiieeeeehhheeeeebbbbeehhhhhhhheeeeeiiiiieebbbbbbbbbbbbbbbbbbbCCCBPCCPPQQQQPPPPPPPPPPPPPPPPPCAAA
wwHHIIIIIIJJLLLMMJJHHHHHHgeeeeiiijeeeeehhheeeeeeebbbbeehhkkkkkhehheeeiiiieeeebbbbbbbbbbbbbbbbbbCCBCPPPPPPPPPPPPPPPPPPPPPPPPPCAAA
wwHHIIIIIIJLLLLMMMJJJHHHHgeeeeeeeeeeeehheeeeeeeeebebbbehhkkkkkkhhhheeeiiiieeeebbbbbbbbbbbbbbbbbbCBCPCPPPPPPPPPPPPPPPPPPPPPCPPCAA
wwHHIIIIIIJLLLMMMMJJJHHHHgghheeeeeeehhheeeeeeeeeebebbbbbhkkkkkkkkkhheeeeiieeeeebbbbbbbbbbbbbbbbbbBCPtCPPPPPPPPPPPPPPPPPPPPPPPCAA
wHHHIIIIIJJLLLMMMMJJJJHHHHghhheeeeehheeeeeeeeiieeeeebbbbhkkhhhhhhhhhheeeeeeeeeeebbbbbbbbbbbbbbbbCBCPPPPPPPPPPPPPPPPPPPPPPPPPPCAA
wHHIIIIIJJJLMMMMMNNMMJJJHHghhheeehhheeeeeiiiiiieeeeebbbbhhhgggggggghhhhhheeeeeeeebbbbbbbbbbbbbbbCBCPPPPPPPPPPPPPPPPPPCCCPPPPPCCA
wwHIIIIJJJMMMMMMMMNNhgggHHghhheehheeeeeeiiiiiiieeeeebbbbhhgmmmgggggeeeeehhheeeeeeebbbbbbbbbbbbbbbBBBBBBCPPPPPPPPPPPPPDDCPPPCPCCA
wwHIIIJJJMMMNMMMMhhkhhhgggghhhehheeeeeeilijiiiieeeeebbbbhgmmmmmmmggeeeeeeehhheeeeeebbbbbbbbbbbbbbbbbbbBBCPPPPPPPPPCPPDDDCPPCPCCA
wHHIIJJJMMNNNMMhhhhkkhhhhhhhhheheeeeeeiilliliiieeeeebbbbggmmmmmmmgggeeeeeeeehhheeeeebbbbbbbbbbbbbbbbbbbBPPPPPPPPPPPPCDFDDPPCPCAA
wHHIJJJMMNNMMhhhhhhhkkhhhhhhhhhheeeeeiiiillliieeeeeebbbbgggmmmmmgggeeeeeeeeeeeheeebbbbbbbbbbbbbbbbbbbbbBBPPPPPPPPPPCCDFFDDPPPCAA
wHHIIJJMNNMhhhhkkkkhhkhhheehhhheeeeeiiiiilliijeeeeebbbbbggggggggggeeeeeeebbbbnnbbbbbbbbbbbbbbbbbbbbbbbbbBBBBCCCCPPPCEEDFFDCPPCAA
wHHJJJJNkhhhhhkkhhkhhhhheeehhhheeeeeiejieeeeeeeeeebbbbbbeegggggggeeeeebbbbbbbnnbbbbbbbebbbbbbbbbbbbbbbbbbbbBBBBBPPPEEEEDFFCPPCAA
wHHHHHMhhhhhhhhhhhhhhhheeeeeeeheeeeeeeeeeeeeeeehhbbbbebeeegggeeeeeeeeeebbbbbbnnbbbbbbeeebbbbbbbbbbbbbbbbbbbbbbbBCPPEEEEEDDDCCAAA
accccchhhhhhhehhhhhheeeeeeeeehheeeeeeeeeeeeeeehhbbbbbeeeeeeeeeeeeeeeeebbbbbbbnnbbbbeeeeeeebbbbebbbbbbbbbbbbbbbbBBCCCEEEEEEDCAAAA
aacccchhkkhheeeeeeeeeeeeeeeehheeeeeeegghhheeehhbbbbbeeeeeeeiiiieeeeebbbbbeeeeehheeeeelllleeeebbbbbbbbbbbbbbbbbbbBBBBBBEEBBBBAGGA
aaahhhhkkhheeeeeeoiiiiiieeeeheeeegggggghhkkhhhbbbbbbeeeeiiiiiiieeebbbbbbeeeelllhheeeeiiiiieeeeeeeeeeebbbbbbbbbbbbeiieegggggggmma
aaahhkkkhheeeeeiiiiliiiieeehheeeggmmgghhkkkhhbbbbeebeeeiiiiiiioeeebbbbbeeelllleehheeeeiiiiiieeeiiiiieebbbbbbbbbbbbeiieeggggmmmma
aaaahhhhheeeeiiiiillioiieehheeeegggmgghkkkhhbbbbeeeeeiiiiiiiieeeeebbbeeeellllleeehhheeeeeiiiieeeiiliieeebbbbbbbbbbbbiiieegggmmma
aaaaahhhggeeeeiijiliiiieehheeeeeegggghhkkhhbbbbbeeeeeioiiiieeeeebbbbbeeeellleeeeeeehhheeeeiieeeeeelliiieeebbbbbbbbbbeiiihhhggaaa
aaaaaggggggeeeeeeeeeeeeeeheeeeebbbghhhhhhhbbbbbeeeeeeeeeeeeeeeebbbbbeeeeeeeeeehhhhhhhhhhheeehhhheeeelliieeebbbbbbbbbiiiihhhhgaaa
aaaaaggggggeeeebbbbbbbbbnnbbbbbbbbbbbbbbbbbbbeeeeeeeeeeeggggeebbbbbbeeeeeehhhhhhhhkkkkkhhhhhhgghhhhhheiiieeebbbbbbbbeeehhehhhgaa
aaaaammmmgggbbbbbbbbbbbbnnbbbbbbbbbbbbbbbbbbbeeeeeeegggggggeebbbbbbeeiiiiihhhhhkkkkhhhhhgghggggggghhheeiieeennnnnnnnnhhheeehhgaa
aaaammmmmmmgbbbbbbbbbbbbnnbbbbbbbeeebbbbbbbbbbbbeeegggghhhhhbbbebbeeiiiiiiieehkkhhhhhhhhggggggmmmgghhheeeeeennnnnnnnneeeeeehhhaa
aaaammmmmmmggbbbbbggggeeeheeeeeeeejeeieebbbbbbbeeeeggghhhhhhbbebbeeiiiiiiiiieeehhhhhhehhgggggmmmmgghhhhhhhhhnnnnnnnnneiioeeehhea
aaaammmmmmmmgggggggggeeeehheeeeiiiiiiieeebbbbbbbbbegghhhhhhbbbbeeeiiiiiiiiiieeeeeeeeeeeeeeggggmmmmggkkheeeeennnnnnnnneeiiieeeeea
aaaammmmmmmmmmmggggeeeeeeehheeeilllliiieeeeeebbbbbbbbbbbbhebbbeeeiiiijiiiiiieeeeiiiiiiiieeeggggmmmggkkkheeeebbbbbbbbbeeiiiiieeea
aaaammmmmmmmmmmggeeeeeeeeeehhheeeeellleeheeeeeebbbbbbbbbbbbbeeeeeiiiiiiiiiieeeiiiiiiiiiiieeeeggggggghkkheeeebbbbbbbbbeeeiiiiieea
aaaammmmmmggggggeeeiiiiiieeeehhheeehhhhhheeheeeeebbbbbbbbbbbeeeeeiiiiiiiiieeeeiiiiiiiiiiieeeeeeeeehhhkkkheeebbbbbbbbbbeeeeiiieea
aaaammmmmmgggggeeeiiiiiiiieeeeehhhhhkkkhhhhheeeebbbbbebbbbbbbbbeeeoiiiiiioeeeeeeeeeeeeeeeeeeeeiieeeehhkkheeebbbbbbbbbbbbeeiiiiea
aaaagmmmgggghhheeeiillioiiiieeeeehhkkkkhhheeeebbbbbbbeeeebbbbbbbbbeeeeeeeebbbbbbbbbbbbbbbbbbeeeiiiieehhkkheebbbbbbbbbbbbbbeiiiea
aaaaggggghhhhhheeiiiilliiiiiiieeeehhhhheeheeeebbbbbbbeeeeeeebbbbbbbeeeeebbbbbbbbbbbbbbbbbbbbbbeeeiiieehhhheebbbbbbbbbbbbbbbeoiea
aaahgghhhhhhhheeeiioiillliiiiieeehhhgggggheeebbbbbbeeeeiiieeebbbbbbeeeebbbbbbbbbbbbbbbbbbbbbbbbbeeeiieeeeeeebbbbbbbbbbbbbbbeiiea
aaahhhhhhhhhheeeeiiiilliiiiiiiieehgggggggheebbbbbbeeeeeiiiieeeebbbbeebbbbbbbbeeeeeeeeeeeebbbebbbbbbeeiieeeeebbbbbbbbbbbbbbbeeiea
aaaehhhhhheeeeeeeeiiiiiiiijeiiiiehggggggghnnnnnneeeeeeeioeeeeeeeeebbbbbbbbbbeeeeeeeeeieeeeeeeebbbbbbeeiiiieebbbbbbbbbbbbbbbeeeea
aaaeeeeeeeeeeeeeeeeeeeeeeeeeeiiieeeeeeggehnnnnnnhheeeeegeeeeeeiieebbebbbbbeeeeeeeeeeeiiieiioeeeebbbbbeeiiiiebbbbbbbbbbbbbbbbeeea
aaaeeoiiieeeeeeebbbbbbbbebbeeeiieeeeeeeeebbbbbeeehhegggggeeeeeiiobbbbbbbbbeehhhheeeeejiiiiiiiieeebbbbeeeeeiebbbbbbbbbbbbbbbbbeaa
aaaeeiiilleebbbbbbbbbbbbbbbbeeeeeeeeebbeebbbeeeeeehhgggggeggeeiiebbbbbbbbeeehhkkhheeeeiiioiiliieeeebbbbeeeieebbbbbbbbbbbbbbbbbaa
aaaeiilllebbbbbbeeeeeeebbbbbbeeeeebbbbbbbbeeeeiieeehgggggggggeiiebbbbbbbeehhhhhkkhheeeeeiiiilliieeeebbbbbeeeebbbbbbbbbbbbbbbbaaa
aaaiilleebbbbbeeeeeeeeeeeeebbbbbbbbbbbbeeeeeeiiieehhggggmmmggeeeeebebbbbehhhhgghhhhheeeeeiiiilliijeeebbbbbbbbbbbbbbbbbbbbbbbaaaa
aaaeeleebbbbeeeeoiieeeeeeeeeebbeebbbbbbeeeiiiiieehhhhhmmmmmggeeeeebbbbbbhhkkhgggghhhheeeeeeiiiiiiieeeeebbbbbbbbbbbbbbbbbbbbbaaaa
aaaeeeebbbeeeeiiilllllleeeeeeeeeeebbbbbbeeiiiijehhhhhmmmmmmmgeeeeebbbbbbbhhkhhggggggghggeeejiiiiiiieeeeeebbbbbbbbbbbbbbbbbbaaaaa
aaaaebbbbeeeiilllleeeeeeeeeeeeeeeebbbbbbeeeiiieehhhhhmmmmmmggeeeeeebbbbbbbhkkhggmmgggggggeeeeeiioiiieeeeeeebbbbbbbbbbbbbbbbaaaaa
aaaabbbbeeeiilleeeehhhheeeeeeeeeeebbbbbbeejiiiiehhhhhmmggggggeeiieeeennnnnnhkkhggmmgmmggeeeeeeeiiiiiioeeeeeeebbbbbbbbbbbbbbaaaaa
aaaaaeeeeiiiileehhhhehheeeeeeebbbbbbbbbbbeeeiiiehhhhhhgggggeeeeiiieeennnnnnhhhhgggmmmmmggeeeeeiiiiiiiieeeeeeebbbbbbbbbbbbbbbbaaa
aaaaaaeeiiioeehhhkkhhhheeeeeebbbbbbbbbbbbeeeeeeeehhhhhggggeeeeejiiiieebbbbbbhhhhggggmmmmggeeeeeiiiilliiieeeeeeebbbbbbbbbbbbbbaaa
aaaaaaeeeeeeehhkkkkhhheeeeeebbbbbbbbbbbbbbeeeeeeeehhhhgggeeeeeeeiiiieeebbbbbbhhhhhhggggggggeeeeeiiillliiieeeeeebbbbbbbbbbbbbbbaa
aaaaaaeeeeeehhkkkkkhheeeeeeebbbbbbbbbbbbbbbeeeeeeeeeehhhhhhhhhheeiiieeeebbbbbbbhhhhhghhgggggeeeejiiilliiiijeeeebbbbbbbbbbbbbbbba
aaaaaaeeeehhhkkkkkkheeeeeeebbbbbbbbbeebbbbbbbbeeeeeeeeeeehhhhhhheeeeeeeebbbbbbbbbhhhhhhhhhhheeeeeiiiiiiiiiieeeebbbbbbbbbbbbbbbba
aaaaaeeeehhhkkkkkhhheeeeeeebbbbbbbbeeeebbbbbbbbbbeeeeeeeeeeeeehheeebbbbbbbbbbbbbbbhhhhhhhhhhheeeeeiiiiioiiieeeebbbbbbbbbbbbbbbba
aaaaaeeehhhkkkkkhhheeeeeeebbbbbbbbbeeeeeebbbbbbbbeeeeeeeeeeeeeennbbbbbbbbbbbbbbbbbbhhhhhhhkhheeeeeiiiiiiiiieeeebbbbbbbbbbbbbbbaa
aaaaaeehhhhkkkkhhheeeeeeeebbbbbbbbeeiiieeebbbbbbbbbbbeeeeeeebbbnnbbbbbbbbbbebbbbbbbbbbhhhhkhhheeeejiiilliiioeeebbbbbbbbbbbbbbaaa
aaaccegggghkkhhheeeeeeeeebbbbbbbbbeeiijieeeebbbbbbbbbbbbbbbbbbbnnbbbbbbbbeeeeebbbbbbbbbbhhkkhhheeeeiiillliiieeebbbbbbbbbbbbbbaaa
aaaccegggghhhhggggeeeeeeebbbbbbbbeeiiiiieeeeeebbbbbbbbbbbbbbbbbnnbbbbbeeeeeeeeebbbbbbbbbbhhkkhheeeeeiiillliieeebbbbbbbbbbbbbaaaa
aacccgggggggggggggeeeeeebbbbbbbbbeeiiiiieeggggeeebbbbbbbbbbbbbbnneeeeeeeeeeiiiiebbbbbbbbbhhhkhhheeeeiiiilliiieebbbbbbbbbbbbaaaaa
aacddgggmmmgggggggeeeeeebbbbbbbbbeiiiiiegggggggeeeeeebbbeeeeeeehheeeeeeeeeeiiiiiieeeebbbbbhhkkhheeeeeiiiiiiiieeebbbbbbbbbbbaaaaa
accdddgmmmmmgggggeeeeeebbbbbbbbbbeijiieeggggggghhhhebbbbeeeeeeehhehhheeeeiiiillliiieeebbbbhhhkkhheeeeiiiiiiiieeebbbbbbbbbbaaaaaa
accdddgmmmmgggggeeeeeeebbbbbbbbbbeeiiieggggggghhhhhebbbbeeeeeeehhhhheeeeeeeeiiillliiieebbbbbhhhhhheeejiiiiiiieeebbbbbbbbbbaaaaaa
accdddgmmmmggggeeeeeeebbbbbbbbbbeeeiieegggggghhhhhhhnnnnhheeeeehhhhhhhhhheeeeeeiiiiiieeebbbbbbhhhheeeeiilijiieeebbbbbbbbbbaaaaaa
accdddggggggeeeeeijeeebbbbbbbbbbbeeeeeeggggghhhhheeennnnehhhhhhhhhhggggghhhheeeeeeeiieeebbbbbbbhhheeeeilliieeeeebbbbbbbbbbbaaaaa
accddddggggeeeeeiiieebbbbbbbbbbbbeeeeeegggghhhheeeeebbbbbeeehhhhhhhgggggggghhhheeeeeeeeeebbbbbbbhheeeeilllieeeeebbbbbbbbbbbbaaaa
accddddggggeeeiiiiieebbbbbbblbbbbbeeeeeeggeeeeeeeeeebbbbbeehhhhhhhhggggggggggghhhhheeeeeeebbbbbbbheeeeilllieeeeebbbbbbbbbbbbaaaa
accddddggeeeeiilliieebbbbblllbbbbbeeeeeeeeeeeeeeeeeeebbbeeeheeeeeheegggggggggggghhhhhhhheebbbbbbbhheeeilllieeeeeebbbbbbbbbbbaaaa
aacdddddgeeeeiiliieebbbbbljlllbbbbbbeeeeeeeeeebbbbbbbbbbeeeeeeeeeeeeeeeggggggggghheeeeehhhhnnnnnhheeeeiillieeeeeebbbbbbbbbbbbaaa
aaccddddggeeeillieeebbbbblllllbbbbbbbbeeeebbbbbbbbbbbbbbeeeeeeiiiiieeeeeeeeehhhheeeeeeeeeeennnnnhheeeeeiliiijeeeebbbbbbbbbbbbaaa
aaccdddddgeejiliieebbbbblllljlbbbbbbbbbbbbbbbbbbbbbbebbbbeeeeeiiiiiiiiiiieeehhheeeeeeeeeeebbbbbeeheeeeeeiiiiieeeebbbbbbbbbbbbbaa
aacccdddggeeiilieeebbbbbljlllbbbbbbbbbbbbbbbbbbbbbbeeebbbbbeeeeeiillliiiiiieeeeeeeeeeeeebbbbbboeehheeeeeiiiiiieeebbbbbbbbbbbbbaa
aaccccccgeeiiiiieeebbbbbbbllbbbbbbbbbbbbbbbbeeeeeeeeeeebbbbbbbeeeeiillliiiieeeeeeeeeeeebbbbboeeeeeheeeeiiiiliiieebbbbbbbbbbbbbaa
wwwxccccgeiiiiiieebbbbbbbbbbbbbbbbbbbbeeeeeeeeeeeeeeeeeebbbbbbbbbeeeeeeeeeeeeeeeeeeeeebbbbboeeeeeeheeeeiiilliiieebbbbbbbbbbbbbba
wwxxxxaceeiiiiieeebbbbbbbbbbbbbbbeeeeeeeeeeeeeeeeeeiiieeebbbbbbbbbbbbbbbbbbbbbbbeeeeebbbbboejeiieeheeeiiiiliiiieebbbbbbbbbbbbbba
wwxxxwaceiiliieeeebbbbbbbbbbbbeeeeeeeeeeeeeeeeeeeeiieiieeebbbbbbbbbbbbbbbbbbbbbbbbbbbbbbboeeeiieehheeeiiiiliiijeebbbbbbbbbbbbbba
wwxxxwaejillieeeeebbbbbbbbbbeeeeeeeeeeegggggggggeeeeeeieeeeeeeeeeebbbbbbbbbbbbbbbbbbbbbbjeeiiiehhhheeeejiiiieeeeebbbbbbbbbbbbbba
wxxxwwaeiiliieeeeebbbbbbbbbeeeeeeeeeeegggggmgggggggggeeeeeeeeeeeeeeeeebbbbbbbbbbbbbbjeoiqiiiehhheehheeeeeeeeeehhhebbbbbbbbbbbbba
wxxxwaaiillijeeeebbbbbbbbbbeeeeeeeeeggccccgmmgggccccggggeeeeeeeeeeeeeeeebbbbbbbbbbjeeiiliiehhheeeeehheeeehhhhhhehhbbbbbbbbbbbbba
wxxwwaeiiliieeeeebbbbbbbbbeeeegggggggccggggmmmggccgggggggggeeeeeeeeeejeejbbbbbbbeeejillliehheeeeeeeehhehhheeeeeeeebbbbbbbbbbbbba
wxxwwaaiiiiieeeebbbbbbbbbeeeeeegggggggggggggmgggggggmmmmgggggeeeeeeiiiieeeeeebbbbjeillqiehheeeejiioeehhheeeeeeeeeebbbbbbbbbbbbba
wxxxwwaeeeeeeeeebbbbbbbeeeeiiieegggggggmmggggggggggmmmgmgggggggeeeeiiiiiieeeeebbbeillqiehheeeoiiiiieehheeeefffffnnnnnbbbbbbbbbba
wxxxwwwwwweeeeeebbbbbbeeeeiiiieeggmmggmmmggggggmmggmmmmmggggcgggeeeeeiiiiiijeebbbboiiieeheeeiiiiiiieeheeeeefeeeennnnnbbbbbbbbbaa
wxxxxxyyxweeeeeebbbbeeeeeeiiieegggmmggmmmggcgmmmmggggmmgggccccgggghheeiiiiiieejbbbbiieehhejiiiiiiiieehheeeefeeeennnnnbbbbbbbbbaa
wxxxxyyxwwppebnnbbeeeeeeeeeeeeegggmmggggggccgmmmmgcggggggggcccggehhhheeeiiiiieebbbbieeehheiiiiiiiioeehheeeefeeefnnnnnbbbbbbbbaaa
wwxxyywwwxppbbnnbeeeeeeeeeeeeeeegggmgggggcccgmmmmgcccggssssssssghhhhhheeeiiiieebbbbbeeeeheiiliiiiieeeheeeeefeeefnnnnnbbbbbbbaaaa
wwxxywwxxxpbbbnnbeeeeeeeeehhhhhhhgggggggggccggggggscgssssssskkkhhhhhhhhheeiiiieebbbbeeeehheilliiieehhheeeeefeeeennnnnbbbbbbaaaaa
wwxyywwxxxxbbbnneeeeeiiieehhhhhehkkkkkkkksgggggggsgsgkkkkkkkkkhhhhhhhhhhheiiiiieebbbbeeeeheeilijehhheeiieeefeeeennnnnbbbbbbbaaaa
wwxyywxxxxzbbbnneeejiijiiehhhehhhkkkkkkkkkkkkkkkkkkkkkkkkkkkkhheeeehkkhhheeiiiieebbbbjeeehheeeeehheeeeeiieeeeeefnnnnnbbbbbbbbaaa
wwxxxxxxxzzzbbeeeeiiiiiiiieehhhhhhkssssskkkkkkkkkkkkkkkkkkhhhhheeeehkkkhhheeiiijeebbbboeeehhehhhhheeeeeiiieeeeefnnnnnbbbbbbbbaaa
wwwxxxxxzzzzzeeeeiiiilllliieeeeeeggggcccccgggggggggggkkhgccgghheeeehkkkkhhheiiiieebbbbeeieehhheeehheeeellieeeeeennnnnbbbbbbbbaaa
wwxxxxxzzzzzzaaeeiillllliiiieeeeeggccccccgggggmmmmmmgggggcccgheeeeehkkkkkhheeiiiejbbbbeeieeeeeeeeehheeelllieeeeennnnnbbbbbbbbbaa
wwxxxxxzzzzwwwaeiillllliiiiiieeeggggggggggggggmmmmmmgggggggghheeeeehhkkkkhheeiiieebbbbeeiieeeellleeheeiilllfffffnnnnnbbbbbbbbbaa
wxxxxxzzzzwwwwaeiiiiiillijiiiieeeegggegghhhgggggmmmgggghhggghheeeeeehkkkkhhheeiieeebbbffeiffffffleehhijeeilllliilhbbbbbbbbbbbbba
wxxxxzzzzwwwwwaeeiiiiiilliilliieeeeeeeeehhhhgccgmmmggghhhhhhheeeeeeehkkkkkhheeeeeeebbbfliiiiiiifleeeheeeeeillliilhbbbbbbbbbbbbba
wxxxxzzzzwwwwwaeeiiiiiiilillliieeeeeeeeehhhhgccgmmgggghhhhheeeeiieeehhkkkkhheeeeeeebbbflleiiiihfeeeehheeeeeeiiiiihbbbbbbbbbbbbba
wxxxxzzzwwwwwwaaeeiiijiilllliiiiieeeeeeehhhgggggggggghhhheeeeeiiieeehhkkkkhheeeeeebbbefllllihhhfeeeeeheeeeeeoiliihbbbbbbbbbbbbba
wxxxxzzwwwwwwwaeeeeiiiiilllliiiijieeeeeeehhgghhhghhhhhhheeeeeiiiieeehhkkkkheeeeeeebbbefllllihhhfeeeeeheeeeeeeiillhbbbbbbbbbbbbba
wxxxxzwwwwwwwwaeeeeeiiilllliiiiiiiieeeeeehhhhhhhhhghhhhheeeeeieiiieeehhkkhheeeeeebbbjeffffffffffeeeeeheeeeeeeeelhhbbbbbbbbbbbbaa
wxxxxwwwwwwwwaaeeeeeeiiilliiiiiiiiieeeeeeeeeehhhhhhheeeeeeeeiiiiiieeehhhhhheeeeeebbbiiiiillllllfeeeeeheeeeeeeeeehhbbbbbbbbbbbbaa
wxxxxwwwwwwaaaeeeeeeeeeiiiiiijiiiiiieeeeeeeeeeeeeeeeeeeeeeeeiiiiiieeehhhhheeeeeebbbbiiiliieeeehhhhehhheeeeeeeeeehhbbbbbbbbbbaaaa
wxxxxxwwwwwaeeeeeeeeeeeeeeiiiiiiiiiieeeeeeeeeeeeeeeeeeeeeeeiiiiiiieeeeeehheeeeebbbbiiliieiehhhheehhheeeeeeeeeeeehbbbbbbbbbbaaaaa
wxxxyywwwwaaehhhheggggeeeeeeeeeiiiiieeeeeeeeeeeiiiiiiieeeeiiiiijiieeeeeeeeeeeeebbbiiiiiiiiehellfeeeeeeeeeeeeeeeehbbbbbbbbbaaaaaa
wxxxxywwwwahhhhhgggggggggeeeeeeeeeeeeeeeeeeeeeeiilliiiiiieiiiiiiiieeeeeeeeeeebbbbefffffiiehhfffffffffffiijeeeeelhbbbbbbbbaaaaaaa
wxxxxyxwwwahhhhhkkggmmmmgggeeeeeeeeaaaaaaaaaaeeiiiliiiiiiiijiiiiiieeeeeeeeeeebbbeefiiiiiiehefiiiiiiiilfiiiiiolllhbbbbbbbbaaaaaaa
wxxxxyywwwaehhhhhkkgggmmmgggeeeeeaaawwwwwwaaaeeeiilliiiiiiiiiiiiiieeeeeeeeeebbbjeefiiiiieehefhhiiiiiilfiiiiiiiihhbbbbbbbpaaaaaaa
wwxxxxywwwaaehhhhhkkkggmmmggeeeeeawwwywyywwwaaeeiiilijiillllllllliieeeeeeeeebbbeeefiiifieeheehhhhijiilfiiiillhhhhbbbbbbbppaaaaaa
wwwxxxyywwwaaahhhhhhkkggmmmggeeeaawyyyyyxxxwaaeeeiiiiiiiliiiiililiieeeeeeeeebbbeeefiihfieeheeeeehhiiilfllollhhhhhbbbbbbhhpppaaaa
wwwxxxxywwwwaaehhhhhhkkgggggggeeaawyyyxxxxxwwaeeeeiiiiiiliiiiillliieeeeeeeeebbbeeefihhfieehefellehiillfllllhhhkhbbbbbbbbhhhppaaa
wwwxxxxxyyywwaaehhhhhhkkggggggeeaawwyyxxxxwwwaeeeeeeiijilliiiillliiieeeeeeeebbbbbefhhhfiehhlfllllllillflllhhhkkhbbbbbbbbbbhhppaa
wwxxxxxxxxywwaaaaaahhhhkkkggheeeeaawwwxxxxwwwaeeeeeeeiiiilljiillliiieeeeeeeeebbbbeffffflehelflllllllllflluhhkkkbbbbbbbbbbbbSSSTT
wwxxxxxxxxxxwwaaaaaaahhhhhhehheeeeaaawxxxxxwwaaaeeeeeeeiiillilliiiiiieeeeeeeebbbbbblllllehelfffffffffffbbbbhbbbbbbbbbbbbbbbeSSTT
wwxxxxxxxxxxxwwwwaaaaehhhhhhheeeeeeawwxxxxxxwwwaaeeeeeeeeeillliiijiiiieeeeeeeebbbbbbbbeeehellllbbbbbbbbbbbbbbbbbbbbbbbbbbeeeeSTT
wwwwxxxxxxxxxxxxwwaaaeeeeeheeeeeaaaawwxxwxxxxwwwaeeeeeeeeeeeeeiiiieeeeeeeeeeeebbbbbbbbbbnnbbbbbbbbbbbbbbbbbbbbbbbbbbbbbeeeeeppTT
wwwwwxxxxxxxxxxxxwaaaaeeeeeeeeaaaawwwxxxwxxxxxwwaaaaaaeeeeeeeeeeeeeeeeeeeeeeeeebbbbbbbbbnnbbbbbbbbbbbbbbbbbbbbbbbbbhhheeeeeppaaa
wwwwxxxxxxxxxxxxxwwwwaaeeeeeaaaawwwxxxxwwxxxxxwwwwwwwaaeeeeeeeeeeeeeeeeeeeeeeeeebbbbbbbbnnbbbbbbbbbbbbbbbbbbbbeehhhhheeeehppaaaa
wwwxxxxxxxxxxxxxxwxxwwaaaaeaaawwwxxxxxwwwwxxxxxxwwwwwwaaaaeeeeeeaaaaaaaaaeeeeeeeeeebbbbbnnbbbbbbeeebbbbbeeeeeeeeeeeeeeeepppaaaaa
wwxxxxxxxxxxxxxxxxxxxwwwwaaaawwxxxxxxxwwwwwwxxxxxxwxxwwwwaaaeeeaawwwwwwwaaeeeeeeeeaaaaeeehheeeeeeeeeeeeveeeeeeeeeeeeeeeppaaaaaaa
wwxxxxyywwwwwwxxxxxxxxwwwwwwwxxxxxxxxwwwwwwwwwxxxxxxxxxxxwwaaaaawwxxxxxwwaeeeeeeeaaaaaaeeehheeeeeepprrraaaaeeeeeeeeeepppaaaaaaaa
wwwwyyywwwwwwwwwwxxxxxxxxxxxxxxxxxwwwwwwwwwwwwwxxxxxxxxxxwwwwwwwwxxxxxxxwaaaaaeaaaaaaaaaaeehhhhhppppraaaaaaallllllepppaaaaaaaaaa
wwwwyyywwwwwwwwwwwwwwwwxxxxxxxwwwwwwwwwwwwwwwwwwxwxxxxxxxxxxxxxxxxxxxxxxwaaaaaaaaaaaaaaaaaaehheaapppraaaaaaaRpppppppaaaaaaaaaaaa
wwwwwwwwwwwwwwwwwwwwwwwwwwwwwwwwwwwwwwwwwwwwwwwwwwwwwwwwwwwwwwwwwwwwwwwwwaaaaaaaaaaaaaaaaaaaaaaaaaaaKaaaaaaaaaaaaaaaaaaaaaaaaaaa
"}
