"a" = (/turf/simulated/wall/rock,/area/world/caves/cave)
"b" = (/turf/simulated/floor/cave_dirt,/area/world/caves/cave)
"c" = (/turf/simulated/wall/cult,/area/world/caves/cave)
"d" = (/turf/simulated/floor/cult,/area/world/caves/cave)
"e" = (/turf/simulated/wall/rock,/area/world/caves/exterior_unsafe)
"f" = (/turf/simulated/floor/colored/dirt/cave,/area/world/caves/cave)
"g" = (/turf/simulated/wall/rock,/area/world/caves/exterior)
"h" = (/turf/simulated/wall/wood/brown,/area/world/caves/cave)
"i" = (/turf/simulated/floor/wood/brown,/area/world/caves/cave)
"j" = (/turf/simulated/wall/diona,/area/world/caves/exterior)
"k" = (/turf/simulated/floor/colored/dirt/cave,/area/world/caves/exterior)
"l" = (/turf/simulated/floor/cave_dirt,/area/world/caves/exterior)
"m" = (/turf/simulated/wall/river,/area/world/caves/exterior_unsafe)
"n" = (/turf/simulated/floor/colored/dirt/cave,/area/world/caves/exterior_unsafe)
"o" = (/turf/simulated/wall/river,/area/world/caves/cave)
"p" = (/turf/simulated/floor/cave_dirt,/area/world/jungle/exterior)
"q" = (/turf/simulated/wall/river,/area/world/jungle/exterior)
"r" = (/turf/simulated/floor/colored/grass,/area/world/caves/exterior)
"s" = (/turf/simulated/floor/wood/dock,/area/world/caves/exterior_unsafe)
"t" = (/turf/simulated/floor/cave_dirt,/area/world/caves/exterior_unsafe)
"u" = (/turf/simulated/floor/cult,/area/world/caves/exterior_unsafe)
"v" = (/turf/simulated/floor/diona,/area/world/caves/exterior)
"w" = (/turf/simulated/wall/diona,/area/world/caves/cave)
"x" = (/turf/simulated/floor/colored/dark_grass,/area/world/caves/exterior_unsafe)
"y" = (/obj/structure/scenery/grass,/turf/simulated/floor/colored/dark_grass,/area/world/caves/exterior_unsafe)
"z" = (/obj/structure/scenery/grass,/turf/simulated/floor/colored/grass,/area/world/caves/exterior)
"A" = (/obj/structure/scenery/evergreen,/turf/simulated/floor/colored/grass,/area/world/caves/exterior)
"B" = (/obj/structure/scenery/rocks,/turf/simulated/floor/colored/dirt/cave,/area/world/caves/exterior_unsafe)
"C" = (/obj/structure/scenery/rocks,/turf/simulated/floor/cave_dirt,/area/world/caves/cave)
"D" = (/obj/structure/scenery/rocks,/turf/simulated/floor/cave_dirt,/area/world/caves/exterior)
"E" = (/obj/structure/scenery/rocks,/turf/simulated/floor/cave_dirt,/area/world/jungle/exterior)
"F" = (/obj/structure/scenery/evergreen,/turf/simulated/floor/colored/dark_grass,/area/world/caves/exterior_unsafe)
"G" = (/obj/structure/interactive/wishgranter/normal/caves,/turf/simulated/floor/colored/grass,/area/world/caves/exterior)
"H" = (/obj/structure/scenery/grass,/obj/marker/mob_spawn/cult/cultist,/turf/simulated/floor/colored/dark_grass,/area/world/caves/exterior_unsafe)
"I" = (/obj/marker/mob_spawn/cult/artificer,/turf/simulated/floor/cult,/area/world/caves/exterior_unsafe)
"J" = (/obj/marker/mob_spawn/cult/cultist,/turf/simulated/floor/cult,/area/world/caves/exterior_unsafe)
"K" = (/obj/marker/mob_spawn/cult/master,/turf/simulated/floor/cult,/area/world/caves/exterior_unsafe)
"L" = (/obj/marker/mob_spawn/cult/behemoth,/turf/simulated/floor/cult,/area/world/caves/exterior_unsafe)
"M" = (/obj/structure/scenery/grass,/obj/marker/mob_spawn/cult/behemoth,/turf/simulated/floor/colored/dark_grass,/area/world/caves/exterior_unsafe)
"N" = (/obj/marker/mob_spawn/cult/cultist,/turf/simulated/floor/cult,/area/world/caves/cave)

(1,1,1) = {"
aaaaaaaaaaaaaaaaaaaaaaaaaaaaaaaaaaaaaaooooaaaaaaaaaaaaaaaaaaaaaaaaaaaaaaaaaaaaaaaaaabbbbbaaaaaaaaaaaaaaaaaaaaaaaaaaaaaaaaaaaaaaa
aaaaaaaaaaaaaaaaaaaaaaaaaaaaaaaaaaaaaaooooaaaaaaaaaaaaaaaaaaaaaaaaaaaaaaaaaaaaaaaabbbbbbbCCaaaaaaaaaaaaaaaaaaaaaaaaaaaaaaaaaaaaa
aaaaaaaaaaaaaaaaaaaaaaaaaaaaaaaaaaaaaaoooooaaaaaaaaaaaaaaaaaaaaaaaaaaaaaaaaaaaaaabbbbbbbbbCCaaaaaaaaaaaaaaaaaaaaaaaaaaaaaaaaaaaa
aaaaaaaaaaaaaaaaaaaaaaaaaaaaaaaaaaaaaaoooooaaaaaaaaaaaaaaaaaaaaaaaaaaaaaaaaaaaaaabbbbbbbbbbbCCCaaaaaaaaaaaaaaaaaaaaaaaaaaaaaaaaa
aaaaaaaaaaaaaaaaaaaaaaaaaaaaaaaaaaaaaaooooooaaaaaaaaaaaaaaaaaaaaaaaaaaaaaaaaaaaaabbbbbbbbbbbbbCCCaaaaaaaaaaaaaaaaaaaaaaaaaaaaaaa
aaaaaaaaaaaaaaaaaaaaaaaaaaaaaaaaaaaaaaooooooaaaaaaaaaaaaaaaaaaaaaaaaaaaaaaaaaaaaCbbbbbbbbbbbbbbbbCaaaaaaaaaaaaaaaaaaaaaaaaaaaaaa
aaaaaaaaaaaaaaaaaaaaaaaaaaaaaaaaaaaaaaooooooaaaaaaaaaaaaaaaaaaaaaaaaaaaaaaaaaaaaCbbbbbbbbbbbbbbbbCCaaaaaaaaaaaaaaaaaaaaaaaaaaaaa
aaaaaaaaaaaaaaaaaaaaaaaaaaaaaaaaaaaaaaaoooooaaaaaaaaaaaaaaaaaaaaaaaaaaaaaaaaaaaaCCCbbbbbbbbbbbbbbbCCaaaaaaaaaaaaaaaaaaaaaaaaaaaa
aaaaaaaaaaaaaaaaaaaaaaaaaaaaaaaaaaaaaaaaoooooaaeeeeeeeeeeeeeeeeeeeeeeaaaaaaaaaaaCCCCbbbbbbbbbbbbbbbbaaaaaaaaaaaaaaaaaaaaaaaaaaaa
aaaaaaaaaaaaaaaaaaaaaaaaaaaaaaaaaaaaaaaaoooooomeeeeeeeeeeeeeeeeeeeeeeaaaaaaaaaaaaCCCCbbbbbbbbbbbbbbbaaaaaaaaaaaaaaaaaaaaaaaaaaaa
aaaaaaaaaaaaaaaaaaaaaaaaaaaaaaaaaaaaaaaaoooooomBnneeeeeeeeeeeeeeeeeeeaaaaaaaaaaaaaCCCCCCbbbbbbbbbbbbabaaaaaaaaaaaaaaaaaaaaaaaaaa
aaaaaaaaaaaaaaaaaaaaaaaaaaaaaaaaaaaaaaaaoooommmBxnnneeeeeeeeeeeeeeeeeaaaaaaaaaaaaaaaaCCCCCCCCbbbbbbbbbbaaaaaaaaaaaaaaaaaaaaaaaaa
aaaaaaaaaaaaaaaaaaaaaaaaaaaaaaaaaaaaaaaaaoommmmByyynnneeeeeeeeeeeeeeeaaaaaaaaaaaaaaaaaaaaCCCCCCCCCCbbbbbbaaaaaaaaaaaaaaaaaaaaaaa
aaaaaaaaaaaaaaaaaaaaaaaaaaaaaaaaaaaaaaaaammmmmmBxxyyynnneeeeeeeeeeeeeaaaaaaaaaaaaaaaaaaaaaaaaaaaaaCCabbbbbaaaaaaaaaaaaaaaaaaaaaa
aaaaaaaaaaaaaaaaaaaaaaaaaaaaaaaaaaaaaaaaammmmmmBxxxxyyynnnneeeeeeeeeeaaaaaaaaaaaaaaaaaaaaaaaaaaaaaaaaabbbbbCaaaaaaaaaaaaaaaaaaaa
aaaaaaaaaaaaaaaaaaaaaaaaaaaaaaaaaaaaaaaeemmmmmmBBxxxxyyyyynnneeeeeeeeaaaaaaaaaaaaaaaaaaaaaaaaaaaaaaaaaabbbbCCaaaaaaaaaaaaaaaaaaa
aaaaaaaaaaaaaaaaaaaaaaaaaaaaaaaaaaaaaaaeeemmmmmmBxxxxxxxyyyynnneeeeeeaaaaaaaaaaaaaaaaaaaaaaaaaaaaaaaaaaabbbbCaaaaaaaaaaaaaaaaaaa
aaaaaaaaaaaaaaaaaaaaaaaaaaaaaaaaaaaaaaaeeemmmmmmBxxxxxxxxxyyyynneeeeeaaaaaaaaaaaaaaaaaaaaaaaaaaaaaaaaaaaabbbCCaaaaaaaaaaaaaaaaaa
aaaaaaaaaaaaaaaaaaaaaaaaaaaaaaaaccccccceeeemmmmmBBxxxxxxxxxyyyyneeeeeaaaaaaaaaaaaaaaaaaaaaaaaaaaaaaaaaaaaabbbCaaaaaaaaaaaaaaaaaa
aaaaaaaaaaaaaaaaaaaaaaaaaaaaaaaacddNdNceeeemmmmmmBxxFxxxxxxxyyynneeeeaaaaaaaaaaaaaaaaaaaaaaaaaaaaaaaaaaaaaabbCCaaaaaaaaaaaaaaaaa
cccccccccccccccccccccccccccccccccdddddceeeemmmmmmBxxxxxxxxxxxyyynneeeaaaaaaaaaaaaaaaaaaaaaaaaaaaaaaaaaaaaaabbbCaaaaaaaaaaaaaaaaa
cddddddddddddddddddddddddddddddddddddNceeeemmmmmmBxxxxxxxxxxxxyyyneeeaaaaaaaaaaaaaaaaaaaaaaaaaaaaaaaaaaaaaaCbbCaaaaaaaaaaaaaaaaa
cdcccccccccccccccccccccccccccccccdddddceeeemmmmmmBxxxxxxxFxxxxxyyneeeaaaaaaaaaaaaaaaaaaaaaaaaaaaaaaaaaaaaaaCbbCaaaaaaaaaaaaaaaaa
cdcuuuuuuuuuuuuuuuuuuuuuuuuuuuuucdddddceeeyBmmmmmBxxxxxxxxxxxxxyyneeeaaaaaaaaaaaaaaaaaaaaaaaaaaaaaaaaaaaaaabbbCCaaaaaaaaaaaaaaaa
cdcuyyyuyyyyyyyyyyyuuyyyyyyyyyyucccdccceeeyBmmmmmBxxxxxxxxxxxxxxyneeeaaaaaaaaaaaaaaaaaaaaaaaaaaaaaaaaaaaaabbbbbCaaaaaaaaaaaaaaaa
cdcuyyyuyyyyyyyyyyyuuyyyyyyyyyyuuucdceeeexyBmmmmmBxxxxxxxxxxxxxxynneeaaaaaaaaaaaaaaaaaaaaaaaaaaaaaaCCCCCCbbbbbCCaaaaaaaaaaaaaaaa
cdcuyyyuyyyyyyyyyyyuuyyyyyyyyyyyyucdceeeeyyBmmmmmBxxxxxxxxxxxxxxyyneeaaaaaaaaaaaaaaaaaaaaaaaaaaaaCCCbbbbbbbbbCCaaaaaaaaaaaaaaaaa
cdcuyyyuyyyyyyyyyyyuuyyyyyyyyyyyyucdceeexyBBmmmmmBxxFxxxxxxxxxxxyyneeaaaaaaaaaaaaaaaaaaaaaaaaaaaCCCCbbbbbbbCCCaaaaaaCCCCCCCaaaaa
cdcuyyyuyyyyyyyyyHyuIyyyyyyyyyyyyucdceeexyBmmmmmmBxxxxxxxxxxxxxxxynneaaaaaaaaaaaaaaaaaaaaaaaaaaCCCCbbbbbaaaaaaaaaaaCCCbbbbCCaaaa
cdcuyyyuyyyyyyyyyyyuuyyyyyyyyyyyyucdceeeyyBmmmmmmBxxxxxxxxxxxxxxyyyneaaaaaaaaaaaaaaaaaaaaaaaaaCCCCbbbbbaaaaaaaaaaCCCbbbbbbbCCaaa
cdcuyyyuyyyyyyyyyyyJuyyyyyyyyyyyuucdceexyBBmmmmmBBxxxxxxxxFxxxxyyyynnaaaaaaaaaaaaaaaaaaaaaaaaaCCbbbbbaaaaaaaaaaaaCbbbbbbbbbbCCaa
cdcuyyyuyyyyyyyyyyyuuyyyyyyyyyyyuccdccexyBmmmmmmBxxxxxxxxxxxxxyyyyyynaaaaaaaaaaaaaaaaaaaaaaaaaaCbbbbaaaaaaaaaaaaCCbbbbbbbbbbbCCa
cdcuuuuuuuuuuuuuuuuuuuuuuuuuuuuuucdddcexyBmmmmmBBxxxxxxxxxxxxyyyyyynnaaaaaaaaaaaaaaCCCCCaaaaaaaCbbbbaaaaaaaaaaaaCbbbbbbbbbbbbbbb
cdcccccuyyyyyyyyyyyuuyyyyyyyyyyyucdddcexyBmmmmmBxxxxxxxxxxxxyyyyyynnCaaaaaaaaaaaaCCCCCCCCCCbbbbbbbbbaaaaaaaaaaaCCbbbbbbbbbbbbbbb
cdcdddcuyyyyyyyyyyyuuyyyyyyyyyyyuddddcexyBmmmmmBxxxxxxxxxxxxyyynnnnCCCCaaaaaaaaaaCbCCCCbbbbbbbbbbbbbaaaaaaaaaggCbbbbbbbbbbbbbbbb
ddddddcuyyyyyyyyyyyuuyyyyyyyyyyyucdddcxxyBmmmmmBxxxFxxxxxxxyyyynnbbbbCCCCCCCCCCCaaCCbbbbbbbbbbbbbbbbbaaaaaagggkkllllbbbbbbbbbbba
ddddddcuyyyyyyyyyyyuuyyyyyyyyyyyucdddcxyyBmmmmmBxxxxxxxxxxxyyyynbbbbbbbbbbbbbbbbbbbbbbbbbbbbbbbbbbbbbbaaaaggkkkkkklllbbbbbbbbbaa
ddddddcuyyyyyyyyyyyuuyyyyyyyyyyyuccdccyyBBmmmmBBxxxxxxxxxxxxyyyntbbbbbbbbbbbbbbbbbbbbbbbbbaaaaaabbbbbbgggggkkkrrrkkllbbbbbbbbaaa
ddddddduuuuuuuKuuuuuuuuuuuuuuuuuuuuuuuussssssssxxxxxxxxxxxxxxyynnbbbbbbbbbbbbbbbbbbbbbbbbaaaaaaaaabbbkkkggkkkrrrrrkkllbbbbbbaaaa
ddddddduuuuuuuuuuuuuuuuuuuuuuuuuuuuuuuussssssssxxxxxxxxxxxxxxxyynbbbbbbbbbbbbbbbbbbbbbbbbaaaaaaaaaabkkkgkkkkrrrrrrrkkllbbbbaaaaa
ddddddcuyyyyyyyyyyyuuyyyyyyyyyyyuccdccBBmmmmmmBxxxxxxxxxxxxxxxxxntbbbbbbbbbbbbCCaaabbbbbbaaaaaaaaaagkkkkkkrrrrzzzzrrkklbbbaaaaaa
ddddddcuyyyyyyyyyyyuuyyyyyyyyyyyucdddcBmmmmmmBBxxxxxxxxxxxxxxxxxnnbbbbbbbbbbbbCaaaabbbbbbaaaaaaaaaagkkkkkrrrrAzzzzrrrkkbbaaaaaaa
ddddddcuyyyyyyyyyyyuuyyyyyyyyyyyucdddcBmmmmmmByxxFxxxxxxxxxxxxxxxnnbbbCCCbbbbCCaaaaabbbbbbaaaaaaaaggkkkkrrrzzzzzzzrrrrkkgaaaaaaa
cdcdddcuyyyyyyyyyyyuuyyyyyyyyyyyuddddcBmmmmmBByxxxxxxxxxxxxxxxxxxxnnbaaCCCCCCCaaaaaaabbbbbbaaaaaaagkkkkrrrzzzzzzzzrrrrrkggaaaaaa
cdcccccuyyyyyyyyyyyuuyyyyyyyyyyyucdddcBmmmmmByyxxxxxxxxxxxxFxxxxxxynnaaaaaaaaaaaaaaaabbbbbbbbbCCaagkkrrrrzzzzzzzzzrrrrrrkgaaaaaa
cdcuuuuuuuuuuuLuuIuuuuuuuuuuuuuuucdddcBmmmmmByyxxxxxxxxxxxxxxxxxxyynaaaaaaaaaaaaaaaaaabbbbbbbbbCCagkrrrrzzzzzzGzzzrrrrrkkgaaaaaa
cdcuyyyuyyyyyyyyyyyuuyyyyyyyyyyyuccdccBmmmmmBByxxxxxxxxxxxxxxxxxyyynaaaaaaaaaaaaaaaaaaabbbbbbbbbCagkrrrrzAzzzzzzzrrrrrkkkgaaaaaa
cdcuyyyuyyyyyyyyyyyuuyyyyyyyyyyyuucdcBBmmmmmmByyxxxxxxxxxxxxxxyyyynnaaaaaaaaaaaaaaaaaaaaabbbbbbbCagkrrrrrzzzzzzrrrrrrrkkggaaaaaa
cdcuyyyuyyyyyyyMyyyJuyyyyyyyyyyyyucdcBmmmmmmmBByxxxxxxxxxxxxyyyyynnaaaaaaaaaaaaaaaaaaaaaabbbbbbbCagkkrrrrzzzzrrrrrrrrrrkggaaaaaa
cdcuyyyuyyyyyyyyyyyuuyyyyyyyyyyyyucdcBmmmmmmmmByxxxFxxxxxyyyyyynnnaaaaaaaaaaaaaaaaaaaaaaabbbbbbbCaggkkrrrrzzrrrrrrrrrrrkggaaaaaa
cdcuyyyuyyyyyyyyyyyuuyyyyyyyyyyyyucdcBmmmmmmmmByxxxxxxxyyyyyynnnaaaaaaaaaaaaaaaaaaaaaaaaaabbbbbbCaagkkkrrrrrrrrrrrrrrrrkgaaaaaaa
cdcuyyyuyyyyyyyyyyyuuyyyyyyyyyyyyucdcBmmmmmmmmByxxxxxxyyyyynnnaaaaaaaaaaaaaaaaaaaaaaaaaaaaabbbbCCaagkkkkrrrrrrrrrrrrrrkkgaaaaaaa
cdcuyyyuyyyyyyyyyyyuuyyyyyyyyyyuuucdcBmmmmmmmmByxxyyyyynnnnnaaaaaaaaaaaaaaaaaaaaaaaaaaaCCCabbbCCaaagkkkkkrrrrrrrrrrrrkkggaaaaaaa
cdcuyyyuyyyyyyyyyyyuuyyyyyyyyyyucccdcccmmmmmmmByyyyyynnnaaaaaaaaaaaaaaaaaaaaaaaaaaaaCCCCbbbbbbaaaaffkkkkkkkrrrrrrrkkkkggaaaaaaaa
cdcuuuuuuuuuuuuuuuuuuuuuuuuuuuuucdddddcmmmmmmmByyynnnnaaaaaaaaaaaaaaaaaaaaaaaaaaaaaCCbbbbbbbbbaaaffffkkkkkkrrrrkkkkkgggaaaaaaaaa
cdcccccccccccccccccccccccccccccccddddNcmmmmmmmBnnnnaaaaaaaaaaaaaaaaaaaaaaaaaaaaaaaCCbbbbbbbbbbaafffffgggggkkrrkkklDggaaaaaaaaaaa
cdddddddddddddddddddddddddddddddddddddcmmmmmmmaaaaaaaaaaaaaaaaaaaaaaaaaaaaaaaaaaaCCbbbbbbbbbbbbffffaaaaaaaaffkkllbCaaaaaaaaaaaaa
cccccccccccccccccccccccccccccccccddNddcmmmmmoaaaaaaaaaaaaaaaaaaaaaaaaaaaaaaaaaaaCCbbbabbbbbbbbbbfaaaaaaaaaaaaabbbbCCaaaaaaaaaaaa
aaaaaaaaaaaaaaaaaaaaaaaaaaaaaaaacddddNcmmmoooaaaaaaaaaaaaaaaaaaaaaaaaaaaaaaaaaaaCbbaaaabbbbbbbbbbaaaCCCCaaaaaCbbbbbCCaaaaaCCCaaa
aaaaaaaaaaaaaaaaaaaaaaaaaaaaaaaacccccccmmooooaaaaaaaaaaaaaaaaaaaaaaaaaaaaaaaaaaCCbbaaaabbbbbCCCbbbaaCCbCCCCCCCbbbbbbCCCCCCCbCCaa
aaaaaaaaaaaaaaaaaaaaaaaaaaaaaaaaaaaaaooooooooaaaaaaaaaaaaaaaaaaaaaaaaaaaaaaaaaCCbbbaaaaaCbbCCaabbbbbbbbbbbbbbbbbbbbbbbbbbbbbbCCa
aaaaaaaaaaaaaaaaaaaaaaaaaaaaaaaaaaaaaooooooooaaaaaaaaaaaaaaaaaaaaaaaaaaaaaaaaaCbbbbbaaaCCbCCaaaabbbbbbbbbbbbbbbbbbbbbbbbbbbbbbbb
aaaaaaaaaaaaaaaaaaaaaaaaaaaaaaaaaaaaaooooooooaaaaaaaaaaaaaaaaaaaaaaaaaaaaaaaaaCbbbbbaaCCbbCaaaabbbbbbbbbbbbbbbbbbbbbbbbbbbbbbbbb
aaaaaaaaaaaaaaaaaaaaaaaaaaaaaaaaaaaaaooooooooaaaaaaaaaaaaaaaaaaaaaaaaaaaaaaaaabbbbbbbCCbbbCCaabbbCCbbbbbbbbbbbbbbbbbbbbbbbbbbbbb
aaaaaaaaaaaaaaaaaaaaaaaaaaaaaaaaaaaaaooooooooaaaaaaaaaaaaaaaaaaaaaaaaaaaaaaaaabbbbbbbbCCCbbbbbbbCCaahhihhhhhhhhhihhaaaCCbbbbbCCa
aaaaaaaaaaaaaaaaaaaaaaaaaaaaaaaaaaaaaoooooooooaaaaaaaaaaaaaaaaaaaaaaaaaaaaaaaabbbbbbbCCaCCbbbbbCCaaahiiiiiiiiiiiiihaaaaCCCCCCCaa
aaaaaaaaaaaaaaaaaaaaaaaaaaaaaaaaaaaaaaooooooooaaaaaaaaaCCCCCCCCCaaaaaaaaaaaaaabbbbbbbaaaaCbbbbCCaaaahiiiiiiiiiiiiihaaaaaaaaaaaaa
aaaaaaaaaaaaaaaaaaaaaaaaaaaaaaaaaaaaaaoooooooooaaaaaaaaaCCCCCCCCCCaaaaaaaaaaabbbbbbbaaaaaCbbbCCaaaaahiiiiiiiiiiiiihaaaaaaaaaaaaa
aaaaaaaaaaaaaaaaaaaaaaaaaaaaaaaaaaaaaaoooooooooaaaaaaaaaaCCCCCCbbaaaaaaaaabbbbbbbbbbbaaabbbbbCaaaaaahiiiiiiiiiiiiihaaaaaaaaaaaaa
aaaaaaaaaaaaaaaaaaaaaaaaaaaaaaaaaaaaaaooooooooooaaaaaaaaaCaCbbbbbbbaaaaabbbbbbbbbbbbbbabbbbbCCaaaaaahiiiiiiiiiiiiihaaaaaaaaaaaaa
aaaaaaaaaaaaaaaaaaaaaaaaaaaaaaaaaaaaaaaaooooooooaaaaaaaaaaCCaabbbbbbbbbbbbbbbbbbbbbbbbbbbbbbCaaaaaaahhhhhhhhhhhhhhhaaaaaaaaaaaaa
aaaaaaaaaaaaaaaaaaaaaaaaaaaaaaaaaaaaaaaaooooooooaaaaaaaaaaaCCCbbbbbbbbbbbbbbbbCCaabbbbbbbbbbaaaaaaaaaaaaaaaaaaaaaaaaaaaaaaaaaaaa
aaaaaaaaaaaaaaaaaaaaaaaaaaaaaaaaaaaaaaaaaooooooooaaaaaaaaaaaaabbbbbbbbbbbbbbCCCaaaaabbbbbbbbaaaaaaaaaaaaaaaaaaaaaaaaaaaaaaaaaaaa
aaaaaaaaaaaaaaaaaaaaaaaaaaaaaaaaaaaaaaaaaaoooooooooaaaaaaaaaaaaaCCCobbbbbCCCCaaaaaaaaaCCCbbbaaaaaaaaaaaaaaaaaaaaaaaaaaaaaaaaaaaa
aaaaaaaaaaaaaaaaaaaaaaaaaaaaaaaaaaaaaaaaaaaooooooooooaaaaaaaaaoooooooooooooaaaaaaaaaaaaaCbbbaaaaaaaaaaCCCaaaaaaaaaaaaaaaaaaaaaaa
aaaaaaaaaaaaaaaaaaaaaaaaaaaaaaaaaaaaaaaaaaaoooooooooooaaaaaaaoooooooooooooooaaaaaaaaaaaaCbbbaaaaaaaaaCCbCCCaaaaaaaaaaaaaaaaaaaaa
aaaaaaaaaaaaaaaaaaaaaaaaaaaaaaaaaaaaaaaaaaaaooooooooooooooaaooooooooooooooooaaaaaaaaaaaaCbbbbaaaaaaaCCbbbbCCaaaaaaaaaaaaaaaaaaaa
aaaaaaaaaaaaaaaaaaaaaaaaaaaaaaaaaaaaaaaaaaaaooooooooooooooooooooooooooooooooaaaaaaaaaaaaCbbbbaaaaaabCbbbbbbbbaaaaaaaaaaaaaaaaaaa
aaaaaaaaaaaaaaaaaaaaaaaaaaaaaaaaaaaaaaaaaaaaaooooooooooooooooooooooooooooooooaaaaaaaaaaaabbbbbaaabbbbbCCCCbbbbaaaaaaaaaaaaaaaaaa
aaaaaaaaaaaaaaaaaaaaaaaaaaaaaaaaaaaaaaaaaaaaaaaaoooooooooooooooooooooooooooooaaaaaaaaaaaabbbbbbbbbbbbCCaaCCbbbbaaaaaaaaaaaaaaaaa
aaaaaaaaaaaaaaaaaaaaaaaaaaaaaaaaaaaaaaaaaaaaaaaaaaooooooooooooooooooooooooooooaaaaaaaaaaaabbbbbbbbbbbaaaaaabbbbCaaaaaaaaaaaaaaaa
aaaaaaaaaaaaaaaaaaaaaaaaaaaaaaaaaaaaaaaaaaaaaaaaaaaaooooooooooooooooooooooooooaaaaaaaaaaaaabbbbbbCCaaaaaaaaabbbCCaaaaaaaaaaaaaaa
aaaaaaaaaaaaaaaaaaaaaaaaaaaaaaaaaaaaaaaaaaaaaaaaaaaaaaaaaooooooooooooooooooooooaaaaaaaaaaaaaCCCbCCaaaaaaaaaaCCbbCaaaaaaaaaaaaaaa
aaaaaaaaaaaaaaaaaaaaaaaaaaaaaaaaaaaaaaaaaaaaaaaaaaaaaaaaaaoooooooooooooooooooooaaaaaaaaaaaaaaaCCCaaaaaaaaaaaaCbbCaaaaaaaaaaaaaaa
aaaaaaaaaaaaaaaaaaaaaaaaaaaaaaaaaaaaaaaaaaaaaaaaaaaaaaaaaaaoooooooooooooooooooooaaaaaaaaaCCCCaaaaaaaaaaaaaaaaCbbCCaaaaaaaaaaaaaa
aaaaaaaaaaaaaaaaaaaaaaaaaaaaaaaaaaaaaaaaaaaaaaaaaaaaaaaaaaaaooooooooooooooooooooaaaaaaaaCCbbbbaaaaabbaaaaaaaaCbbbCaaaaaaaaaaaaaa
aaaaaaaaaaaaaaaaaaaaaaaaaaaaaaaaaaaaaaaaaaaaaaaaaaaaaaaaaaaaaooooooooooooooooooooaaaaaaCCbbbbbbbbbbbbbaaaaaCCCbbbCaaaaaaaaaaaaaa
aaaaaaaaaaaaaaaaaaaaaaaaaaaaaaaaaaaaaaaaaaaaaaaaaaaaaaaaaaaaaoooooooooooooooooooooaaaaaCbbbbbbbbbbbbbbbbabbCCCbbbCaaaaaaaaaaaaaa
aaaaaaaaaaaaaaaaaaaaaaaaaaaaaaaaaaaaaaaaaaaaaaaaaaaaaaaaaaaaaoooooooooooooooooooooaaaaCCbbbbbbbbbbbbbbbbbbCCCCCbbCaaaaaaaaaaaaaa
aaaaaaaaaaaaaaaaaaaaaaaaaaaaaaaaaaaaaaaaaaaaajjjjjjjllllaaaaaaoooooooooooooooooooooaaaCbbbbbbbbbaaaaaabbbbCCCCCbbCaaaaaaaaaaaaaa
aaaaaaaaaaaaaaaaaaaaaaaaaaaaaaaaaaaaaaaaaaajjjvvvvvllllllaaaaaooooooooooooooooooooooaaCbbbbbbbbaaaaaaaaabbbCCCCbbCaaaaaaaaaaaaaa
aaaaaaaaaaaaaaaaaaaaaaaaaaaaaaaaaaaaaaaaaajjvvvvvvllllllllaaaaaooooooooooooooooooooooaabbbbbbaaaaaaaaaaaaCbbCCbbbCaaaaaaaaaaaaaa
aaaaaaaaaaaaaaaaaaaaaaaaaaaaaaaaaaaaaaaaaajvvvvvvllllllllllaaaaooooooooooooooooooooooaabbbbbbaaaaaaaaaaaaCbbbbbbbCaaaaaaaaaaaaaa
aaaaaaaaaaaaaaaaaaaaaaaaaaaaaaaaaaaaaaaaawjvvvvvvlllllllllllaaooooooooooooooooooooooooaabbbbbaaaaaaaaaaaaCCbbbbbbCaaaaaaaaaaaaaa
aaaaaaaaaaaaaaaaaaaaaaaaaaaaaaaaaaaaaaaaajvvvvvvlllllllllllllloooooooooooooooooooooooooaaabbbbbbaaaaaaaaaCCbbbbbbCaaaaaaaaaaaaaa
aaaaaaaaaaaaaaaaaaaaaaaaaaaaaaaaaaaaaaaajjvvvvvvlllllllllllllllooooooooooooooooooooooooaaaaCCbbbbbaaaaaaaCCCbbbbbCaaaaaaaaaaaaaa
aaaaaaaaaaaaaaaaaaaaaaaaaaaaaaaaaaaaaaaajvvvvvvllllllllllllllllooooooooooooooooooooooooaaaaaCCCbbbbbaaaaaCCCbbbbbaaaaaaaaaaaaaaa
aaaaaaaaaaaaaaaaaaaaaaaaaaaaaaaaaaaaaaaajvvvvvvvllllllllllllllloooooooooooooooooooooooooaaaaaaCbbbbbbaaaaCCbbbbbbaaaaaaaaaaaaaaa
aaaaaaaaaaaaaaaaaaaaaaaaaaaaaaaaaaaaaaajjvvvvvvvllllllllllllllloooooooooooooooooooooooooaaaaaaaCCbbbbbbaaCbbbbbbaaaaaaaaaaaaaaaa
aaaaaaaaaaaaaaaaaaaaaaaaaaaaaaaaaaaaaaajvvvvvvvvlllllllllllllllooooooooooooooooooooooooooaaaaaaaabbbbbbbbbbbbbbaaaaaaaaaaaaaaaaa
aaaaaaaaaaaaaaaaaaaaaaaaaaaaaaaaaaaaaaajvvvvvvvvlllllllllllllllooooooooooooooooooooooooooaaaaaaaaaabbbbbbbbbbbaaaaaaaaaaaaaaaaaa
aaaaaaaaaaaaaaaaaaaaaaaaaaaaaaaaaaaaaaajvvvvvvvvlllllllllllllaaaaooooooooooooooooooooooooaaaaaaaaaabbbbbbbbbbaaaaaaaaaaaaaaaaaaa
aaaaaaaaaaaaaaaaaaaaaaaaaaaaaaaaaaaaaaajjvvvvvvvllllllllllllaaaaaaoooooooooooooooooooooooaaaaaaaaaabbbbbbbbaaaaaaaaaaaaaaaaaaaaa
aaaaaaaaaaaaaaaaaaaaaaaaaaaaaaaaaaaaaaaajjvvvvvvvllllllllllaaaaaaaoooooooooooooooooooooooaaaaaaaaCCbbbbbaaaaaaaaaaaaaaaaaaaaaaaa
aaaaaaaaaaaaaaaaaaaaaaaaaaaaaaaaaaaaaaaaajjvvvvvvllllllllaaaaaaaaaoooooooooooooooooooooooaaaaaaCCCbbbbaaaaaaaaaaaaaaaaaaaaaaaaaa
aaaaaaaaaaaaaaaaaaaaaaaaaaaaaaaaaaaaaaaaaajjjvvvvllllllaaaaaaaaaaooooooooooooooooooooooooaaaaaCCbbbbbbaaaaaaaaaaaaaaaaaaaaaaaaaa
aaaaaaaaaaaaaaaaaaaaaaaaaaaaaaaaaaaaaaaaaaaajjjvvvlllllaaaaaaaaaoooooooooooooooooooooooooaaaaCCbbbbbbaaaaaaaaaaaaaaaaaaaaaaaaaaa
aaaaaaaaaaaaaaaaaaaaaaaaaaaaaaaaaaaaaaaaaaaaaajjjjjlaaaaaaaaaaaaoooooooooooooooooooooooooaaaaCbbbbbaaaaaaaaaaaaaaaaaaaaaaaaaaaaa
aaaaaaaaaaaaaaaaaaaaaaaaaaaaaaaaaaaaaaaaaaaaaaaaaaaaaaaaaaaaaaaaooooooooooooooooooooooooaaaaaCbbbbbbaaaaaaaaaaaaaaabbaaaaaaaaaaa
aaaaaaaaaaaaaaaaaaaaaaaaaaaaaaaaaaaaaaaaaaaaaaaaaaaaaaaaaaaaaaaaooooooooooooooooooooooooaaaaaCbbbbbbbaaaaaaaaaaaabbbbbbbbbbaaaaa
aaaaaaaaaaaaaaaaaaaaaaaaaaaaaaaaaaaaaaaaaaaaaaaaaaaaaaaaaaaaaaaaoooooooooooooooooooooooaaaaaCCbbbbbbbaaaaaaaabbbbbbbbbbbbbbbaaaa
aaaaaaaaaaaaaaaaaaaaaaaaaaaaaaaaaaaaaaaaaaaaaaaaaaaaaaaaaaaaaaaaaooooooooooooooooooooooaaaaCCbbbbbbbbbaaabbbbbbbbbbbbaaabbbbbaaa
aaaaaaaaaaaaaaaaaaaaaaaaaaaaaaaaaaaaaaaaaaaaaaaaaaaaaaaaaaaaaaaaaooooooooooooooooooooooaaaaCbbbbbbbbbbbbbbbbbbbbbbbbbaaaaabbbbaa
aaaaaaaaaaaaaaaaaaaaaaaaaaaaaaaaaaaaaaaaaaaaaaaaaaaaaaaaaaaaaaaaaaoooooooooooooooooooooaaaCCbbbbbbbbbbbbbbbbbbbbbbbbbbaaaaabbbba
aaaaaaaaaaaaaaaaaaaaaaaaaaaaaaaaaaaaaaaaaaaaaaaaaaaaaaaaaaaaaaaaaaooooooooooooooooooooooaCCbbbbbbbbbbbbbbaaaaabbbbbbbbbaaabbbbba
aaaaaaaaaaaaaaaaaaaaaaaaaaaaaaaaaaaaaaaaaaaaaaaaaaaaaaaaaaaaaaaaaaaooooooooooooooooooooobbbbbbbbbbbbbbCaaaaaaabbbbbbbbbbbbbbbbba
aaaaaaaaaaaaaaaaaaaaaaaaaaaaaaaaaaaaaaaaaaaaaaaaaaaaaaaaaaaaaaaaaaaooooooooooooooooooooobbbbbbbbbbbbbbCaaaaabbbbaabbbbbbbbbbbbaa
aaaaaaaaaaaaaaaaaaaaaaaaaaaaaaaaaaaaaaaaaaaaaaaaaaaaaaaaaaaaaaaaaaaaoooooooooooooooooooobbbbbbbbbbbbbbCaaaabbbbbaaaabbbbbbbbbaaa
aaaaaaaaaaaaaaaaaaaaaaaaaaaaaaaaaaaaaaaaaaaaaaaaaaaaaaaaaaaaaaaaaaaaoooooooooooooooooooobbbbbbbbbbbbbbCaaaabbbbbaaaaabbbbbbbaaaa
aaaaaaaaaaaaaaaaaaaaaaaaaaaaaaaaaaaaaaaaaaaaaaaaaaaaaaaaaaaaaaaaaaaaaooooooooooooooooooobbbbbbbbbbbbbCCaaaaabbbbbbaaabbbbbbaaaaa
aaaaaaaaaaaaaaaaaaaaaaaaaaaaaaaaaaaaaaaaaaaaaaaaaaaaaaaaaaaaaaaaaaaaaoooooooooooooooooooobbbbbbbbbbbbCaaaaaabbbbbbbbbbbbbaaaaaaa
aaaaaaaaaaaaaaaaaaaaaaaaaaaaaaaaaaaaaaaaaaaaaaaaaaaaaaaaaaaaaaaaaaaaaaooooooooooooooooooobbbbbbppbbbCCaaaaabbbbbbbbbbbbbaaaaaaaa
aaaaaaaaaaaaaaaaaaaaaaaaaaaaaaaaaaaaaaaaaaaaaaaaaaaaaaaaaaaaaaaaaaaaaaaooooooooooooooooooobbbbppppbbCaaaaabbbbbbbbbbbbbaaaaaaaaa
aaaaaaaaaaaaaaaaaaaaaaaaaaaaaaaaaaaaaaaaaaaaaaaaaaaaaaaaaaaaaaaaaaaaaaaaoooooooooooooooooobbbppppppCCaaaaabbbbbbbbbbbaaaaaaaaaaa
aaaaaaaaaaaaaaaaaaaaaaaaaaaaaaaaaaaaaaaaaaaaaaaaaaaaaaaaaaaaaaaaaaaaaaaaaooooooooooqqqqqqqqppppppppEaaaaaaabbbbaaaaaaaaaaaaaaaaa
aaaaaaaaaaaaaaaaaaaaaaaaaaaaaaaaaaaaaaaaaaaaaaaaaaaaaaaaaaaaaaaaaaaaaaaaaaoooooqqqqqqqqqqqqqpppppppaaaaaaaaabbaaaaaaaaaaaaaaaaaa
aaaaaaaaaaaaaaaaaaaaaaaaaaaaaaaaaaaaaaaaaaaaaaaaaaaaaaaaaaaaaaaaaaaaaaaaaaaooqqqqqqqqqqqqqqqqppppppaaaaaaaaaaaaaaaaaaaaaaaaaaaaa
aaaaaaaaaaaaaaaaaaaaaaaaaaaaaaaaaaaaaaaaaaaaaaaaaaaaaaaaaaaaaaaaaaaaaaaaaaaaqqqqqqqqqqqqqqqqqqpppppaaaaaaaaaaaaaaaaaaaaaaaaaaaaa
"}
