"a" = (/turf/simulated/floor/colored/mint_grass,/area/world/abyss/exterior)
"b" = (/turf/simulated/wall/boss,/area/world/abyss/exterior)
"c" = (/turf/simulated/floor/colored/ash/necro,/area/world/abyss/exterior)
"d" = (/turf/simulated/floor/colored/dirt/cake,/area/world/abyss/exterior)
"e" = (/turf/simulated/floor/icing,/area/world/abyss/exterior)
"f" = (/turf/simulated/floor/candy,/area/world/abyss/exterior)
"g" = (/obj/marker/lobby,/turf/simulated/floor/colored/ash/necro,/area/world/abyss/exterior)
"h" = (/turf/simulated/floor/river/chocolate,/area/world/abyss/exterior)
"i" = (/obj/structure/scenery/lolipops,/turf/simulated/floor/colored/dirt/cake,/area/world/abyss/exterior)
"j" = (/obj/structure/scenery/lolipops,/turf/simulated/floor/colored/mint_grass,/area/world/abyss/exterior)
"k" = (/obj/structure/scenery/gumdrop{icon_state = "gumdrop"; dir = 4},/turf/simulated/floor/colored/mint_grass,/area/world/abyss/exterior)
"l" = (/obj/structure/scenery/gumdrop{icon_state = "gumdrop"; dir = 8},/turf/simulated/floor/colored/mint_grass,/area/world/abyss/exterior)

(1,1,1) = {"
bbbbbbbbbbbbbbbbbbbbbbbbbbbbbbbbbbbbbbbbbbbbbbbbbbbbbbbbbbbbbbbbbbbbbbbbbbbbbbbbbbbbbbbbbbbbbbbbbbbbbbbbbbbbbbbbbbbbbbbbbbbbbbbb
bbbbbbbbbbbbbbbbbbbbbbbbbbbbbbbbbbbbbbbbbbbbbbbbbbbbbbbbbbbbbbbbbbbbbbbbbbbbbbbbbbbbbbbbbbbbbbbbbbbbbbbbbbbbbbbbbbbbbbbbbbbbbbbb
bbaaaaaaaaaaaaaaaaaaaaaaaaaaaaaaaaaaaaaaaaaaaaaaaaaaaaaaaaaaaaaaaaaaaaaaaaaaaaaaaaaaaaaaaaaaaaaaaaaaaaaaaaaaaaaaaaaaaaaaaaaaaabb
bbaaaaaaaaaaaaaaaaaaaaaaaaaaaaaaaaaaaaaaaaaaaaaaaaaaaaaaaaaaaaaaaaaaaaaaaaaaaaaaaaaaaaaaaaaaaaaaaaaaaaaaaaaaaaaaaaaaaaaaaaaaaabb
bbaaaaaaaaaaaaaaaaaaaaaaaaaaaaaaaaaaaaaaaaaaaaaaaaaaaaaaaaaaaaaaaaaaaaaaaaaaaaaaaaaaaaaaaaaaaaaaaaaaaaaaaaaaaaaaaaaaaaaaaaaaaabb
bbaaaaaaaaaaaaaaaaaaaaaaaaaaaaaaaaaaaaaaaaaaaaaaaaaaaaaaaaaaaaaaaaaaaaaaaaaaaaaaaaaaaaaaaaaaaaaaaaaaaaaaaaaaaaaaaaaaaaaaaaaaaabb
bbaaaaaaaaaaaaaaaaaaaaaaaaaaaaaaaaaaaaaaaaaaaaaaaaaaaaaaaaaaaaaaaaaaaaaaaaaaaaaaaaaaaaaaaaaaaaaaaaaaaaaaaaaaaaaaaaaaaaaaaaaaaabb
bbaaaaaaaaaaaaaaaaaaaaaaaaaaaaaaaaaaaaaaaaaaaaaaaaaaaaaaaaaaaaaaaaaaaaaaaaaaaaaaaaaaaaaaaaaaaaaaaaaaaaaaaaaaaaaaaaaaaaaaaaaaaabb
bbaaaaaaaaaaaaaaaaaaaaaaaaaaaaaaaaaaaaaaaaaaaaaaaaaaaaaaaaaaaaaaaaaaaaaaaaaaaaaaaaaaaaaaaaaaaaaaaaaaaaaaaaaaaaaaaaaaaaaaaaaaaabb
bbaaaaaaaaaaaaaaaaaaaaaaaaaaaaaaaaaaaaaaaaaaaaaaaaaaaaaaaaaaaaaaaaaaaaaaaaaaaaaaaaaaaaaaaaaaaaaaaaaaaaaaaaaaaaaaaaaaaaaaaaaaaabb
bbaaaaaaaaaaaaaaaaaaaaaaaaaaaaaaaaaaaaaaaaaaaaaaaaaaaaaaaaaaaaaaaaaaaaaaaaaaaaaaaaaaaaaaaaaaaaaaaaaaaaaaaaaaaaaaaaaaaaaaaaaaaabb
bbaaaaaaaaaaaaaaaaaaaaaaaaaaaaaaaaaaaaaaaaaaaaaaaaaaaaaaaaaaaaaaaaaaaaaaaaaaaaaaaaaaaaaaaaaaaaaaaaaaaaaaaaaaaaaaaaaaaaaaaaaaaabb
bbaaaaaaaaaaaaaaaaaaaaaaaaaaaaaaaaaaaaaaaaaaaaaaaaaaaaaaaaaaaaaaaaaaaaaaaaaaaaaaaaaaaaaaaaaaaaaaaaaaaaaaaaaaaaaaaaaaaaaaaaaaaabb
bbaaaaaaaaaaaaaaaaaaaaaaaaaaaaaaaaaaaaaaaaaaaaaaaaaaaaaaaaaaaaaaaaaaaaaaaaaaaaaaaaaaaaaaaaaaaaaaaaaaaaaaaaaaaaaaaaaaaaaaaaaaaabb
bbaaaaaaaaaaaaaaaaaaaaaaaaaaaaaaaaaaaaaaaaaaaaaaaaaaaaaaaaaaaaaaaaaaaaaaaaaaaaaaaaaaaaaaaaaaaaaaaaaaaaaaaaaaaaaaaaaaaaaaaaaaaabb
bbaaaaaaaaaaaaaaaaaaaaaaaaaaaaaaaaaaaaaaaaaaaaaaaaaaaaaaaaaaaaaaaaaaaaaaaaaaaaaaaaaaaaaaaaaaaaaaaaaaaaaaaaaaaaaaaaaaaaaaaaaaaabb
bbaaaaaaaaaaaaaaaaaaaaaaaaaaaaaaaaaaaaaaaaaaaaaaaaaaaaaaaaaaaaaaaaaaaaaaaaaaaaaaaaaaaaaaaaaaaaaaaaaaaaaaaaaaaaaaaaaaaaaaaaaaaabb
bbaaaaaaaaaaaaaaaaaaaaaaaaaaaaaaaaaaaaaaaaaaaaaaaaaaaaaaaaaaaaaaaaaaaaaaaaaaaaaaaaaaaaaaaaaaaaaaaaaaaaaaaaaaaaaaaaaaaaaaaaaaaabb
bbaaaaaaaaaaaaaaaaaaaaaaaaaaaaaaaaaaaaaaaaaaaaaaaaaaaaaaaaaaaaaaaaaaaaaaaaaaaaaaaaaaaaaaaaaaaaaaaaaaaaaaaaaaaaaaaaaaaaaaaaaaaabb
bbaaaaaaaaaaaaaaaaaaaaaaaaaaaaaaaaaaaaaaaaaaaaaaaaaaaaaaaaaaaaaaaaaaaaaaaaaaaaaaaaaaaaaaaaaaaaaaaaaaaaaaaaaaaaaaaaaaaaaaaaaaaabb
bbaaaaaaaaaaaaaaaaaaaaaaaaaaaaaaaaaaaaaaaaaaaaaaaaaaaaafaaaaaaaaaaaaaaaaaaaaaaaaaaaaaaaaaaaaaaaaaaaaaaaaaaaaaaaaaaaaaaaaaaaaaabb
bbddddddddddddddddddddddddddddddddddddddddddddddddfahahfaaaaaaaaaaaaaaaaaaaaaaaaaaaaaaaaaaaaaaaaaaaaaaaaaaaaaaaaaaaaaaaaaaaaaabb
bbddddddddiiidddddddddddddddddddddddddddddddddddddfhhhhfaaaaaaaaaaaaaaaaaaaaaaaaaaaaaaaaaaaaaaaaaaaaaaaaaaaaaaaaaaaaaaaaaaaaaabb
bbddddddiiiiidddddddddddddddddddddddddddddddddddddfhhhhfaaaaaaaaaaaaaaaaaaaaaaaaaaaaaaaaaaaaaaaaaaaaaaaaaaaaaaaaaaaaaaaaaaaaaabb
bbdddddiiiiidddddddeeddddddddddddddddddddddddddddffhhhhffaaaaaaaaaaaaaaaaaaaaaaaaaaaaaaaaaaaaaaaaaaaaaaaaaaaaaaaaaaaaaaaaaaaaabb
bbddddiiiiiiddddeeeeeddddddddddddddddddddddddddddfhhhhhhfaaaaaaaaaaaaaaaaaaaaaaaaaaaaaaaaaaaaaaaaaaaaaaaaaaaaaaaaaaaaaaaaaaaaabb
bbdddiiiiiiddddeeeeedddddddddddddddddddddddddddddfhhhhhhfaaaaaaaaaaaaaaaaaaaaaaaaaaaaaaaaaaaaaaaaaaaaaaaaaaaaaaaaaaaaaaaaaaaaabb
bbddiiiiiiddddeeeeedddddddddddddddddddddddddddddffhhhhhffaaaaaaaaaaaaaaaaaaaaaaaaaaaaaaaaaaaaaaaaaaaaaaaaaaaaaaaaaaaaaaaaaaaaabb
bbddiiiiiddddeeeedddddddddddddddddddddddddddddddfhhhhhhfaaaaaaaaaaaaaaaaaaaaaaaaaaaaaaaaaaaaaaaaaaaaaaaaaaaaaaaaaaaaaaaaaaaaaabb
bbddddddddddeeeeedddddddddddddddddddddddddddddddfhhhhhffaafddeddeddaaaaaaaaaaaaaaaaaaaaaaaaaaaaaaaaaaaaaaaaaaaaaaaaaaaaaaaaaaabb
bbdddddddddeeeeeedddddddddddddddddddddddddddddddffhhhhfaaafddeddeddaaaaaaaaaaaaaaaaaaaaaaaaaaaaaaaaaaaaaaaaaaaaaaaaaaaaaaaaaaabb
bbddddddddeeeeeeddddddddddddddddddddddddddddddddfhhhhffaaafddeddeddaaaaaaaaaaaaaaaaaaaaaaaaaaaaaaaaaaaaaaaaaaaaaaaaaaaaaaaaaaabb
bbddddddddeeeeedddddddddddddddddddddddddddddddddfhhhhhfaaafddeddeddaaaaaaaaaaaaaaaaaaaaaaaaaaaaaaaaaaaaaaaaaaaaaaaaaaaaaaaaaaabb
bbddddddddeeeedddddddddddddiiiiiidddddddddddddddffhhhhfaaafddeddeddaaaaaaaaaaaaaaaaaaaaaaaaaaaaaaaaaaaaaaaaaaaaaaaaaaaaaaaaaaabb
bbdddddddeeeedddddddddiiiiiiiiiiiiiddddddddddddddfhhhhffaafddeddeddaaaaaaaaaaaaaaaaaaaaaaaaaaaaaaaaaaaaaaaaaaaaaaaaaaaaaaaaaaabb
bbddddddeeeeeddddddiiiiiiiiiiiiiiiiddddddddddddddfhhhhhfaafddeddeddaaaaaaaaaaaaaaaaaaaaaaaaaaaaaaaaaaaaaaaaaaaaaaaaaaaaaaaaaaabb
bbddddddeeeeedddddiiiiiiiiiiiiiiiiiidddddddddddddffhhhhfaafddeddeddaaaaaaaaaaaaaaaaaaaaaaaaaaaaaaaaaaaaaaaaaaaaaaaaaaaaaaaaaaabb
bbddddddeeeeeddddiiiiiiiiiiiiiiiiiiidddddddddddddafhhhhfaafddeddeddaaaaaaaaaaaaaaaaaaaaaaaaaaaaaaaaaaaaaaaaaaaaaaaaaaaaaaaaaaabb
bbdddddeeeeedddiiiiiiiiiiiiiiiiiiiiidddddddddddddafhhhhfaafddeddeddaaaaaaaaaaaaaaaaaaaaaaaaaaaaaaaaaaaaaaaaaaaaaaaaaaaaaaaaaaabb
bbdddddeeeeedddiiiiiiiiiiiiiiiiiiiiidddddddddddddffhhhhfaafddeddeddaaaaaaaaaaaaaaaaaaaaaaaaaaaaaaaaaaaaaaaaaaaaaaaaaaaaaaaaaaabb
bbddddddeeedddddiiiiiiiiiiiiiiiiiiiidddddddddddddfhhhhhfaafddeddeddaaaaaaaaaaaaaaaaaaaaaaaaaaaaaaaaaaaaaaaaaaaaaaaaaaaaaaaaaaabb
bbdddddeeeedddddiiiiiiiiiiiiiiiiiiiidddddddddddddfhhhhhfaafddeddeddaaaaaaaaaaaaaaaaaaaaaaaaaaaaaaaaaaaaaaaaaaaaaaaaaaaaaaaaaaabb
bbddddddeeedddddddiiiiiiiiiiiiiiiiiddddddddddddddfhhhhffaafddeddeddaaaaaaaaaaaaaaaaaaaaaaaaaaaaaaaaaaaaaaaaaaaaaaaaaaaaaaaaaaabb
bbddddddeeeedddddddddiiiiiiiiiiiiidddddddddddddddfhhhhffaafddeddeddaaaaaaaaaaaaaaaaaaaaaaaaaaaaaaaaaaaaaaaaaaaaaaaaaaaaaaaaaaabb
bbdddddddeeeedddddddddddiiiiiiiiiddddddddddddddddfhhhhhfakfddeddeddlaaaaaaaaaaaaaaaaaaaaaaaaaaaaaaaaaaaaaaaaaaaaaaaaaaaaaaaaaabb
bbddddddddeeeeeddddddddddddddddddddddddddddddddddfhhhhhfaafddeddeddaaaaaaaaaaaaaaaaaaaaaaaaaaaaaaaaaaaaaaaaaaaaaaaaaaaaaaaaaaabb
bbdddddddddeeeeedddddddddddddddddddddddddddddddddffhhhhfaafddeddeddaaaaaaaaaaaaaaaaaaaaaaaaaaaaaaaaaaaaaaaaaaaaaaaaaaaaaaaaaaabb
bbddddddddddeeeeeeeeeeeeeeeeeeeeddddddddddddddddddfhhhhfaafddeddeddaaaaaaaaaaaaaaaaaaaaaaaaaaaaaaaaaaaaaaaaaaaaaaaaaaaaaaaaaaabb
bbdddddddddddeeeeeeeeeeeeeeeeeeeeedddddddiiiiiddddfhhhhfakfddeddeddlaaaaaaaaaaaaaaaaaaaaaaaaaaaaaaaaaaaaaaaaaaaaaaaaaaaaaaaaaabb
bbdddddddddddddeeeeeeeeeeeeeeeeeeeedddddiiiiiiidddfhhhhfaafddeddeddaaaaaaaaaaaaaaaaaaaaaaaaaaaaaaaaaaaaaaaaaaaaaaaaaaaaaaaaaaabb
bbdddddddddddddddddddddddddddddeeeeeddddiiiiiiidddfhhhhfaafddeddeddaaaaaaaaaaaaaaaaaaaaaaaaaaaaaaaaaaaaaaaaaaaaaaaaaaaaaaaaaaabb
bbddddddddddddddddddddddddddddddeeeeedddiiiiiiidddffhhhfaafddeddeddaaaaaaaaaaaaaaaaaaaaaaaaaaaaaaaaaaaaaaaaaaaaaaaaaaaaaaaaaaabb
bbdddddddddddddddddddddddddddddddeeeeddddiiiiiidddffhhhfakfddeddeddlaaaaaaaaaaaaaaaaaaaaaaaaaaaaaaaaaaaaaaaaaaaaaaaaaaaaaaaaaabb
bbddddddddddddddddddddddddddiiddddeeeddddiiiiiidddfhhhhfaafddeddeddaaaaaaaaaaaaaaaaaaaaaaaaaaaaaaaaaaaaaaaaaaaaaaaaaaaaaaaaaaabb
bbddddddddddddddddddddddiiiiiiidddeeeeeddiiiiiidddfhhhhfaafddeddeddaaaaaaaaaaaaaaaaaaaaaaaaaaaaaaaaaaaaaaaaaaaaaaaaaaaaaaaaaaabb
bbddddddddddddddddddddiiiiiiiiiidddeeeeddiiiiiiddffhhhhfaafddeddeddaaaaaaaaaaaaaaaaaaaaaaaaaaaaaaaaaaaaaaaaaaaaaaaaaaaaaaaaaaabb
bbddddddddddddddddddiiiiiiiiiiiiidddeeeeddiiiidddfhhhhhfakfddeddeddlaaaaaaaaaaaaaaaaaaaaaaaaaaaaaaaaaaaaaaaaaaaaaaaaaaaaaaaaaabb
bbddddddddddddddddddiiiiiiiiiiiiiidddeeedddddddddfhhhhhfaafddeddeddaaaaaaaaaaaaaaaaaaaaaaaaaaaaaaaaaaaaaaaaaaaaaaaaaaaaaaaaaaabb
bbdddddddddddddddddiiiiiiiiiiiiiiidddeeeeddddddddfhhhhffaafddeddeddaaaaaaaaaaaaaaaaaaaaaaaaaaaaaaaaaaaaaaaaaaaaaaaaaaaaaaaaaaabb
bbdddddddddddddddddiiiiiiiiiiiiiidddddeeeddddddddfhhhhfaaafddeddeddaaaaaaaaaaaaaaaaaaaaaaaaaaaaaaaaaaaaaaaaaaaaaaaaaaaaaaaaaaabb
bbddddddddddddddddddiiiiiiiiiiiidddddeeeeeeeeeeddfhhhhfaakfddeddeddlaaaaaaaaaaaaaaaaaaaaaaaaaaaaaaaaaaaaaaaaaaaaaaaaaaaaaaaaaabb
bbddddddddddddddddddddiiiiiiiiiddeeeeeeeeeeeeeeeefhhhhfaaafddeddeddaaaaaaaaaaaaaaaaaaaaaaaaaaaaaaaaaaaaaaaaaaaaaaaaaaaaaaaaaaabb
bbdddddddddddddddddddddddiidddddeeeeeeeeeeeeeeeeefhhhhfaaafddeddeddaaaaaaaaaaaaaaaaaaaaaaaaaaaaaaaaaaaaaaaaaaaaaaaaaaaaaaaaaaabb
bbdddddddddddddddddddddddddddeeeeeeeeddddddddddddfhhhhfaaafddeddeddaaaaaaaaaaaaaaaaaaaaaaaaaaaaaaaaaaaaaaaaaaaaaaaaaaaaaaaaaaabb
bbddddddddddddddddddddddddddeeeeeeeddddddddddddddfhhhhfaakfddeddeddlaaaaaaaaaaaaaaaaaaaaaaaaaaaaaaaaaaaaaaaaaaaaaaaaaaaaaaaaaabb
bbdddddddddddddddddddddddddeeeeeeddddddiiiiddddddfhhhhfaaafddeddeddaaaaaaaaaaaaaaaaaaaaaaaaaaaaaaaaaaaaaaaaaaaaaaaaaaaaaaaaaaabb
bbdddddddddddddddddddddddddeeeeeddddddiiiiiiddddffhhhhfaaafddeddeddaaaaaaaaaaaaaaaaaaaaaaaaaaaaaaaaaaaaaaaaaaaaaaaaaaaaaaaaaaabb
bbdddddddddddddddddddddddddeeeeedddddiiiiiiiidddfhhhhhfaaafddeddeddaaaaaaaaaaaaaaaaaaaaaaaaaaaaaaaaaaaaaaaaaaaaaaaaaaaaaaaaaaabb
bbdddddddddddddddddddddddddeeeedddddiiiiiiiiiddffhhhhffaakfddeddeddlaaaaaaaaaaaaaaaaaaaaaaaaaaaaaaaaaaaaaaaaaaaaaaaaaaaaaaaaaabb
bbdddddddddddddddddddddddddeeeeddddiiiiiiiiiiddfhhhhhfaaaafddeddeddaaaaaaaaaaaaaaaaaaaaaaaaaaaaaaaaaaaaaaaaaaaaaaaaaaaaaaaaaaabb
bbdddddddddddddddddddddddddeeeeedddiiiiiiiiiddffhhhhhfaaaafddeddeddaaaaaaaaaaaaaaaaaaaaaaaaaaaaaaaaaaaaaaaaaaaaaaaaaaaaaaaaaaabb
bbdddddddddddddddddddddddddeeeeedddiiiiiiiiidffhhhhhffaaaafddeddeddaaaaaaaaaaaaaaaaaaaaaaaaaaaaaaaaaaaaaaaaaaaaaaaaaaaaaaaaaaabb
bbddddddddddddddddddddddddddeeeeedddiiiiiiiidfhhhhhhfaaaakfddeddeddlaaaaaaaaaaaaaaaaaaaaaaaaaaaaaaaaaaaaaaaaaaaaaaaaaaaaaaaaaabb
bbdddddddddddddddddddddddddddeeeedddiiiiiiiddffhhhhhfaaaaafddeddeddaaaaaaaaaaaaaaaaaaaaaaaaaaaaaaaaaaaaaaaaaaaaaaaaaaaaaaaaaaabb
bbddddddddddddddddddddddddddddeeeedddiiiiidddffhhhhhfaaaaafddeddeddaaaaaaaaaaaaaaaaaaaaaaaaaaaaaaaaaaaaaaaaaaaaaaaaaaaaaaaaaaabb
bbddddddddddddddddddddddddddddeeeeddddiiiddddfhhhhhffaaaaafddeddeddaaaaaaaaaaaaaaaaaaaaaaaaaaaaaaaaaaaaaaaaaaaaaaaaaaaaaaaaaaabb
bbdddddddddddddddddddddddddddddeeeddddddddddffhhhhhfaaaaakfddeddeddlaaaaaaaaaaaaaaaaaaaaaaaaaaaaaaaaaaaaaaaaaaaaaaaaaaaaaaaaaabb
bbddddddddddddddddddddddddddddddeeedddddddddfhhhhhffaaaaaafddeddeddaaaaaaaaaaaaaaaaaaaaaaaaaaaaaaaaaaaaaaaaaaaaaaaaaaaaaaaaaaabb
bbddddddddddddddddddddddddddddddeeeeedddddddfhhhhhfaaaaaaafddeddeddaaaaaaaaaaaaaaaaaaaaaaaaaaaaaaaaaaaaaaaaaaaaaaaaaaaaaaaaaaabb
bbddddddddddddddddddddddddddddddeeeeedddddddfhhhhhfaaaaaaafddeddeddaaaaaaaaaaaaaaaaaaaaaaaaaaaaaaaaaaaaaaaaaaaaaaaaaaaaaaaaaaabb
bbddddddddddddddddddddddddddiiddeeeeeddddddffhhhhhfaaaaaakfddeddeddlaaaaaaaaaaaaaaaaaaaaaaaaaaaaaaaaaaaaaaaaaaaaaaaaaaaaaaaaaabb
bbddddddddddddddddddddddddiiiidddeeedddddfffhhhhhffaaaaaaafddeddeddaaaaaaaaaaaaaaaaaaaaaaaaaaaaaaaaaaaaaaaaaaaaaaaaaaaaaaaaaaabb
bbdddddddddddddddddddddddiiiiidddeeedddddfhhhhhhhfaaaaaaaafddeddeddaaaaaaaaaaaaaaaaaaaaaaaaaaaaaaaaaaaaaaaaaaaaaaaaaaaaaaaaaaabb
bbddddddddddddddddddddddiiiiiiddeeedddddffhhhhhhhfaaaaaaaafddeddeddaaaaaaaaaaaaaaaaaaaaaaaaaaaaaaaaaaaaaaaaaaaaaaaaaaaaaaaaaaabb
bbdddddddddddddddddddddiiiiiidddeeeddddffhhhhhhhffaaaaaaakfddeddeddlaaaaaaaaaaaaaaaaaaaaaaaaaaaaaaaaaaaaaaaaaaaaaaaaaaaaaaaaaabb
bbddddddddddddddddddddiiiididdddeedddddfhhhhhhhhfaaaaaaaaafddeddeddaaaaaaaaaaaaaaaaaaaaaaaaaaaaaaaaaaaaaaaaaaaaaaaaaaaaaaaaaaabb
bbdddddddddddddddddddiiiiiiidddeeeddddffhhhhhhhffaaaaaaaaafddeddeddaaaaaaaaaaaaaaaaaaaaaaaaaaaaaaaaaaaaaaaaaaaaaaaaaaaaaaaaaaabb
bbddddddddddddddddddiiiiiiddddeeeeddddfhhhhhhhhfaaaaaaaaaafddeddeddaaaaaaaaaaaaaaaaaaaaaaaaaaaaaaaaaaaaaaaaaaaaaaaaaaaaaaaaaaabb
bbdddddddddddddddddiiiiiddddddeeedddddfhhhhhhhffaaaaaaaaakfddeddeddlaaaaaaaaaaaaaaaaaaaaaaaaaaaaaaaaaaaaaaaaaaaaaaaaaaaaaaaaaabb
bbdddddddddddddddiiiiiiddddddeeeedddddfhhhhhhffaaaaaaaaaaafddeddeddaaaaaaaaaaaaaaaaaaaaaaaaaaaaaaaaaaaaaaaaaaaaaaaaaaaaaaaaaaabb
bbddddddddddddddiiiiddddddddeeeeddddddfhhhhhhfaaaaaaaaaaaafddeddeddaaaaaaaaaaaaaaaaaaaaaaaaaaaaaaaaaaaaaaaaaaaaaaaaaaaaaaaaaaabb
bbdddddddddddddddiidddddeeeeeeedddddddfhhhhhhfaaaaaaaaaaaafddeddeddaaaaaaaaaaaaaaaaaaaaaaaaaaaaaaaaaaaaaaaaaaaaaaaaaaaaaaaaaaabb
bbddddddddddddddddddddeeeeeeeeddddddddfhhhhhhfaaaaaaaaaaakfddeddeddlaaaaaaaaaaaaaaaaaaaaaaaaaaaaaaaaaaaaaaaaaaaaaaaaaaaaaaaaaabb
bbdddddddddddddddddeeeeeeeeddddddiiiddffhhhhhfaaaaaaaaaaaafddeddeddaaaaaaaaaaaaaaaaaaaaaaaaaaaaaaaaaaaaaaaaaaaaaaaaaaaaaaaaaaabb
bbdddddddddddddddeeeeeedddddddddiiiidddfhhhhhfaaaaaaaaaaaafddeddeddaaaaaaaaaaaaaaaaaaaaaaaaaaaaaaaaaaaaaaaaaaaaaaaaaaaaaaaaaaabb
bbddddddddddddddeeeeeddddddddddiiiiiiddfhhhhhfaaaaaaaaaaaafddeddeddaaaaaaaaaaaaaaaaaaaaaaaaaaaaaaaaaaaaaaaaaaaaaaaaaaaaaaaaaaabb
bbdddddddddddddeeeedddddddddddiiiiiiiddfhhhhhfaaaaaaaaaaakfddeddeddlaaaaaaaaaaaaaaaaaaaaaaaaaaaaaaaaaaaaaaaaaaaaaaaaaaaaaaaaaabb
bbdddddddddddddeeedddddddddddiiiiiiiiddffhhhhfaaaaaaaaaaaafddeddeddaaaaaaaaaaaaaaaaaaaaaaaaaaaaaaaaaaaaaaaaaaaaaaaaaaaaaaaaaaabb
bbddddddddddddeeedddddiiddddiiiiiiiiddddfhhhhffaaaaaaaaaaafddeddeddaaaaaaaaaaaaaaaaaaaaaaaaaaaaaaaaaaaaaaaaaaaaaaaaaaaaaaaaaaabb
bbddddddddddddeedddddiiiiddiiiiiiiidddddfhhhhhfaaaaaaaaaaafddeddeddaaaaaaaaaaaaaaaaaaaaaaaaaaaaaaaaaaaaaaaaaaaaaaaaaaaaaaaaaaabb
bbddddddddddddeeeeddiiiiidddiiiiiddddddffhhhhffaaaaaaaaaakfddeddeddlaaaaaaaaaaaaaaaaaaaaaaaaaaaaaaaaaaaaaaaaaaaaaaaaaaaaaaaaaabb
bbddddddddddddeeeeddiiiiiddddddddddddddfhhhhhfaaaaaaaaaaaafddeddeddaaaaaaaaaaaaaaaaaaaaaaaaaaaaaaaaaaaaaaaaaaaaaaaaaaaaaaaaaaabb
bbdddddddddddeeeeddiiiiidddddddddddddfffhhhhffaaaaaaaaaaaafddeddeddaaaaaaaaaaaaaaaaaaaaaaaaaaaaaaaaaaaaaaaaaaaaaaaaaaaaaaaaaaabb
bbdddddddddddeeeeddiiiiiddddddddddffffhhhhhhhfaaaaaaaaaaaafddeddeddaaaaaaaaaaaaaaaaaaaaaaaaaaaaaaaaaaaaaaaaaaaaaaaaaaaaaaaaaaabb
bbdddddddddddeeeeddiiiddddddddddfffhhhhhhhhhhfaaaaaaaaaaakfddeddeddlaaaaaaaaaaaaaaaaaaaaaaaaaaaaaaaaaaaaaaaaaaaaaaaaaaaaaaaaaabb
bbdddddddddddeeeedddddddddddddfffhhhhhhhhhhhhffaaaaaaaaaaafddeddeddaaaaaaaaaaaaaaaaaaaaaaaaaaaaaaaaaaaaaaaaaaaaaaaaaaaaaaaaaaabb
bbdddddddddddeeeedddddddddddfffhhhhhhhhhhhhhhhffaaaaaaaaaafddeddeddaaaaaaaaaaaaaaaaaaaaaaaaaaaaaaaaaaaaaaaaaaaaaaaaaaaaaaaaaaabb
bbdddddddddddeeeeddddddddddffhhhhhhhhhhhhhhhhhhffaaaaaaaaafddeddeddaaaaaaaaaaaaaaaaaaaaaaaaaaaaaaaaaaaaaaaaaaaaaaaaaaaaaaaaaaabb
bbddddffffffffffffffffffffffhhhhhhhhhhhhhhhhhhhhffaajjjjjkfddeddeddljjjjjjaaaaaaaaaaaaaaaaaaaaaaaaaaaaaaaaaaaaaaaaaaaaaaaaaaaabb
bbdffffhhhhhhhhhhhhhhhhhhhhhhhhhhhhhhhhhhhhhhhhhhffjjjjjjjfddeddeddjjjjjjjjaaaaaaaaaaaaaaaaaaaaaaaaaaaaaaaaaaaaaaaaaaaaaaaaaaabb
bbffhhhhhhhhhhhhhhhhhhhhhhhhhhhhhhhhhhhhhhhhhhhhhhfjjjjjjjfddeddeddjjjjjjjjaaaaaaaaaaaaaaaaaaaaaaaaaaaaaaaaaaaaaaaaaaaaaaaaaaabb
bbhhhhhhhhhhhhhhhhhhhhhhhhhhhhhhhhhhhhhhhhhhhhhhhhhbbbbbbbbccccccccbbbbbbbbaaaaaaaaaaaaaaaaaaaaaaaaaaaaaaaaaaaaaaaaaaaaaaaaaaabb
bbhhhhhhhhhhhhhhhhhhhhhhhhhhhhhhhhhhhhhhhhhhhhhhhhhbbbbbbbbccccccccbbbbbbbbaaaaaaaaaaaaaaaaaaaaaaaaaaaaaaaaaaaaaaaaaaaaaaaaaaabb
bbhhhhhhhhhhhhhhhhhhhhhhhhhhhhhhhhhhhhhhhhhhhhhhhhhbbccccccccccccccccccccbbaaaaaaaaaaaaaaaaaaaaaaaaaaaaaaaaaaaaaaaaaaaaaaaaaaabb
bbhhhhhhhhhhhhhhhhhhhhhhhhhhhhhhhhhhhhhhhhhhhhhhhhhbbccccccccccccccccccccbbaaaaaaaaaaaaaaaaaaaaaaaaaaaaaaaaaaaaaaaaaaaaaaaaaaabb
bbhhhhhhhhhhhhhhhhhhhhhhhhhhhhhhhhhhhhhhhhhhhhhhhhhbbccccccccccccccccccccbbaaaaaaaaaaaaaaaaaaaaaaaaaaaaaaaaaaaaaaaaaaaaaaaaaaabb
bbhhhhhhhhhhhhhhhhhhhhhhhhhhhhhhhhhhhhhhhhhhhhhhhhhbbccccccccccccccccccccbbaaaaaaaaaaaaaaaaaaaaaaaaaaaaaaaaaaaaaaaaaaaaaaaaaaabb
bbhhhhhhhhhhhhhhhhhhhhhhhhhhhhhhhhhhhhhhhhhhhhhhhhhbbccccccccccccccccccccbbaaaaaaaaaaaaaaaaaaaaaaaaaaaaaaaaaaaaaaaaaaaaaaaaaaabb
bbhhhhhhhhhhhhhhhhhhhhhhhhhhhhhhhhhhhhhhhhhhhhhhhhhbbccccccccccccccccccccbbaaaaaaaaaaaaaaaaaaaaaaaaaaaaaaaaaaaaaaaaaaaaaaaaaaabb
bbhhhhhhhhhhhhhhhhhhhhhhhhhhhhhhhhhhhhhhhhhhhhhhhhhbbccccccccccccccccccccbbaaaaaaaaaaaaaaaaaaaaaaaaaaaaaaaaaaaaaaaaaaaaaaaaaaabb
bbhhhhhhhhhhhhhhhhhhhhhhhhhhhhhhhhhhhhhhhhhhhhhhhhhbbcccccccccgccccccccccbbaaaaaaaaaaaaaaaaaaaaaaaaaaaaaaaaaaaaaaaaaaaaaaaaaaabb
bbhhhhhhhhhhhhhhhhhhhhhhhhhhhhhhhhhhhhhhhhhhhhhhhhhbbccccccccccccccccccccbbaaaaaaaaaaaaaaaaaaaaaaaaaaaaaaaaaaaaaaaaaaaaaaaaaaabb
bbhhhhhhhhhhhhhhhhhhhhhhhhhhhhhhhhhhhhhhhhhhhhhhhhhbbccccccccccccccccccccbbaaaaaaaaaaaaaaaaaaaaaaaaaaaaaaaaaaaaaaaaaaaaaaaaaaabb
bbhhhhhhhhhhhhhhhhhhhhhhhhhhhhhhhhhhhhhhhhhhhhhhhhhbbccccccccccccccccccccbbaaaaaaaaaaaaaaaaaaaaaaaaaaaaaaaaaaaaaaaaaaaaaaaaaaabb
bbhhhhhhhhhhhhhhhhhhhhhhhhhhhhhhhhhhhhhhhhhhhhhhhhhbbccccccccccccccccccccbbaaaaaaaaaaaaaaaaaaaaaaaaaaaaaaaaaaaaaaaaaaaaaaaaaaabb
bbhhhhhhhhhhhhhhhhhhhhhhhhhhhhhhhhhhhhhhhhhhhhhhhhhbbccccccccccccccccccccbbaaaaaaaaaaaaaaaaaaaaaaaaaaaaaaaaaaaaaaaaaaaaaaaaaaabb
bbbbbbbbbbbbbbbbbbbbbbbbbbbbbbbbbbbbbbbbbbbbbbbbbbbbbbbbbccccccccccccbbbbbbbbbbbbbbbbbbbbbbbbbbbbbbbbbbbbbbbbbbbbbbbbbbbbbbbbbbb
bbbbbbbbbbbbbbbbbbbbbbbbbbbbbbbbbbbbbbbbbbbbbbbbbbbbbbbbbccccccccccccbbbbbbbbbbbbbbbbbbbbbbbbbbbbbbbbbbbbbbbbbbbbbbbbbbbbbbbbbbb
"}
