"a" = (/turf/simulated/wall/boss,/area/world/abyss/exterior)
"b" = (/turf/simulated/floor/colored/ash/rocky,/area/world/abyss/exterior)
"c" = (/turf/simulated/floor/colored/necro_grass,/area/world/abyss/exterior)
"d" = (/turf/simulated/floor/colored/ash/necro,/area/world/abyss/exterior)

(1,1,1) = {"
aaaaaaaaaaaaaaaaaaaaaaaaaaaaaaaaaaaaaaaaaaaaaaaaaaaaaaaaaaaaaaaaaaaaaaaaaaaaaaaaaaaaaaaaaaaaaaaaaaaaaaaaaaaaaaaaaaaaaaaaaaaaaaaa
aaaaaaaaaaaaaaaaaaaaaaaaaaaaaaaaaaaaaaaaaaaaaaaaaaaaaaaaaaaaaaaaaaaaaaaaaaaaaaaaaaaaaaaaaaaaaaaaaaaaaaaaaaaaaaaaaaaaaaaaaaaaaaaa
aabbbbbbaabbbbbbbabbbbbbbbabbbbbbbbbabbbbbbbbbbabbbbbbabbbbbbbbabbbbbbbbabbbbbbbbbbabbbbbbbabbbbbbbabbbbbbbabbbbbbbbbbaabbbbbbaa
aabbbbbbaabbbbbbbabbbbbbbbabbbbbbbbbabbbbbbbbbbabbbbbbabbbbbbbbabbbbbbbbabbbbbbbbbbabbbbbbbabbbbbbbabbbbbbbabbbbbbbbbbaabbbbbbaa
aabbbbbbaabbbbbbbabbbbbbbbabbbbbbbbbabbbbbbbbbbabbbbbbabbbbbbbbabbbbbbbbabbbbbbbbbbabbbbbbbabbbbbbbabbbbbbbabbbbbbbbbbaabbbbbbaa
aabbbbbbaabbbbbbbabbbbbbbbabbbbbbbbbabbbbbbbbbbabbbbbbabbbbbbbbabbbbbbbbabbbbbbbbbbabbbbbbbabbbbbbbabbbbbbbabbbbbbbbbbaabbbbbbaa
aabbbbbbaabbbbbbbabbbbbbbbabbbbbbbbbabbbbbbbbbbabbbbbbabbbbbbbbabbbbbbbbabbbbbbbbbbabbbbbbbabbbbbbbabbbbbbbabbbbbbbbbbaabbbbbbaa
aabbbbbbaabbbbbbbabbbbbbbbabbbbbbbbbabbbbbbbbbbabbbbbbabbbbbbbbabbbbbbbbabbbbbbbbbbabbbbbbbabbbbbbbabbbbbbbabbbbbbbbbbaabbbbbbaa
aaaaaaaaaaaaaaaaaaaaaaaaaaaaaaaaaaaaaaaaaaaaaaaaaaaaaaaaaaaaaaaaaaaaaaaaaaaaaaaaaaaaaaaaaaaaaaaaaaaaaaaaaaaaaaaaaaaaaaaaaaaaaaaa
aaaaaaaaaaaaaaaaaaaaaaaaaaaaaaaaaaaaaaaaaaaaaaaaaaaaaaaaaaaaaaaaaaaaaaaaaaaaaaaaaaaaaaaaaaaaaaaaaaaaaaaaaaaaaaaaaaaaaaaaaaaaaaaa
aabbbbbbaabbbbbbbbbbbbbbbbbbbbbbbbbbbbbbbbbbbbbbbbbbbbbbbbbbbbbbbbbbbbbbbbbbbbbbbbbbbbbbbbbbbbbbbbbbbbbbbbbbbbbbbbbbbbaabbbbbbaa
aabbbbbbaabbbbbbbbbbbbbbbbbbbbbbbbbbbbbbbbbbbbbbbbbbbbbbbbbbbbbbbbbbbbbbbbbbbbbbbbbbbbbbbbbbbbbbbbbbbbbbbbbbbbbbbbbbbbaabbbbbbaa
aabbbbbbaabbbbbbbbbbbbbbbbbbbbbbbbbbbbbbbbbbbbbbbbbbbbbbbbbbbbbbbbbbbbbbbbbbbbbbbbbbbbbbbbbbbbbbbbbbbbbbbbbbbbbbbbbbbbaabbbbbbaa
aabbbbbbaabbbbbbbbbbbbbbbbbbbbbbbbbbbbbbbbbbbbbbbbbbbbbbbbbbbbbbbbbbbbbbbbbbbbbbbbbbbbbbbbbbbbbbbbbbbbbbbbbbbbbbbbbbbbaabbbbbbaa
aabbbbbbaabbbbbbbbbbbbbbbbbbbbbbbbbbbbbbbbbbbbbbbbbbbbbbbbbbbbbbbbbbbbbbbbbbbbbbbbbbbbbbbbbbbbbbbbbbbbbbbbbbbbbbbbbbbbaabbbbbbaa
aabbbbbbaabbbbbbbbbbbbbbbbbbbbbbbbbbbbbbbbbbbbbbbbbbbbbbbbbbbbbbbbbbbbbbbbbbbbbbbbbbbbbbbbbbbbbbbbbbbbbbbbbbbbbbbbbbbbaabbbbbbaa
aabbbbbbaabbbbbbbbbbbbbbbbbbbbbbbbbbbbbbbbbbbbbbbbbbbbbbbbbbbbbbbbbbbbbbbbbbbbbbbbbbbbbbbbbbbbbbbbbbbbbbbbbbbbbbbbbbbbaabbbbbbaa
aabbbbbbaabbbbbbbbbbbbbbbbbbbbbbbbbbbbbbbbbbbbbbbbbbbbbbbbbbbbbbbbbbbbbbbbbbbbbbbbbbbbbbbbbbbbbbbbbbbbbbbbbbbbbbbbbbbbaabbbbbbaa
aaaaaaaaaabbbbbbbbbbbbbbbbbbbbbbbbbbbbbbbbbbbbbbbbbbbbbbbbbbbbbbbbbbbbbbbbbbbbbbbbbbbbbbbbbbbbbbbbbbbbbbbbbbbbbbbbbbbbaabbbbbbaa
aabbbbbbaabbbbbbbbbbbbbbbbbbbbbbbbbbbbbbbbbbbbbbbbbbbbbbbbbbbbbbbbbbbbbbbbbbbbbbbbbbbbbbbbbbbbbbbbbbbbbbbbbbbbbbbbbbbbaabbbbbbaa
aabbbbbbaabbbbbbbbbbbbbbbbbbbbbbbbbbbbbbbbbbbbbbbbbbbbbbbbbbbbbbbbbbbbbbbbbbbbbbbbbbbbbbbbbbbbbbbbbbbbbbbbbbbbbbbbbbbbaabbbbbbaa
aabbbbbbaabbbbbbbbbbbbbbbbbbbbbbbbbbbbbbbbbbbbbbbbbbbbbbbbbbbbbbbbbbbbbbbbbbbbbbbbbbbbbbbbbbbbbbbbbbbbbbbbbbbbbbbbbbbbaaaaaaaaaa
aabbbbbbaabbbbbbbbbbbbbbbbbbbbbbbbbbbbbbbbbbbbbbbbbbbbbbbbbbbbbbbbbbbbbbbbbbbbbbbbbbbbbbbbbbbbbbbbbbbbbbbbbbbbbbbbbbbbaabbbbbbaa
aabbbbbbaabbbbbbbbbbbbbbbbbbbbbbbbbbbbbbbbbbbbbbbbbbbbbbbbbbbbbbbbbbbbbbbbbbbbbbbbbbbbbbbbbbbbbbbbbbbbbbbbbbbbbbbbbbbbaabbbbbbaa
aabbbbbbaabbbbbbbbbbbbbbbbbbbbbbbbbbbbbbbbbbbbbbbbbbbbbbbbbbbbbbbbbbbbbbbbbbbbbbbbbbbbbbbbbbbbbbbbbbbbbbbbbbbbbbbbbbbbaabbbbbbaa
aabbbbbbaaaaaaaaaaaaaaaaaaaaaaaaaaaaaaaaaaaaaaaaaaaaaaaaaaaaaaaaaaaaaaaaaaaaaaaaaaaaaaaaaaaaaaaaaaaaaaaaaaaaaaaaaaaaaaaabbbbbbaa
aaaaaaaaaaaaaaaaaaaaaaaaaaaaaaaaaaaaaaaaaaaaaaaaaaaaaaaaaaaaaaaaaaaaaaaaaaaaaaaaaaaaaaaaaaaaaaaaaaaaaaaaaaaaaaaaaaaaaaaabbbbbbaa
aabbbbbbaabbbbbbbbbbbbbbbbbbbbbbbbbbbbbbbbbbbbbbbbbbbbbbbbbbbbbbbbbbbbbbbbbbbbbbbbbbbbbbbbbbbbbbbbbbbbbbbbbbbbbbbbbbbbaaaaaaaaaa
aabbbbbbaabbbbbbbbbbbbbbbbbbbbbbbbbbbbbbbbbbbbbbbbbbbbbbbbbbbbbbbbbbbbbbbbbbbbbbbbbbbbbbbbbbbbbbbbbbbbbbbbbbbbbbbbbbbbaabbbbbbaa
aabbbbbbaabbbbbbbbbbbbbbbbbbbbbbbbbbbbbbbbbbbbbbbbbbbbbbbbbbbbbbbbbbbbbbbbbbbbbbbbbbbbbbbbbbbbbbbbbbbbbbbbbbbbbbbbbbbbaabbbbbbaa
aabbbbbbaabbbcccccccccbbbccccccccccbbbaaaaaaaaaaaaaaaaabbbbbbbbbbbbbbbbbbbbbbbbbbbbbbbbbbbbbbbbbbbbbbbbbbbbbbbbbbbbbbbaabbbbbbaa
aabbbbbbaabbbcccccccccbbbccccccccccbbbadddddddddddddddabbbbbbbbbbbbbbbbbbbbbbbbbbbbbbbbbbbbbbbbbbbbbbbbbbbbbbbbbbbbbbbaabbbbbbaa
aabbbbbbaabbbcccccccccbbbccccccccccbbbadddddddddddddddabbbbbbbbbbbbbbbbbbbbbbbbbbbbbbbbbbbbbbbbbbbbbbbbbbbbbbbbbbbbbbbaabbbbbbaa
aabbbbbbaabbbcccccccccbbbccccccccccbbbadddddddddddddddabbbbbbbbbbbbbbbbbbbbbbbbbbbbbbbbbbbbbbbbbbbbbbbbbbbbbbbbbbbbbbbaaaaaaaaaa
aabbbbbbaabbbcccccccccbbbccccccccccbbbadddddddddddddddabbbbbbbbbbbbbbbbbbbbbbbbbbbbbbbbbbbbbbbbbbbbbbbbbbbbbbbbbbbbbbbaabbbbbbaa
aabbbbbbaabbbcccccccccbbbccccccccccbbbadddddddddddddddabbbaaaaaaaaaaaaaabbbaaaaaaaaaaaaaaaaaaaabbbbbbbbbbbbbbbbbbbbbbbaabbbbbbaa
aabbbbbbaabbbcccccccccbbbccccccccccbbbadddddddddddddddabbbaddddddddddddabbbaddddddddddddddddddabbbbbbbbbbbbbbbbbbbbbbbaabbbbbbaa
aaaaaaaaaabbbaaaaaaaaabbbaaaaaaaaaabbbadddddddddddddddabbbaddddddddddddabbbaddddddddddddddddddabbbaaaaaaaaaaaaaaaaabbbaabbbbbbaa
aabbbbbbaabbbadddddddabbbaddddddddabbbadddddddddddddddabbbaddddddddddddabbbaddddddddddddddddddabbbadddddddddddddddabbbaabbbbbbaa
aabbbbbbaabbbadddddddabbbaddddddddabbbadddddddddddddddabbbaddddddddddddabbbaddddddddddddddddddabbbadddddddddddddddabbbaaaaaaaaaa
aabbbbbbaabbbadddddddabbbaddddddddabbbadddddddddddddddabbbaddddddddddddabbbaddddddddddddddddddabbbadddddddddddddddabbbaabbbbbbaa
aabbbbbbaabbbadddddddabbbaddddddddabbbadddddddddddddddabbbaddddddddddddabbbaddddddddddddddddddabbbadddddddddddddddabbbaabbbbbbaa
aabbbbbbaabbbadddddddabbbaddddddddabbbadddddddddddddddabbbaaaaaaaaaaaaaabbbaaaaaaaaaaaaaaaaaaaabbbadddddddddddddddabbbaabbbbbbaa
aabbbbbbaabbbadddddddabbbaddddddddabbbadddddddddddddddabbbbbbbbbbbbbbbbbbbbbbbbbbbbbbbbbbbbbbbbbbbadddddddddddddddabbbaabbbbbbaa
aabbbbbbaabbbadddddddabbbaddddddddabbbadddddddddddddddabbbbbbbbbbbbbbbbbbbbbbbbbbbbbbbbbbbbbbbbbbbadddddddddddddddabbbaabbbbbbaa
aabbbbbbaabbbadddddddabbbaddddddddabbbadddddddddddddddabbbbbbbbbbbbbbbbbbbbbbbbbbbbbbbbbbbbbbbbbbbadddddddddddddddabbbaabbbbbbaa
aabbbbbbaabbbadddddddabbbaaaaaaaaaabbbaaaaaaaaaaaaaaaaabbbaaaaaaaaaaaaaabbbbbbccccaaaaaaaaaccccbbbadddddddddddddddabbbaabbbbbbaa
aabbbbbbaabbbadddddddabbbbbbbbbbbbbbbbbbbbbbbbbbbbbbbbbbbbaddddddddddddabbbbbbccccadddddddaccccbbbadddddddddddddddabbbaaaaaaaaaa
aaaaaaaaaabbbadddddddabbbbbbbbbbbbbbbbbbbbbbbbbbbbbbbbbbbbaddddddddddddabbbbbbccccadddddddaccccbbbadddddddddddddddabbbaabbbbbbaa
aabbbbbbaabbbadddddddabbbbbbbbbbbbbbbbbbbbbbbbbbbbbbbbbbbbaddddddddddddabbbbbbccccadddddddaccccbbbadddddddddddddddabbbaabbbbbbaa
aabbbbbbaabbbadddddddabbbbaaaaaaaaaabbbaaaaaaaaaaaaaaaabbbaddddddddddddabbbbbbccccadddddddaccccbbbadddddddddddddddabbbaabbbbbbaa
aabbbbbbaabbbadddddddabbbbaddddddddabbbaddddddddddddddabbbaddddddddddddabbbbbbccccadddddddaccccbbbadddddddddddddddabbbaabbbbbbaa
aabbbbbbaabbbadddddddabbbbaddddddddabbbaddddddddddddddabbbaddddddddddddabbbbbbccccadddddddaccccbbbadddddddddddddddabbbaabbbbbbaa
aabbbbbbaabbbadddddddabbbbaddddddddabbbaddddddddddddddabbbaddddddddddddabbbbbbccccaaaaaaaaaccccbbbaaaaaaaaaaaaaaaaabbbaabbbbbbaa
aabbbbbbaabbbaaaaaaaaabbbbaddddddddabbbaddddddddddddddabbbaaaaddddddaaaabbbbbbbbbbbbbbbbbbbbbbbbbbbbbbbbbbbbbbbbbbbbbbaabbbbbbaa
aabbbbbbaabbbbbbbbbbbbbbbbaddddddddabbbaddddddddddddddabbbbbbaddddddabbbbbbbbbbbbbbbbbbbbbbbbbbbbbbbbbbbbbbbbbbbbbbbbbaaaaaaaaaa
aabbbbbbaabbbbbbbbbbbbbbbbaddddddddabbbaddddddddddddddabbbbbbaddddddabbbbbbbbbbbbbbbbbbbbbbbbbbbbbbbbbbbbbbbbbbbbbbbbbaabbbbbbaa
aaaaaaaaaabbbbbbbbbbbbbbbbaddddddddabbbaddddddaaaaaaaaabbbaaaaddddddaaaabbbbbbaaaaaaaaaaaaaaaaabbbaaaaaaabbbaaaaaaabbbaabbbbbbaa
aabbbbbbaabbbaaaaaaacccbbbaddddddddabbbaddddddaccccccccbbbaddddddddddddabbbbbbadddddddddddddddabbbadddddabbbadddddabbbaabbbbbbaa
aabbbbbbaabbbadddddacccbbbaddddddddabbbaddddddaccccccccbbbaddddddddddddabbbbbbadddddddddddddddabbbadddddabbbadddddabbbaabbbbbbaa
aabbbbbbaabbbadddddacccbbbaddddddddabbbaddddddaccccccccbbbaddddddddddddabbbbbbadddddddddddddddabbbadddddabbbadddddabbbaaaaaaaaaa
aabbbbbbaabbbadddddacccbbbaddddddddabbbaddddddabbbbbbbbbbbaddddddddddddabbbbbbadddddddddddddddabbbadddddabbbadddddabbbaabbbbbbaa
aabbbbbbaabbbadddddacccbbbaddddddddabbbaddddddabbbbbbbbbbbaddddddddddddabbbbbbadddddddddddddddabbbadddddabbbadddddabbbaabbbbbbaa
aabbbbbbaabbbadddddacccbbbaddddddddabbbaddddddabbbbbbbbbbbaddddddddddddabbbbbbadddddddddddddddabbbadddddabbbadddddabbbaabbbbbbaa
aabbbbbbaabbbadddddacccbbbaddddddddabbbaddddddabbbaaaaabbbaddddddddddddabbbbbbadddddddddddddddabbbadddddabbbadddddabbbaabbbbbbaa
aabbbbbbaabbbadddddacccbbbaaaaaaaaaabbbaaaaaaaabbbadddabbbaaaaaaaaaaaaaabbbbbbadddddddddddddddabbbadddddabbbadddddabbbaabbbbbbaa
aaaaaaaaaabbbaaaaaaaaaabbbbbbbbbbbbbbbbbbbbbbbbbbbadddabbbbbbbbbbbbbbbbbbbbbbbadddddddddddddddabbbadddddabbbadddddabbbaabbbbbbaa
aabbbbbbaabbbaddddddddabbbbbbbbbbbbbbbbbbbbbbbbbbbadddabbbbbbbbbbbbbbbbbbbbbbbadddddddddddddddabbbadddddabbbadddddabbbaabbbbbbaa
aabbbbbbaabbbaddddddddabbbbbbbbbbbbbbbbbbbbbbbbbbbadddabbbbbbbbbbbbbbbbbbbbbbbadddddddddddddddabbbadddddabbbadddddabbbaaaaaaaaaa
aabbbbbbaabbbaddddddddaaaaaaaaabbbaaaaaaaaabbbaaaaadddaaaaabbbaaaaaaaaaabbbbbbadddddddddddddddabbbadddddabbbadddddabbbaabbbbbbaa
aabbbbbbaabbbaddddddddadddddddabbbadddddddabbbadddddddddddabbbaddddddddabbbbbbadddddddddddddddabbbadddddabbbadddddabbbaabbbbbbaa
aabbbbbbaabbbaddddddddadddddddabbbadddddddabbbadddddddddddabbbaddddddddabbbbbbaaaaaaaaaaaaaaaaabbbaaaaaaabbbaaaaaaabbbaabbbbbbaa
aabbbbbbaabbbaddddddddadddddddabbbadddddddabbbadddddddddddabbbaddddddddabbbbbbbbbbbbbbbbbbbbbbbbbbbbbbbbbbbbbbbbbbbbbbaabbbbbbaa
aabbbbbbaabbbaddddddddadddddddabbbadddddddabbbadddddddddddabbbaddddddddabbbbbbbbbbbbbbbbbbbbbbbbbbbbbbbbbbbbbbbbbbbbbbaabbbbbbaa
aabbbbbbaabbbaddddddddadddddddabbbadddddddabbbadddddddddddabbbaddddddddabbbbbbbbbbbbbbbbbbbbbbbbbbbbbbbbbbbbbbbbbbbbbbaabbbbbbaa
aaaaaaaaaabbbaaaaaaaaaaaaaaaaaabbbaaaaaaaaabbbaaaaadddaaaaabbbaddddddddabbbbbbcccaaaaaaaaaaaaaabbbaaaaaaaaaaaaaaaaabbbaabbbbbbaa
aabbbbbbaabbbbbbbbbbbbbbbbbbbbbbbbbbbbbbbbbbbbbbbbbbbbbbbbbbbbaaaaaaaaaabbbbbbcccaddddddddddddabbbadddddddddddddddabbbaaaaaaaaaa
aabbbbbbaabbbbbbbbbbbbbbbbbbbbbbbbbbbbbbbbbbbbbbbbbbbbbbbbbbbbbbbbbbbbbbbbbbbbcccaddddddddddddabbbadddddddddddddddabbbaabbbbbbaa
aabbbbbbaabbbbbbbbbbbbbbbbbbbbbbbbbbbbbbbbbbbbbbbbbbbbbbbbbbbbbbbbbbbbbbbbbbbbcccaddddddddddddabbbadddddddddddddddabbbaabbbbbbaa
aabbbbbbaabbbaaaaaabbbaaaaaaaaaabbbaaaaaaaaaaaaaaaabbbbbbbbbbbbbbbbbbbbbbbbbbbcccaddddddddddddabbbadddddddddddddddabbbaabbbbbbaa
aabbbbbbaabbbaddddabbbaddddddddabbbaddddddddddddddabbbaaaaaaaaabbbaaaaaabbbbbbcccaddddddddddddabbbadddddddddddddddabbbaabbbbbbaa
aabbbbbbaabbbadddddbbbaddddddddabbbaddddddddddddddabbbadddddddabbbaddddabbbbbbcccaaaaaaaadddddabbbadddddddddddddddabbbaabbbbbbaa
aabbbbbbaabbbadddddbbbaddddddddabbbaddddddddddddddabbbadddddddabbbaddddabbbbbbccccccccccadddddabbbadddddddddddddddabbbaabbbbbbaa
aabbbbbbaabbbaddddabbbaddddddddabbbaddddddddddddddabbbadddddddabbbaddddabbbbbbccccccccccadddddabbbadddddddddddddddabbbaabbbbbbaa
aaaaaaaaaabbbaaaaaabbbaddddddddabbbaddddddddddddddabbbadddddddabbbaddddabbbbbbccccccccccadddddabbbadddddddddddddddabbbaabbbbbbaa
aabbbbbbaabbbccccccbbbaddddddddabbbaddddddddddddddabbbadddddddabbbaddddabbbbbbbbbbbbbbbbadddddabbbadddddddddddddddabbbaabbbbbbaa
aabbbbbbaabbbccccccbbbaaaaaaaaaabbbaaaaaaaaaaaaaaaabbbadddddddabbbaaaaaabbbbbbbbbbbbbbbbadddddabbbadddddddddddddddabbbaaaaaaaaaa
aabbbbbbaabbbccccccbbbbbbbbbbbbbbbbbbbbbbbbbbbbbbbbbbbaaaaaaaaabbbbbbbbbbbbbbbbbbbbbbbbbadddddabbbadddddddddddddddabbbaabbbbbbaa
aabbbbbbaabbbaaaaaabbbbbbbbbbbbbbbbbbbbbbbbbbbbbbbbbbbbbbbbbbbbbbbbbbbbbbbbbbbcccccccbbbaaaaaaabbbaaaaaaaaaaaaaaaaabbbaabbbbbbaa
aabbbbbbaabbbaddddabbbbbbbbbbbbbbbbbbbbbbbbbbbbbbbbbbbbbbbbbbbbbbbbbbbbbbbbbbbcccccccbbbbbbbbbbbbbbbbbbbbbbbbbbbbbbbbbaabbbbbbaa
aabbbbbbaabbbadddddbbbbaaaaaaaaabbbaaaaaaaaacccccccbbbbbbbbbbbbbbbcccccccccbbbcccccccbbbbbbbbbbbbbbbbbbbbbbbbbbbbbbbbbaabbbbbbaa
aabbbbbbaabbbadddddbbbbadddddddaaaaadddddddacccccccbbbaaaaaaaaabbbcccccccccbbbaaaaaaabbbbbbbbbbbbbbbbbbbbbbbbbbbbbbbbbaabbbbbbaa
aabbbbbbaabbbaddddabbbbadddddddddddddddddddacccccccbbbadddddddabbbcccccccccbbbadddddabbbaaaaaaaaaabbbaaaaaaaaaaaaaabbbaaaaaaaaaa
aaaaaaaaaabbbaaaaaabbbbaddddddddddddddddddddbbbbbbbbbbadddddddabbbcccccccccbbbadddddabbbaddddddddabbbaddddddddddddabbbaabbbbbbaa
aabbbbbbaabbbbbbbbbbbbbaddddddddddddddddddddbbbbbbbbbbadddddddabbbcccccccccbbbadddddabbbaddddddddabbbaddddddddddddabbbaabbbbbbaa
aabbbbbbaabbbbbbbbbbbbbaddddddddddddddddddddbbbbbbbbbbadddddddabbbcccccccccbbbadddddabbbaddddddddabbbaddddddddddddabbbaabbbbbbaa
aabbbbbbaabbbbbbbbbbbbbadddddddddddddddddddacccccccbbbaaaaaaaaabbbcccccccccbbbadddddabbbaddddddddabbbaddddddddddddabbbaabbbbbbaa
aabbbbbbaabbbaaaaaaabbbadddddddaaaaadddddddacccccccbbbbbbbbbbbbbbbcccccccccbbbadddddabbbaddddddddabbbaddddddddddddabbbaabbbbbbaa
aabbbbbbaabbbadddddabbbaaaaaaaaabbbaaaaaaaaacccccccbbbbbbbbbbbbbbbcccccccccbbbaaaaaaabbbaddddddddabbbaddddddddddddabbbaabbbbbbaa
aabbbbbbaabbbadddddabbbbbbbbbbbbbbbbbbbbbbbbbbbbbbbbbbbbbbbbbbbbbbcccccccccbbbbbbbbbbbbbaddddddddabbbaddddddddddddabbbaabbbbbbaa
aabbbbbbaabbbadddddabbbbbbbbbbbbbbbbbbbbbbbbbbbbbbbbbbaaaaaaaaabbbcccccccccbbbbbbbbbbbbbaddddddddabbbaddddddddddddabbbaabbbbbbaa
aabbbbbbaabbbadddddabbbbbbbbbbbbbbbbbbbbbbbbbbbbbbbbbbadddddddabbbcccccccccbbbbbbbbbbbbbaddddddddabbbaddddddddddddabbbaabbbbbbaa
aaaaaaaaaabbbadddddaccccccccbbbaaaaaaaaaabbbaaaaaaabbbadddddddabbbcccccccccbbbaaaaaaaaaaaddddddddabbbaddddddddddddabbbaaaaaaaaaa
aabbbbbbaabbbadddddaccccccccbbbaddddddddabbbadddddabbbaaadddaaabbbcccccccccbbbaddddddddddddddddddabbbaddddddddddddabbbaabbbbbbaa
aabbbbbbaabbbadddddaccccccccbbbaddddddddabbbadddddabbbbbadddabbbbbcccccccccbbbaddddddddddddddddddabbbaddddddddddddabbbaabbbbbbaa
aabbbbbbaabbbadddddaaaaaaaaabbbaddddddddabbbadddddabbbbbadddabbbbbcccccccccbbbaddddddddddddddddddabbbaddddddddddddabbbaabbbbbbaa
aabbbbbbaabbbadddddddddddddabbbaddddddddabbbadddddabbbbbadddabbbbbcccccccccbbbaddddddddddddddddddabbbaddddddddddddabbbaabbbbbbaa
aabbbbbbaabbbadddddddddddddabbbaddddddddabbbadddddabbbaaadddaaabbbcccccccccbbbaddddddddddddddddddabbbaddddddddddddabbbaabbbbbbaa
aabbbbbbaabbbadddddddddddddabbbaddddddddabbbadddddabbbadddddddabbbcccccccccbbbaddddddddddddddddddabbbaddddddddddddabbbaabbbbbbaa
aabbbbbbaabbbadddddddddddddabbbaddddddddabbbadddddabbbadddddddabbbcccccccccbbbaddddddddddddddddddabbbaddddddddddddabbbaabbbbbbaa
aaaaaaaaaabbbadddddddddddddabbbaddddddddabbbadddddabbbadddddddabbbcccccccccbbbaddddddddddddddddddabbbaddddddddddddabbbaaaaaaaaaa
aabbbbbbaabbbaaaaaaaaaaaaaaabbbaaaaaaaaaabbbaaaaaaabbbaaaaaaaaabbbcccccccccbbbaaaaaaaaaaaaaaaaaaaabbbaaaaaaaaaaaaaabbbaabbbbbbaa
aabbbbbbaabbbbbbbbbbbbbbbbbbbbbbbbbbbbbbbbbbbbbbbbbbbbbbbbbbbbbbbbbbbbbbbbbbbbbbbbbbbbbbbbbbbbbbbbbbbbbbbbbbbbbbbbbbbbaabbbbbbaa
aabbbbbbaabbbbbbbbbbbbbbbbbbbbbbbbbbbbbbbbbbbbbbbbbbbbbbbbbbbbbbbbbbbbbbbbbbbbbbbbbbbbbbbbbbbbbbbbbbbbbbbbbbbbbbbbbbbbaabbbbbbaa
aabbbbbbaabbbbbbbbbbbbbbbbbbbbbbbbbbbbbbbbbbbbbbbbbbbbbbbbbbbbbbbbbbbbbbbbbbbbbbbbbbbbbbbbbbbbbbbbbbbbbbbbbbbbbbbbbbbbaabbbbbbaa
aabbbbbbaabbbbbbbbbbbbbbbbbbbbbbbbbbbbbbbbbbbbbbbbbbbbbbbbbbbbbbbbbbbbbbbbbbbbbbbbbbbbbbbbbbbbbbbbbbbbbbbbbbbbbbbbbbbbaabbbbbbaa
aabbbbbbaabbbbbbbbbbbbbbbbbbbbbbbbbbbbbbbbbbbbbbbbbbbbbbbbbbbbbbbbbbbbbbbbbbbbbbbbbbbbbbbbbbbbbbbbbbbbbbbbbbbbbbbbbbbbaabbbbbbaa
aabbbbbbaabbbbbbbbbbbbbbbbbbbbbbbbbbbbbbbbbbbbbbbbbbbbbbbbbbbbbbbbbbbbbbbbbbbbbbbbbbbbbbbbbbbbbbbbbbbbbbbbbbbbbbbbbbbbaabbbbbbaa
aaaaaaaaaaaaaaaaaaaaaaaaaaaaaaaaaaaaaaaaaaaaaaaaaaaaaaaaabbbbbbbbbbbbaaaaaaaaaaaaaaaaaaaaaaaaaaaaaaaaaaaaaaaaaaaaaaaaaaaaaaaaaaa
aaaaaaaaaaaaaaaaaaaaaaaaaaaaaaaaaaaaaaaaaaaaaaaaaaaaaaaaabbbbbbbbbbbbaaaaaaaaaaaaaaaaaaaaaaaaaaaaaaaaaaaaaaaaaaaaaaaaaaaaaaaaaaa
aabbbbbbaabbbbbbbbbbbbbbbbbbbbbbbbbbbbbbbbbbbbbbbbbbbbbaabbbbbbbbbbbbaabbbbbbbbbbbbbbbbbbbbbbbbbbbbbbbbbbbbbbbbbbbbbbbaabbbbbbaa
aabbbbbbaabbbbbbbbbbbbbbbbbbbbbbbbbbbbbbbbbbbbbbbbbbbbbaabbbbbbbbbbbbaabbbbbbbbbbbbbbbbbbbbbbbbbbbbbbbbbbbbbbbbbbbbbbbaabbbbbbaa
aabbbbbbaabbbbbbbbbbbbbbbbbbbbbbbbbbbbbbbbbbbbbbbbbbbbbaabbbbbbbbbbbbaabbbbbbbbbbbbbbbbbbbbbbbbbbbbbbbbbbbbbbbbbbbbbbbaabbbbbbaa
aabbbbbbaabbbbbbbbbbbbbbbbbbbbbbbbbbbbbbbbbbbbbbbbbbbbbaabbbbbbbbbbbbaabbbbbbbbbbbbbbbbbbbbbbbbbbbbbbbbbbbbbbbbbbbbbbbaabbbbbbaa
aabbbbbbaabbbbbbbbbbbbbbbbbbbbbbbbbbbbbbbbbbbbbbbbbbbbbaabbbbbbbbbbbbaabbbbbbbbbbbbbbbbbbbbbbbbbbbbbbbbbbbbbbbbbbbbbbbaabbbbbbaa
aabbbbbbaabbbbbbbbbbbbbbbbbbbbbbbbbbbbbbbbbbbbbbbbbbbbbaabbbbbbbbbbbbaabbbbbbbbbbbbbbbbbbbbbbbbbbbbbbbbbbbbbbbbbbbbbbbaabbbbbbaa
aaaaaaaaaaaaaaaaaaaaaaaaaaaaaaaaaaaaaaaaaaaaaaaaaaaaaaaaabbbbbbbbbbbbaaaaaaaaaaaaaaaaaaaaaaaaaaaaaaaaaaaaaaaaaaaaaaaaaaaaaaaaaaa
aaaaaaaaaaaaaaaaaaaaaaaaaaaaaaaaaaaaaaaaaaaaaaaaaaaaaaaaabbbbbbbbbbbbaaaaaaaaaaaaaaaaaaaaaaaaaaaaaaaaaaaaaaaaaaaaaaaaaaaaaaaaaaa
"}
