"a" = (/turf/simulated/floor/chasm,/area/world/mountain/weather)
"b" = (/turf/simulated/wall/rock/snow,/area/world/mountain/weather)
"c" = (/turf/simulated/floor/colored/snow,/area/world/mountain/weather)
"d" = (/turf/simulated/floor/ice,/area/world/mountain/weather)
"e" = (/obj/structure/scenery/snow_bush,/turf/simulated/floor/colored/snow,/area/world/mountain/weather)
"f" = (/obj/structure/scenery/pinetrees,/turf/simulated/floor/colored/snow,/area/world/mountain/weather)
"g" = (/obj/structure/interactive/lighting/streetlamp/snow,/turf/simulated/floor/colored/snow,/area/world/mountain/weather)
"h" = (/obj/marker/mob_spawn/cult/behemoth,/turf/simulated/floor/colored/snow,/area/world/mountain/weather)
"i" = (/obj/marker/mob_spawn/cult/artificer,/turf/simulated/floor/colored/snow,/area/world/mountain/weather)
"j" = (/obj/marker/mob_spawn/cult/cultist,/turf/simulated/floor/colored/snow,/area/world/mountain/weather)
"k" = (/obj/structure/scenery/snow_grass,/turf/simulated/floor/colored/snow,/area/world/mountain/weather)
"n" = (/turf/simulated/floor/colored/dirt/snow,/area/world/mountain/weather)
"o" = (/obj/marker/mob_spawn/cult/artificer,/turf/simulated/floor/ice,/area/world/mountain/weather)
"p" = (/obj/marker/mob_spawn/cult/cultist,/turf/simulated/floor/ice,/area/world/mountain/weather)
"q" = (/turf/simulated/floor/cave_dirt,/area/world/mountain/cave)
"r" = (/turf/simulated/wall/rock,/area/world/mountain/cave)
"s" = (/obj/structure/scenery/rocks,/turf/simulated/floor/colored/dirt/snow,/area/world/mountain/weather)
"t" = (/turf/simulated/floor/colored/snow,/area/world/mountain/village)
"u" = (/turf/simulated/wall/wood/brown,/area/world/mountain/village/interior/bar)
"v" = (/obj/structure/scenery/snow_grass,/turf/simulated/floor/colored/snow,/area/world/mountain/village)
"w" = (/turf/simulated/wall/wood/brown,/area/world/forest/village/cave)
"x" = (/turf/simulated/floor/chasm,/area/world/mountain)
"y" = (/turf/simulated/wall/rock/snow,/area/world/mountain)
"z" = (/turf/simulated/wall/rock,/area/world/mountain)
"A" = (/turf/simulated/floor/cave_dirt,/area/world/forest/village/cave)
"B" = (/turf/simulated/wall/rock,/area/world/forest/village/cave)
"C" = (/obj/structure/scenery/rocks,/turf/simulated/floor/cave_dirt,/area/world/forest/village/cave)
"D" = (/turf/simulated/floor/colored/dirt/snow,/area/world/mountain/village)
"E" = (/turf/simulated/floor/ice,/area/world/mountain/village)
"F" = (/obj/structure/scenery/pinetrees,/turf/simulated/floor/colored/snow,/area/world/mountain/village)
"G" = (/obj/structure/interactive/lighting/streetlamp,/turf/simulated/floor/colored/dirt/snow,/area/world/mountain/village)
"H" = (/obj/structure/scenery/snow_bush,/turf/simulated/floor/colored/snow,/area/world/mountain/village)
"I" = (/obj/structure/interactive/wishgranter/normal/northern_heights,/turf/simulated/floor/colored/dirt/snow,/area/world/mountain/village)
"J" = (/obj/structure/interactive/lighting/streetlamp/snow,/turf/simulated/floor/colored/snow,/area/world/mountain/village)
"K" = (/turf/simulated/floor/wood/brown,/area/world/mountain/village/interior/bar)
"L" = (/obj/structure/smooth/table/wood,/turf/simulated/floor/wood/brown,/area/world/mountain/village/interior/bar)
"M" = (/turf/simulated/wall/wood/brown,/area/world/mountain/shack)
"N" = (/turf/simulated/floor/wood/brown,/area/world/mountain/shack)

(1,1,1) = {"
xxxxxxxxxxxxxxxxxxxxxxxxxxxxxxxxxxxxxxyyyyyyyyyyyyyyyyyyyyyyyyyyyyyyyyyyyyyyyyyyyyyyyyyyyyyyyyyyyyyyyyyyyyyyyyyyyyyyyyyyyyyyyyyy
xaaaaaaaaaaaaaaaaaaaaaaaaaaaaaaaaaaaaaabbbbbbbbbbbbbbbbbbbbbbbbbbbbbbbbbbbbbbbbbbbbbbbbbbbbbbbbbbbbbbbbbbbbbbbbbbbbbbbbbbbbbbbby
xaaaaaaaaaaaaaaaaaaaaaaaaaaaaaaaaaaaaaaabbbbbbbbbbbbbbbaaaaaaaaaaaabbbbbbbbbbbbbbbbbbbbbbbbbbbbbbbbbbbbbbbbbbbbbbbbbbbbbbbbbbbby
xaaaaaaaaaaaaaaaaaaaaaaaaaaaaaaaaaaaaaaaaabbbbbbbbbaaaaaaaaaaaaaaaaaabbbbbbbbbbbbbbbbbbbbbbbbbbbbbbbbbbbbbbbbbbbbbbbbbbbbbbbbbby
xaaaaaaaaaaaaaaaaaaaaaaaaaaaaaaaaaaaaaaaaaabbbbaaaaaaaaaaaaaaaaaaaaaaaaabbbbbbbbbbbbbbbbbbbbbbbbbbbbbbbbbbbbbbbbbbbbbbbbbbbbbbby
xaaaaaaaaaaaaaaaaaaaaaaaaaaaaaaaaaaaaaaaaaaabaaaaaaaaaaacccccaaaaaaaaaaaaabbbbbbbbbbbbbbbbbbbbbbbbbbbbbbbbbbbbccbbbbbbbbbbbbbbby
xaaaaaaaaaaaaaaaaaaaaaaaaaaaaaaaaaaaaaaaaaaaaaaaaaccccccccccccccccaaaaaaaaabbbbbbbbbbbbbbbbbbbbbbbbcccccccccccccccbbbbbbbbbbbbby
xaaaaaaaaaaaaaaaaaaaaaaaaaaaaaaaaaaaaaaaaaaaaaaacccdddccccccccceccaaaaaaaaaabbbbbbbbbbbbbbbbbbccccccccccccccccccccccbbbbbbbbbbby
xaaaaaaaaaaaaaaaaaaaaaaaaaaaaaaaaaaaaaaaaaaaaaacccdddddccccccccccccaaaaaaaaaaabbbbbbbbbbbbbccccccccccccccccccccccccccbbbbbbbbbby
xaaaaaaaaaaaaaaaaaaaaaaaaaaaaaaaaaaaaaaaaaaaaacccdddddcccccfccccccccccccaaaaaaabbbbbbbbbbbccccccccccccccccccccccccccccbbbbbbbbby
xaaaaaaaaaaaaaaaaaaaaaaaaaaaaaaaaaaaaaaaaaaaacccdddddccceccccccccfcccccccaaaaaaabbbbbbbbbbcccccccccccccccccccccccccccccbbbbbbbby
xaaaaaaaaaaaaaaaaaaaaaaaaaaaaaaaaaaaaaaaaaaaccccdddddccccccccccccccccccccaaaaaaaacbbbbbbbbccccccccccccccccccccccccccccccbbbbbbby
xaaaaaaaaaaaaaaaaaaaaaaaaaaaaaaaaaaaaaaaaaaccccdddddccccccccccccccccccccccaaaaaaaccbbbbbbccccccccccccccccccccccccccccccccbbbbbby
xaaaaaaaaaaaaaaaaaaaaaaaaaaaaaaaaaaaaaaaaaaccccdddcccccccccccccccccccccccccaaaaaacccbbbbbcccccccccccccccccccccccccccccccccbbbbby
xaaaaaaaaaaaaaaaaaaaaaaaaaaaaaaaaaaaaaaaaaaccccdccccccccccccccfccfccccfceccaaaaaacccbbbbcccccccccccccccccccccccccccccccccccbbbby
xaaaaaaaaaaaaaaaaaaaaaaaaaaaaaaaaaaaaaaaaaaccccccccccccfcccfcccccccccccccccaaaaacccccbbbcccccccccccccccccccccccccccccccccccbbbby
xaaaaaaaaaaaaaaaaaaaaaaaaaaaaaaaaaaaaaaaaaaccccccccccccccccccccecccccccccccaaaaaccccccbcccccccccccccccccccccccccccccccccccccbbby
xaaaaaaaaaaaaaaaaaaaaaaaaaaaaaaaaaaaaaaaaaccccccccccccccccccccccccccccfccccaaaaaccccccccccccccccccccccccccccccccccccccccccccbbby
xaaaaaaaaaaaaaaaaaaaaaaaaaaaaaaaaaaaaaaaaccccccfcccecccfccccccccccccccccccaaaaaccccccccccccccccccccccccccccccccccccccccccccccbby
xaaaaaaaaaaaaaaaaaaaaaaaaaaaaaaaaaaaaaaaacccccccccccccccccccccccccfcccccccaaaaaccccccccccccccccccccccccccccccccccccccccccccccbby
xaaaaaaaaaaaaaaaaaaaaaaaaaaaaaaaaaaaaaaacccccccccccccccccccccccccccccccccaaaaccccccccccccccccccccccccccccccccccccccccccccccccbby
xaaaaaaaaaaaaaaaaaaaaaaaaaaaaaaaaaaaaaaacccccccccccccccccecccfccccccccaaaaaaaccccccccccccccgccccccccccccccccccccccccccccccccccby
xaaaaaaaaaaaaaaaaaaaaaaaaaaaaaaaaaaaaacccccccccccccfccccccccccccccccaaaaaaaaacccccccccccccccccccccccccccccccccccccccccccccccccby
xaaaaaaaaaaaaaaaaaaaaaaaaaaaaaaaaaaaaaccccccfcccccccccccccccccccccccaaaaaaacccccccccccccccccccbbbbccccccccccccccccdddccccccccbby
xaaaaaaaaaaaaaaaaaaaaaaaaaaaaaaaaaaaccccccccccccfccccccccccccaaachccaaaaaaccccccccccccccccccccbbbbbccccccccdddddddddddccccccbbby
xaaaaaaaaaaaaaaaaaaaaaaaaaaaaaaaaaaacccccccccccccccccccfccccaaaaccccaaaaaccccccccccccccccccccbbbbbbccccccddddddddddddccccccbbbby
xaaaaaaaaaaaaaaaaaaaaaaaaaaaaaaaaacccccecccccccccccccccccccaaacccccicccccccccccccccccccccccccbbbbbbbccccdddddddddddddcccccbbbbby
xaaaaaaaaaaaaaaaaaaaaaaaaaaaaaaaaacccccccccjcccccccccccccaaaacccjccccccccccccccccccccccccccccbbbbbbbbcccddddddddddddccccbbbbbbby
xaaaaaaaaaaaaaaaaaaaaaaaacccfccccccccccccccccccccccccccccaaaacccccccccccccccccccccccccccccccccbbbbbbbbcccdddddddddccccbbbbbbbbby
xaaaaaaaaaaaaaaaaaaaaaaacccccccccccccfcccccccjcccfcccaacaaaaaccccccccccccccccccccccccccccccccccbbccbbbbccccccccccccbbbbbbbbbbbby
yaaaaaaaaaaaaaaaaaaaacccccccccccccccccccccjccccccccccaaaaaaaaccccccecccccccccccccccccccccccccccccccbbbbbbbbbbbbbbbbbbbbbbbbbbbby
ybaaaaaaaaaaaaaaaaaccccccfccccccccccccccccccccccccccaaaaaaaaaaccccccccccccccccccccccccccccccccccccccbbbbbbbbbbbbbbbbbbbbbbbbbbby
ybaaaaaaacaaaaaacccccccccccccfccccccccfccccccccccccaaaaaaaaaaaccccccccccccccccccccccccccccccccgcccccccbbbbbbbbbbbbbbbbbbbbbbbbby
ybbaaaaaccccaaccccfcccccccccccccccccccccccccccccccaaaaaacaaaaaccccccccccccccccccccccccccccccccccccccccccbbbbbbbbbbbbbbbbbbbbbbby
ybbbaacccccccccfccccccfcccccccccccccccccccfcccccccaaaaccccaaaaaacccccccccccccccccccccccccccccccccccccccccbbbbbbbbbbbbbbbbbbbbbby
ybbbaccccccccccccccccccccccccccccfccccccccccccccaaaaaccccccaaaaaccccccccccccccccccccccccccccccccccccccccccbbbbbbbbbbbbbbbbbbbbby
ybbbaccccdddddccccccccccccccccccccccfcccccccccccaaaaccccccccaaaacccccccccccccccccccccccccccccccccccccccccccbbbbbbbbbbbbbbbbbbbby
ybbbccccdddddddccccfccccccccccccccccccccccccccccaaacccccccccaaaaacccccccccccccccccccccccccccccccccccccccccccbbbbbbbbbbbbbbbbbbby
ybbbccccdddddddccccccccccfccccfcccccccccccccccccaaaccccccccccaaaaccccccccccccccccccccccccccccccccccccccccccccbbbbbbbbbbbbbbbbbby
ybbbccccddddddddccccccccccccccccccccccccccccfcccaacccccccccccaaaaccccccccccccccccccccccccccccccccccccccccccccccbbbbbbbbbbbbbbbby
ybbcccccdddddddccccccccccccccccccccccfcccccccccaaacccccccccccaaaacccccccccccccccccccccccccccccccccccccccccccccccbbbbbbbbbbbbbbby
ybbcccccdddddddccccccccccccccccccccceckkkkkkcccaaaccccccccccccaaaccccccccccccccccccccccjccccccccccccccccccccccccccbbbbbbbbbbbbby
ybbcccccdddddddccccccccccccccccccfcckkkkkkkkcccaaaccccccccccccaaacccccccccccccccccccccccccjcccccccccccccccddcccccccbbbbbbbbbbbby
ybbcccccddddddcccccccfccccccccccccckkkkkkkkkcccaaaccccccccccccaaacccccccccccccccccccccccccccccccccccccccccddddccccccbbbbbbbbbbby
ybbcccccdddddcccecccccccccfcccccckkkkkkkkkkkccbaaaccccccccccccaaacccccccccccccccccccccccjccccccccccccccccdddddddcccccbbbbbbbbbby
ybbbcccccccccccckkkccccccccccfcckkkkkkkkkkkcccbaaaaccccccccccaaaacccccccccccccccccccccccccccccccccccccccdddddddddccccccbbrrrrrrz
ybbbcccccccccckkkkkceccccccccccckkkkkkkkkkkcfcbbbbbbbbqqqqbbbbbbbbbbbbccccccccccccccccccccccccccccccccddddddddddddccccccccrrrrrz
ybbbbbccccecckkkkkkkkccccccccccekkkkkkkkkkcccbbbrrrrrrqqqqrrrrrrrrrrbbbbbbbccccccccccccccccccccccccccdddddddddddddcccccccccrrrrz
ybbbbbcccccckkkkkkkkkcccccfccccckkkkkkkkkccbbbrrrrrrrrqqqqrrrrrrrrrrrbbbbbbbbbcccccccccccccccccccccccdddddddddddddccccccccccqrrz
ybbbbbcccckkkkkkkkkccccccccccccccckkckkecbbbbbrrrrrrrqqqqqqqqrrrrrrrrbbbbbbbbbbbccccccccccccccccccccccddddddddddddccccbccrqqqqrz
ybbbbbccccckkccecccccccfccccccccccccccccbbbbbbrrrrrqqqqqqqqqqqrrrrrrrrrrrbbbbbbbbcccccccccccccgccccccccddddddddddccccbbbbrrqqqqz
ybbbbbcccccccccccccccccccccccfccfcccfccbbbbbbbrrrrqqqqqqqqqqqqqqqqqqrrrrrrbbbbbbbbccccccccccccccccccccccddddddddccccbbbrrrrqqqqz
ybbbbbbbcccccddddddddddddddddddddcccccbbbrrrrrrrrrqqqqqqqqqqqqqqqqqqrrrrrrrrrrbbbbbcccccccccccccccccccccccdddddccccbbbbrrrrrqqqz
ybbbbbbbcddddddddddddddddddddddddddccbbbbrrrrrrrrrqqqqqqqqqqqqqqqqqrrrrrrrrrrrbbbbbbccccccccccccccccccccccdddcccccbbbbrrrqqrrqqz
ybbbbbbdddddddddddddddddddddddddddddcbbbbrrrqqrrrqqqqqqqqqqqqqqqqqqqrrrrrrrrrrrrrbbbbccccccccccccccccccccccccccccbbbrrrrqqrrqqqz
ybbbbbbddddddddddddddddddddddddddddddbbbbrqqqqrrqqqqqqqqqqqqqqqqqqqqqqqrrrrrrrrrrbbbbbccccccccccccccccccccccccccbbrrrrqqqqrrqqqz
ybbbbbdddddddddddddddddddddddddddddbbbbbbrqqqqqqqqqqqqqqqqqqqqqqqqqqqqqqrrrrrrrrrbbbbbccccccccccnncccccccccccccbbbrrqqqqrrrrqqrz
ybbbbbbdddddddddddddddddddddddddddbbbbrrrrqqqqqqqqqqqqqqqqqqqqqqqqqqqqqqqqrrrrrrrrbbbbccccccccccncccccccccccccbbbbrrqqqqrrrqqqrz
ybbbbbbddddddddddddddddddddddddddbbbbbrrqqqrrrrrrrrrrrrrrrrrrrrrqqrqqqqqqqqrrrrrrrbbbbbcccccccccnccccccccccccbbbrrrqqrqqrrqqqrrz
ybbbbbdddddddddddddddddddddddddddbbrrrrrqrrrrrrrrrrrrrrrrrrrrrrrrrrrrrrqqqqrrrrrrrrbbbbcccccccccnccccccccccccbbbrrqqrrqqqqqqrrrz
ybbbbbdddddddddddddddddddddddddddbbrqqqqqrrrqqqqqrrrrrrrrrqqqqqqqqqqqqqqqqqqrrrrrrrbbbbcccccccccncccccccccccbbbbrrqqrrqqqqqrrrrz
ybbbbdddddddddddddodpddddddddddddbbrqqqqrrqqqqqqqrrrqqqqqqqqqqqqqqqqqqqqqrrrrrrrrrrbbbbbcccccccngcccccccccccbbbbrrrrrqqqqqrrrrrz
ybbbbbdddddddddddddddddddddddddddbbrqqqqrrqqqqqqqqqqqqqqqqrqqrrrrrrrrrrrqrrrrrrrrrrbbbbbccccccnccccccccccccbbbbbrrrrrqqqrrrrrrrz
ybbbbbbddddddddddddpdddddddddddddbbrrqqqrqqqqqrqqqqqqqqrrrrrrrrrrrqrrrrrrrrrrrrrrrrbbbbbcccccnnccccccccccccbbbbbrrrrqqqrrrrrrrrz
ybbbbbdddddddddddddddddddddddddddbbbrrqrrqqqqrrrrqqrrrrrrrrrqqqqqqqqqqqrrrrrrqqqqrrbbbbbcccccnccccccccccccbbbbbbrrrrqqrrrrrrrrrz
ybbbbbbdddddddddddddddddddddddddddbbrrrrrqqqrrrrrrrrrrrqrrqqqqqqqqqqqqqrrrrrqqqqqqrbbbbbccccnnccccccccccccbbbbbbrrrqqqrrrrqrrrrz
ybbbbbbdddddddddddddddddddddddddddbbrrrrrqqqrrrrrrrrqqqqqqqqrrrrrrrrrqqqqrqqqqqqqqrbbbbbccccnccccccccccccbbbbbbbrrrqqqrrqqqqrrrz
ybbbbbbbddddddddddddddddddddddddddbbbbrrrqqqrrrrrrrqqqqqqqrrrrrrrrrrrrqqqqqqqqqqqqrbbbbbccccncccccccccccbbbbrrrrrqqqqrrrqqqqqrrz
ybbbbbbbdddddddddddddddddddddddddddbbbrrrrqqqqrrrrqqqqqqqrrrqqqqqrrrrrqqqqqqqqqqqrrbbbbbcccncjcccccccccbbbbbrrrrrqqqrrrrqqqqqqrz
ybbbbbbddddddddddddddddddddddddddddbbbbbrrqqqqqqqqqqqqrrrrqqqqqqqrrrrrrqqrrrrqqqrrrbbbbccjcccccccccccbbbbbbbrrrrqqqqrrrrqqqqqqrz
ybbbbbddddddddddddddddddddddddddddddbbbbrrrqqqqqqqrrrrrrrqqqqqqqqqrrrrqqqrrrrrrrrrrbbbbcccncccccccbbbbbbbbbbrrrrqqqrrrrrqqqqqqrz
ybbbbddddddddddddddddddddddddddddddcbbbbrrrrqqqqqrrrrrrrqqqqqrrqqqqqqqqqqqqqrrrrrrrbbbbcccnccjccbbbbbbbbbbrrrrrrqqqrrrrqqqqqqqrz
ybbbbbbdddddddddddddddddddddddddccccbbbbrrrrrqqrrrrrrrrqqqqqrrrqqqqqqqqqqqqqqrrrrrrbbbbccnnccccbbbbbbbbbbbrrqqqqqqqrrrqqqqqqqqqz
ybbbbbddddddddddddddddddddddddccccccbbbbrrrrrrrrrrrrrqqqqqqrrrrqqqqqqqqqqqqqqrrrrrrbbbbccnccccbbbbbbbbbbrrrrqqqqqqrrrrqqqqqqqqqz
ybbbbbbddddddddddddddddddddccccccccccccbbbrrrrrrrrrrqqqqqrrrrrqqqqqqqrrrrqqqqrrrrrbbbbcccncccbbbbbbbbbbbrrrrqqqqrrrrrqqqqqqqqqqz
ybbbbbdddddddddddddddddddcccckcccccccccccbbbrrrrrrrqqqqqrrrrqqqqqqqqrrrrrqqqqrrrrrbbbbcccncccbbbbbbrrrrrrrqqqqrrrrrrrqqqqqqqqqrz
ybbbbbdddddddddddddddddccccfckcfcccckcccccbbbrrrrrrqqqqrrrrqqqqqqqqqrrrrrqqqrrrrrrbbbbccncccbbbbbbbrrrrrrqqqqqqrrrrrrqqqqqqqqqrz
ybbbbbddddddddddddddcccccccckkkcccfkkccccccbbbbrrrrqqqqrrrrqqqqqqqqrrrrqqqrrrrrrrrbbbccnncccbbbbbbrrrrrrqqqqqqqrrrrrrrqqqqqqqqrz
ybbbbdddddddddddddccckcfkkkkkckkfckkccccccccbbbrrrrqqqqrrqqqqqqqrrrrrrqqqqrrrrrrrrbbbccncccbbbbbbbrrrrqqqqqrrqqqqrrrrrqqqqqqqqrz
ybbbddddddddddddcckcckkkkkkcccckcckccfccccccbbbbrrrrqqqrrqqqqqqrrrrrqqqqqrrrrrrrrbbbccnncccbbbbrrrrrrqqqrrrrrrqqqqrrrrqqqqqqqqrz
ybbbbddddddddddccckkfkkkckcccfckkkkccccccfcccbbbbbrrqqqrrqqqqqqrrrrrqqqqrrrrrrrrbbccccngcccbbbbrrqrrrqqqrrrrrrqqqqrrrrqqqqqqqqrz
ybbbddddddddddcccfckkkccckkfcckkckkcckkkkccccccbbbrrrrrrrqqqqqrrrrrrrrrrrrrrrrbbbccccnnccccbbbbrqqqqqqqrrrqqqrrrqqqrrrrqqqqqqqqz
ybbbdddddddddcccckkkkcjcjckccckcfckfkkcckkkcfceccbbbbbbbMMMNMMMMMMMMrrrrrrrbbbbccccccncccccbbbbrqqqqqqqqrrqqqqqrqqqrrrrrqqqqqqqz
ybbbdddddddddcecckcccccccckkcckkkckkkcfkkckkkkcceccbbbbbMNNNNNNNNNNMrrrrrbbbccckccccnncccccbbbbrqqqqqqqqrrqqqqqrqqqqrrrrqqqqqqqz
ybbbddddddddccccckkfcccjcfkccckckkkkccckccckckkccccecbbbMNNNNNNNNNNMbbbbbbcccckkcccnnccccccbbbbrrrqrrrqqrrrqqrrrrqqqrrrrqqqqqqqz
ybbbdddddddccccccckkkcccckkcfckkcckccckkcfckcckkccccccccMNNNNNNNNNNMcccccccckkkkccnncckkcccbbbbrrrrrrrqqqrrrqrrrrqqrrrrrqqqqqqrz
ybbbdddddddccccfcccckkkkkkccckkcfckcccckkcckcfckfckcccccMNNNNNNNNNNMccccckkkkkkkcnncckcccccbbbbrrrrrrrqqqqrrqrrrqqqqrrrrqqqqqqrz
ybbbdddddddccccccfcccckkkccckkccccckfccckkkkcckkkkkcfcccMNNNNNNNNNNMccckkkckkkkccnncckcckccbbbbbbbrrrrrqqqqrqrqqqqrrrrrrrqqqqqrz
ybbbdddddddcccckkkccfkkckkfckccckcckkccfkkckkkkkkcccccccMMMMMMMMMNMMccccckkkkkccnnccckcckccbbbbbbbrrqrrrqqqrqqqqqqrrrrrrrqqqqqrz
ybbbdddddddccfkkckkkckcfckcckcfckkfckckkkccckcccccceccccgccccccccccgcdddccckkccnnccckkkckccebbbbbbrrqrrrrqqqqqqrrrrrrrrrrqqqqqrz
ybbbdddddddccckcccckkkccccccccccckkkkcckkcfkkcckkfcccccccccccccccccccddddcccccnncckkkkkckcccbbbbbbbrqqrrqqqqqrrrrrrrrrrrrrqqqqrz
ybbbdddddddccckccfcccccbbbbbbbccccckcfckckkkkfckkckkkfcccccccccccccccdddddccccnncckcckcckkccbbbbbbbrqqqqqrrqqqqrrrrrrrrrqqqqqqrz
ybbbdddddddccccccccbbbbbbbbbbbbbcfckkckccccckkkkkkkckccccccccccccccccddddddcccncckkccckcekcccbbbbbbrrqqqqrrrrqqqqqqrrrqqqqqqqqrz
ybbbddddddddccccbbbbrrrrrrrrrrbbbbcccckkfccckkccckcckkccccccccccccccdddddddccnncckeckckcckkcccbbbbbrrqqqrrrrrrqqqqqqqqqqqqqqqqrz
ybbbddddddddcecbbbrrqqqqqqqqqrrbbbbcccckkccfckcfkkcfckcfcckkkkkkkccccdddddcccnncckkkkckkkkkcecbbbbbrrrrrrrrrrrrrrqqqqqqqqqqqqqqz
ybbbddddddddcccbbbrqqqqqqqqqqqrrrbbccfcckcccckcckkkkcccccccccccccccccccddccccnncckkccckkkkckkcccbbbrrrrrrrrrrrrrrrqqqqqqqqqqqqqz
ybbbcdddddddccbbbbrqqqqqqqqqqqqqrrbbccccccfckkckkcckkccccccnnnnngncccccccckccnnckkckkkkcckkckkcccbbbbbbbbrrrrrrrrrrrqqqqqqqqqqqz
ybbbcddddddddcccbbrqqqqqqqqqqqqqqrbbccccccckkcckcfcccnnnnnnnccnnnnnncccccckcnncckckkcckkcckcckkcccbbbbbbbbbbbbbbrrrrrrqqqqqqqqrz
ybbbccdddddddccccbrrqqccqqqqqqqqqrbbccccfckkcfccccccnnccccckkcccncnnnnccckkcnnckkkkcckkccckkcckkccccbbbbbbbbbbbbrrrrrrrrrrrrrrrz
ybbbccddddddddccccbrqcccqqqqqqqqqrbbcccccccccccccnncncccfckkckccccccnnnnncccnnckcccckkccceccccckkcccccbbbbbbbbbbbbbbbbbbbbbbbbby
ybbbcccddddddddccccbcccccqqqqqqqqrbbcccckccfcccencccccccckkckkccccccccnnnnncnnccsnnncnnncnnncckkccccdddddcccbbbbbbbbbbbbbbbbbbby
ybbbcfcdddddddddccccccccccqqqqqqqrbbcccckkkccccngccckkcckkcfkccccccccccccnnnnnnnnnnncccckccncckccccdddddddccccccccccbbbbbbbbbbby
ybbbbcccdddddddddccccccccccqqqqqrrbcccfccckkccccckccckfckccckccccccccccccccnnnncccccckkkkcccckkcccdddddddddccccccccccbbbbbbbbbby
ybbbbkkccdddddddddcccccbrrqqqqqqrbbcccccccckccccckcfckcccdddkkfcccfcccccccccnncccccccccccckkkkcccdddddddddddccccccccccbbbbbbbbby
ybbbckkccddddddddddcccebbrrqqqqrrbcccccecfckcfccckcckkcdddddckcccccccccbbbJtDDtJbbbbbbbbccccccccddddddddddddddccccdddccbbbbbbbby
ybbbcckfccddddddddddccccbbrrrqqrbbcccccccccccccckkcckccddddcckkccfcfcbbbttvvDDDtttEEEttbbbcccccdddddddddddddddddddddddccbbbbbbby
ybbbfckcccdddddddddddccccbbbrrrrbccccfcccccckkcfkccckccdddcccckkcccbbbtttvvtDDDDtEEEEEtttbceccddddddddddddddddddddddddcccbbbbbby
ybbbcckkkkcdddddddddddcccccbbbbbcccccccccfccckkcccfkkccccccccfkkccbbttttvvtvttDDDtEEEEEttbbccdddddddddddddddddddddddddccccbbbbby
ybbbccccckcccdddddddddcccccccbbcccfcckkccccccckkkcckcfccfcccckkccbbttFttvtvvDDDDDttEEEEEttbccddddddddddddddddddddddddddccccbbbby
ybbcccfcfkkcccddddddddccfccccccccccckkccccfccfckkkkkkccccccfkkccbbttttuuuuuuuuuGDDttEEEEEtbccdddddddddddddddddddddddddddccccbbby
ybbccccccckccccdddddddccccccccckccccckcccccccckkcccckccccccckcccbbtFttuKKKKKKKuDDDvtEEEEEtbbccddddddddddddddddddddddddddccccbbby
ybccfckkkkkcfcccdddddddccccfccckkfccckkfcccckccccccckcfcfcckkcccbbbttHuKKKKKKKuDDDvvtEEEEtbbcccdddddddddddddddddddddddddcccccbby
ybbccckccckccccccddddddccccccccckccccckkkcfckcccfccfccccccckkfccbbbtHtuLLLLLLLuDvDvvttEEEtbbbcccdddddddddddddddddddddddcccccccby
ybbccckcfkkkkkcfcddddddcccccecfckcccfkkcccckkfkkccccccfcccckcccbbbbbtHuKKKKKKKuDDDvDIttEttbbbbccdddddddddddddddddddddddcccccccby
ybbccfkcckccckkcccdddddccfccccckkccckkkccfckckkcccfccccccfkkcccbbbbbttuKKKKKKKuDDDDDDtttttbbbbcccdddddddddddddddddddddddccccccby
ybbbckkcekcfcckkkcddddddccccjckkccfckccfcckkckcccccccfkkkkccccccbbbbttuKKKKKKKKDvDDDttttttbbbbbccddddddddddddddddddddddddcccccby
ybbbccccckkkccccccddddddccccccjcccckkccccckcckcfcccfckkcckccfcccbbbbttuKKKKKKKuDvDDvvtFttttbbbbbccdddddddddddddddddddddddcccccby
ybbbccccckkkkcfccccdddddccccjcccfcckcfccccckfkccccccckccccccccccbbbbttuKKKKKKKutvDDvvvtttttbbbbbbccdddddddddddddddddddddccccccby
ybbbbccfkkcckccccccdddddcfcccccckkckkcccfcckkkkcccfccccfccccccecbbbbtvuuuuuuuuuJvvDDvvvtFttbbbbbbbccdddddddddddddddddddddcccccby
ybbbbcckkkcckkccccfdddddcccccccckcfckccccccckccfcckkcccccccfcccecbbtvvtttttttttttvvDDDvvtttbbbbbbbbccddddddddddddddddddddcccccby
ybbbbckkcccfckccccccddddccccccfckccccccfccfkkccccccbbbbcccecccccccJtttttttbbbbbtttvDDDvtttbbbbbbbbbbccdddddddddddddddddddcccccby
ybbbccccfcccckcfccccddddcccfcccckcccccccccckccccccbbbbbbbcccececcctvtttbbbbbbbbbbwwwAAAwwbbbbbbbbbbbbcccdddddddddddddddccccccbby
ybbbccccccccccccccecddddcccccccckcfccfccccckcfcccbbbbbbbbccccccckkvvtbbbbbbbbbbbbBAAAAAACBbbbbbbbbbbbbccccccddddddddcccccccccbby
ybbcccbbbbbbbcceccccddddcccbbbcckcccccckcfckcccccbbbbbbbbbccececccttbbbbbbbbbbbbBBBAAAAAABBbbbbbbbbbbbbbccbbbbdddddcccccccccbbby
ybbbbbbbbbbbbbcccbbbdddbbbbbbcccccccccckkkkkcbbbbbbbbbbbbbbcccccccJbbbbbbbbbbbbBBBBAAAAAAABBbbbbbbbbbbbbbbbbbbbbbbbbbbbccccbbbby
ybbbbbbbbbbbbbcbbbbbbbbbbbbbbbbbbbbbbbbcccccbbbbbbbbbbbbbbbbbccccbbbbbbbbbbbbbbBBBBCAAAAAABBBbbbbbbbbbbbbbbbbbbbbbbbbbbbbbbbbbby
ybbbbbbbbbbbbbbbbbbbbbbbbbbbbbbbbbbbbbbbbbbbbbbbbbbbbbbbbbbbbbbbbbbbbbbbbbbbbbbBBBBAAAAAAABBBBbbbbbbbbbbbbbbbbbbbbbbbbbbbbbbbbby
yyyyyyyyyyyyyyyyyyyyyyyyyyyyyyyyyyyyyyyyyyyyyyyyyyyyyyyyyyyyyyyyyyyyyyyyyyyyyyyBBBBCAAAAAABBBByyyyyyyyyyyyyyyyyyyyyyyyyyyyyyyyyy
"}
