"a" = (/turf/simulated/floor/chasm,/area/world/mountain/exterior)
"b" = (/turf/simulated/wall/rock/snow,/area/world/mountain/exterior)
"c" = (/mob/living/simple/npc/bear/snow,/turf/simulated/floor/colored/snow,/area/world/mountain/exterior)
"e" = (/obj/structure/scenery/snow_bush,/turf/simulated/floor/colored/snow,/area/world/mountain/exterior)
"f" = (/obj/structure/scenery/pinetrees,/turf/simulated/floor/colored/snow,/area/world/mountain/exterior)
"g" = (/obj/structure/interactive/lighting/streetlamp/snow,/turf/simulated/floor/colored/snow,/area/world/mountain/exterior)
"j" = (/turf/simulated/floor/colored/snow,/area/world/mountain/exterior)
"k" = (/obj/structure/scenery/snow_grass,/turf/simulated/floor/colored/snow,/area/world/mountain/exterior)
"l" = (/turf/simulated/wall/rock,/area/world/mountain/exterior)
"m" = (/turf/simulated/wall/rock/snow,/area/world/mountain/interior/cave)
"n" = (/turf/simulated/floor/colored/dirt/snow,/area/world/mountain/exterior)
"p" = (/turf/simulated/floor/ice,/area/world/mountain/exterior)
"s" = (/obj/structure/scenery/rocks,/turf/simulated/floor/colored/dirt/snow,/area/world/mountain/exterior)
"t" = (/turf/simulated/floor/colored/snow,/area/world/mountain/exterior/village)
"u" = (/turf/simulated/wall/wood/brown,/area/world/mountain/interior/bar)
"v" = (/obj/structure/scenery/snow_grass,/turf/simulated/floor/colored/snow,/area/world/mountain/exterior/village)
"w" = (/turf/simulated/wall/wood/brown,/area/world/mountain/interior/cave)
"A" = (/turf/simulated/floor/cave_dirt,/area/world/mountain/interior/cave)
"B" = (/turf/simulated/wall/rock,/area/world/mountain/interior/cave)
"C" = (/obj/structure/scenery/rocks,/turf/simulated/floor/cave_dirt,/area/world/mountain/interior/cave)
"D" = (/turf/simulated/floor/colored/dirt/snow,/area/world/mountain/exterior/village)
"E" = (/turf/simulated/floor/ice,/area/world/mountain/exterior/village)
"F" = (/obj/structure/scenery/pinetrees,/turf/simulated/floor/colored/snow,/area/world/mountain/exterior/village)
"G" = (/obj/structure/interactive/lighting/streetlamp,/turf/simulated/floor/colored/dirt/snow,/area/world/mountain/exterior/village)
"H" = (/obj/structure/scenery/snow_bush,/turf/simulated/floor/colored/snow,/area/world/mountain/exterior/village)
"I" = (/obj/structure/interactive/wishgranter/normal/northern_heights,/turf/simulated/floor/colored/dirt/snow,/area/world/mountain/exterior/village)
"J" = (/obj/structure/interactive/lighting/streetlamp/snow,/turf/simulated/floor/colored/snow,/area/world/mountain/exterior/village)
"K" = (/turf/simulated/floor/wood/brown,/area/world/mountain/interior/bar)
"L" = (/obj/structure/smooth/table/wood,/turf/simulated/floor/wood/brown,/area/world/mountain/interior/bar)
"M" = (/turf/simulated/wall/wood/brown,/area/world/mountain/interior/shack)
"N" = (/turf/simulated/floor/wood/brown,/area/world/mountain/interior/shack)
"O" = (/turf/simulated/floor/river,/area/world/mountain/exterior)

(1,1,1) = {"
bbbbbbbbbbbbbbbbbbbbbbbbbbbbbbbbbbbbbbbbbbbbbbbbbbbbbbbbbbbbbbbbbbbbbbbbbbbbbbbbbbbbbbbbbbbbbbbbbbbbbbbbbbbbbbbbbbbbbbbbbbbbbbbb
bbbbbbbbbbbbbbbbbbbbbbbbbbbbbbbbbbbaaaabbbbbbbbbbbbbbbbbbbbbbbbbbbbbbbbbbbbbbbbbbbbbbbbbbbbbbbbbbbbbbbbbbbbbbbbbbbbbbbbbbbbbbbbb
jjjjjjjbbbbbbbbbbbbbbbbbbbbbbbbbbbaaaaaabbbbbbbbbbbbbbbaaaaaaaaaaaabbbbbbbbbbbbbbbbbbbbbbbbbbbbbbbbbbbbbbbbbbbbbbbbbbbbbbbbbbbbb
jjjjjjjjbbbbbbbbbbbbbbbjjjbbbbbbbaaaaaaaaabbbbbbbbbaaaaaaaaaaaaaaaaaabbbbbbbbbbbbbbbbbbbbbbbbbbbbbbbbbbbbbbbbbbbbbbbbbbbbbbbbbbb
jjkkjjjjjbbbbbbbbbbbbbjjjjjbbbbbbaaaaaaaaaabbbbaaaaaaaaaaaaaaaaaaaaaaaaabbbbbbbbbbbbbbbbbbbbbbbbbbbbbbbbbbbbbbbbbbbbbbbbbbbbbbbb
jkkkkkjjjjbbbbbbbbbjjjjjjjbbbbbbbaaaaaaaaaaabaaaaaaaaaaajjjjjaaaaaaaaaaaaabbbbbbbbbbbbbbbbbbbbbbbbbbbbbbbbbbbbjjbbbbbbbbbbbbbbbb
jkjjjkkjjjjbbbbbbbjjjjjjjjbbbbbbbaaaaaaaaaaaaaaaaajjjjjjjjjjjjjjjjaaaaaaaaabbbbbbbbbbbbbbbbbbbbbbbbjjjjjjjjjjjjjjjbbbbbbbbbbbbbb
jkjfjjkjjjjbbbbjjjjjjkjjjjjbbbbbaaaaaaaaaaaaaaaajjjpppjjjjjjjkjejjaaaaaaaaaabbbbbbbbbbbbbbbbbbjjjjjjjjjjjjjjjjjjjjjjbbbbbbbbbbbb
kkjjjjkkjjjjbbjjjjfjjkfjjjbbbbbbaaaaaaaaaaaaaaajjjpppppjjkjjjkjjjjjaaaaaaaaaaabbbbbbbbbbbbbjjjjjjjjjjjjjjjjjjjjjjjjjjbbbbbbbbbbb
kkkjjfjkjjjjjjjjjjjjkkjjjjbbbbbaaaaaaaaaaaaaaajjjpppppjjjkkfjkjjjjjjjjjjaaaaaaabbbbbbbbbbbjjjjjjjjjjjjjjjjjjjjjjjjjjjjbbbbbbbbbb
kjkkkkkkkjjjjjjjkkkkkjjjjbbbbbaaaaaaaaaaaaaaajjjpppppjjjejkkkkjjjfjjjjjjjaaaaaaabbbbbbbbbbjjjjjjjjjjjjjjjjjjjjjjjjjjjjjbbbbbbbbb
kjjjjjjkkjjjjjjkkjjkkjfjjbbbbbaaaaaaaaaaaaaajjjjpppppjjjjjkjkkjjjkkkjjjjjaaaaaaaajbbbbbbbbjjjjjjjjjjjjjjjjjjjjjjjjjjjjjjbbbbbbbb
kkjjjjjjkkjfjjjkjjjkjjjjjbbbbbaaaaaaaaaaaaajjjjpppppjjjjjjkjjkkkkkjkjjjjjjaaaaaaajjbbbbbbjjjjjjjjjjjjjjjjjjjjjjjjjjjjjjjjbbbbbbb
kkjjjjjjjkjjjjkkjfjkjjjjbbbbbaaaaaaaaaaaaaajjjjpppjjjjjjjkkjjkjkkjjkkjjjjjjaaaaaajjjbbbbbjjjjjjjjjjjjjjjjjjjjjjjjjjjjjjjjjbbbbbb
kkjjfjjjjkkjjjkjjkkkjjjjbbbbbaaaaaaaaaaaaaajjjjpjjjjjjjjkkjjjkfjkfjjkjfjejjaaaaaajjjbbbbjjjjjjjjjjjjjjjjjjjjjjjjjjjjjjjjjjjbbbbb
kkkjjjjjjkkkkkkkkkjjjjjbbbbbaaaaaaaaaaaaaaajjjjjjjjjjjjfjjkfkkjjkkkkkkkjjjjaaaaajjjjjbbbjjjjjjjjjjjjjjjjjjjjjjjjjjjjjjjjjjjbbbbb
kjkjjjjfjkkkjjjfjjjjjbbbbbbaaaaaaaaaaaaaaaajjjjjjjjjjkkkkkkkkjjejjjjkkjjjjjaaaaajjjjjjbjjjjjjjjjjjjjjjjjjjjjjjjjjjjjjjjjjjjjbbbb
kjkkkjjjjkkjfjjjjjbbbbbbbbbaaaaaaaaaaaaaaajjjjjjjjjjjjjjjjjkkjjjjjjjkjfjjjjaaaaajjjjjjjjjjjjjjjjjjjjjjjjjjjjjjjjjjjjjjjjjjjjbbbb
kjjkkjjkkkjjjjjjjbbbbbbbbbaaaaaaaaaaaaaaajjjjjjfjjjejjjfjjjjkkkkjjjjkjjjjjaaaaajjjjjjjjjjjjjjjjjjjjjjjjjjjjjjjjjjjjjjjjjjjjjjbbb
kjjjkkkkjjjkjjjjjbbbbbbbbbaaaaaaaaaaaaaaajjjjjjjjjjjjjjjjjjjkjjkkjfkkjjjjjaaaaajjjjjjjjjjjjjjjjjjjjjjjjjjjjjjjjjjjjjjjjjjjjjjbbb
kjjjkjjjjjkkjjjfjbbbaaaaaaaaaaaaaaaaaaaajjjkjjjkkjjjjjjjjjjkkjjjkkkkjjjjjaaaajjjjjjjjjjjjjjjjjjjjjjjjjjjjjjjjjjjjjjjjjjjjjjjjbbb
kjjjkjjjjkkjjkjjjbbbbaaaaaaaaaaaaaaaaaaajjjkjjkkjjjjjjjjjejkjfjjjkjjjjaaaaaaajjjjjjjjjjjjjjgjjjjjjjjjjjjjjjjjjjjjjjjjjjjjjjjjjbb
kjfjkjfjkkjjjkjjjbbbbaaaaaaaaaaaaaaaaajjjjjkjjkjjjjfkkjjjjjkjjjjjjjjaaaaaaaaajjjjjjjjjjjjjjjjjjjjjjjjjjjjjjjjjjjjjjjjjjjjjjjjjbb
kjjkkjjjkjjfjkjjjbbbbbaaaaaaaaaaaaaaaajjjjjkfkkjjjjkkjjjjjjjjjjjjjjjaaaaaaajjjjjjjjjjjjjjjjjjjbbbbjjjjjjjjjjjjjjjjpppjjjjjjjjbbb
kjkkkkjjkjjjjkjjjjbbbbaaaaaaaaaaaaaajjjjjjjkjkkjfjjkjjjjjjjjjaaajjjjaaaaaajjjjjjjjjjjjjjjjjjjjbbbbbjjjjjjjjpppppppppppjjjjjjbbbb
kkkjjkkkkjjkkkjjjjbbbbbaaaaaaaaaaaaajjjjjjjkkkkkkjkkjjjfjjjjaaaajjjjaaaaajjjjjjjjjjjjjjjjjjjjbbbbbbjjjjjjppppppppppppjjjjjjbbbbb
kkjjjjkkkkkkjjjjjjjbbbbaaaaaaaaaaajjjjjejjjkkjjjkkkjjjjjjjjaaajjjjjjjjjjjjjjjjjjjjjjjjjjjjjjjbbbbbbbjjjjpppppppppppppjjjjjbbbbbb
kkjjfjjkkkkkjjfjjjjbbbbbbaaaaaaaaajjjjjjjkkkkjjjjjjjjjjjjaaaajjjjjjjjjjjjjjjjjjjjjjjjjjjjjjjjbbbbbbbbjjjppppppppppppjjjjbbbbbbbb
kjjjjjkkjjjkkkjjjjjjbbbbbjjjfjjjjjjjjjjjjjjjkjjjjjjjjjjjjaaaajjjjjjjjjjjjjjjjjjjjjjjjjjjjjjjjjbbbbbbbbjjjpppppppppjjjjbbbbbbbbbb
kkjjjkkjjjjjjkkjjkkjjbbbbjjjkkkkjjjjjfjjjjkjkkjjjfjjjaajaaaaajjjjjjjjjjjjjjjjjjjjjjjjjjjjjjjjjjbbjjbbbbjjjjjjjjjjjjbbbbbbbbbbbbb
kjkkkkjjjfjjjjkkkjkkkjjjjjjkkjjjjjjjjjjjjkkjjkkkjjjjjaaaaaaaajjjjjjejjjjjjjjjjjjjjjjjjjjjjjjjjjjjjjbbbbbbbbbbbbbbbbbbbbbbbbbbbbb
kjjjjkkjjjjjjjjjkjjjkkkkjfjkjjjkkkjkjjjjkkjjjjjkkkjjaaaaaaaaaajjjjjjjjjjjjjjjjjjjjjjjjjjjjjjjjjjjjjjbbbbbbbbbbbbbbbbbbbbbbbbbbbb
kjjjjjkjjjjjjjjjkjjjkjjkkjjkjfjkjjjkkjfjkjjjjjjjjjjaaaaaaaaaaajjjjjjjjjjjjjjjjjjjjjjjjjjjjjjjjgjjjjjjjbbbbbbbbbbbbbbbbbbbbbbbbbb
kkjjjjkjjjjjjjjjkkfjkjjjkkjkjjkkjjjjkkkkkjjjjjjjjjaaaaaajaaaaajjjjjjjjjjjjjjjjjjjjjjjjjjjjjjjjjjjjjjjjjjbbbbbbbbbbbbbbbbbbbbbbbb
kkjfjjkjjjjjjjjfjkjjkjfjjkkkjkkkjjjjjjkkkjfjjjjjjjaaaajjjjaaaaaajjjjjjjjjjjjjjjjjjjjjjjjjjjjjjjjjjjjjjjjjbbbbbbbbbbbbbbbbbbbbbbb
kkjjjjjjjjjjjjjjjkjjkkjkkkjkkkjkkfjjjjjkkjjjkkkjaaaaajjjjjjaaaaajjjjjjjjjjjjjjjjjjjjjjjjjjjjjjjjjjjjjjjjjjbbbbbbbbbbbbbbbbbbbbbb
kjjjjjjpppppppjjjkjjjkkkjjjkkjjjkkjjfjjjkkkkkjjjaaaajjjjjjjjaaaajjjjjjjjjjjjjjjjjjjjjjjjjjjjjjjjjjjjjjjjjjjbbbbbbbbbbbbbbbbbbbbb
jjjjjppppppppppjjkjfjkkjjjjjkjjjjkjjjjjkkkjjjjjjaaajjjjjjjjjaaaaajjjjjjjjjjjjjjjjjjjjjjjjjjjjjjjjjjjjjjjjjjjbbbbbbbbbbbbbbbbbbbb
jjjppppppppppppjjkkjjkkjjfjjkjfjjkkjjjjjkjjjjjjjaaajjjjjjjjjjaaaajjjjjjjjjjjjjjjjjjjjjjjjjjjjjjjjjjjjjjjjjjjjbbbbbbbbbbbbbbbbbbb
jjppppppppppppppjjkkkkkkjjjkkjjjjjjjjjjjkjjjfjjjaajjjjjjjjjjjaaaajjjjjjjjjjjjjjjjjjjjjjjjjjjjjjjjjjjjjjjjjjjjjjbbbbbbbbbbbbbbbbb
pppppppppppppppjjjkkjjjkkkjkkjjjjjjjjfjjkjjjjjjaaajjjjjjjjjjjaaaajjjjjjjjjjjjjjjjjjjjjjjjjjjjjjjjjjjjjjjjjjjjjjjbbbbbbbbbbbbbbbb
pppppppppppppppjjjkjjjjjkkjjkkkjjjjjejkkkkkkjjjaaajjjjjjjjjjjjaaajjjjjjjjjjjjjjjjjjjjjjjjjjjjjjjjjjjjjjjjjjjjjjjjjbbbbbbbbbbbbbb
pppppppppppppppjfjkjjjjjkkjjjjkjjfjjkkkkkkkkjjjaaajjjjjjjjjjjjaaajjjjjjjjjjjjjjjjjjjjjjjjjjjjjjjjjjjjjjjjjppjjjjjjjbbbbbbbbbbbbb
ppppppppppppppjjjkkjjfjjkkjjjjkkjjjkkkkkkkkkjjjaaajjjjjjjjjjjjaaajjjjjjjjjjjjjjjjjjjjjjjjjjjjjjjjjjjjjjjjjppppjjjjjjbbbbbbbbbbbb
pppppppppppppjjjekjjjjjjkjfjjjjkkkkkkkkkkkkkjjjaaajjjjjjjjjjjjaaajjjjjjjjjjjjjjjjjjjjjjjjjjjjjjjjjjjjjjjjpppppppjjjjjbbbbbbbbbbb
ppppjjjjjjjjjjjjkkkjjjkkjjjjjfjjkkkkkkkkkkkjjjjaaaajjjjjjjjjjaaaabbbjjjjjjjjjjjjjjjjjjjjjjjjjjjjjjjjjjjjpppppppppjjjjjjbbBBBBBBl
pppjkjjjjjjjjjkkkkkjkkkkkjjjjjjjkkkkkkkkkkkjfjbbbbbbbbAAAAbbbbbbbbbbbbjjjjjjjjjjjjjjjjjjjjjjjjjjjjjjjjppppppppppppjjjjjjjjBBBBBl
pjjjkjjfjjejjkkkkkkkkjjjkjjjjkkkkkkkkkkkkkjjjbbbBBBBBBAAAABBBBBBBBBBbbbbbbbjjjjjjjjjjjjjjjjjjjjjjjjjjpppppppppppppjjjjjjjjjBBBBl
jjjjkjjjkkjjkkkkkkkkkjjjkkfjkkjjkkkkkkkkkjjbbbBBBBBBBBAAAABBBBBBBBBBBbbbbbbbbbjjjjjjjjjjjjjjjjjjjjjjjpppppppppppppjjjjjjjjjjABBl
jjjjkkkkkjkkkkkkkkkjjjjjjkjkkjjjjjkkjkkejbbbbbBBBBBBBAAAAAAAABBBBBBBBbbbbbbbbbbbjjjjjjjjjjjjjjjjjjjjjjppppppppppppjjjjbjjBAAAABl
jjfjkkkjjjjkkjjejjjjjjjfjjkkjjjjjjjjjjjjbbbbbbBBBBBAAAAAAAAAAABBBBBBBBBBBbbbbbbbbjjjjjjjjjjjjjgjjjjjjjjppppppppppjjjjbbbbBBAAAAl
jjkjkkkjjjjjjjjjjjjjjjjjjjjjjfjjfjjjfjjbbbbbbbBBBBAAAAAAAAAAAAAAAAAABBBBBBbbbbbbbbjjjjjjjjjjjjjjjjjjjjjjppppppppjjjjbbbBBBBAAAAl
jjkkkjjjjjjjjppppppppppppppppppppjjjjjbbbBBBBBBBBBAAAAAAAAAAAAAAAAAABBBBBBBBBBbbbbbjjjjjjjjjjjjjjjjjjjjjjjpppppjjjjbbbbBBBBBAAAl
jjjkkjjjjjpppppppppppppppppppppppppjjbbbbBBBBBBBBBAAAAAAAAAAAAAAAAABBBBBBBBBBBbbbbbbjjjjjjjjjjjjjjjjjjjjjjpppjjjjjbbbbBBBAABBAAl
jjjjkjfjjpppppppppppppppppppppppppppjbbbbBBBAABBBAAAAAAAAAAAAAAAAAAABBBBBBBBBBBBBbbbbjjjjjjjjjjjjjjjjjjjjjjjjjjjjbbbBBBBAABBAAAl
jjjjkkjjjppppppppppppppppppppppppppppbbbbBAAAABBAAAAAAAAAAAAAAAAAAAAAAABBBBBBBBBBbbbbbjjjjjjjjjjjjjjjjjjjjjjjjjjbbBBBBAAAABBAAAl
jjjjjjjjpppppppppppppppppppppppppppbbbbbbBAAAAAAAAAAAAAAAAAAAAAAAAAAAAAABBBBBBBBBbbbbbjjjjjjjjjjnnjjjjjjjjjjjjjbbbBBAAAABBBBAABl
jfjjkjjpppppppppppppppppppppppppppbbbbBBBBAAAAAAAAAAAAAAAAAAAAAAAAAAAAAAAABBBBBBBBbbbbjjjjjjjjjjnjjjjjjjjjjjjjbbbbBBAAAABBBAAABl
jjjkkjjppppppppppppppppppppppppppbbbbbBBAAABBBBBBBBBBBBBBBBBBBBBAABAAAAAAAABBBBBBBbbbbbjjjjjjjjjnjjjjjjjjjjjjbbbBBBAABAABBAAABBl
jkkkjjpppppppppppppppppppppppppppbbBBBBBABBBBBBBBBBBBBBBBBBBBBBBBBBBBBBAAAABBBBBBBBbbbbjjjjjjjjjnjjjjjjjjjjjjbbbBBAABBAAAAAABBBl
jkjjjjpppppppppppppppppppppppppppbbBAAAAABBBAAAAABBBBBBBBBAAAAAAAAAAAAAAAAAABBBBBBBbbbbjjjjjjjjjnjjjjjjjjjjjbbbbBBAABBAAAAABBBBl
jkkjjjpppppppppppppppppppppppppppbbBAAAABBAAAAAAABBBAAAAAAAAAAAAAAAAAAAAABBBBBBBBBBbbbbbjjjjjjjngjjjjjjjjjjjbbbbBBBBBAAAAABBBBBl
jjkkjjjppppppppppppppppppppppppppbbBAAAABBAAAAAAAAAAAAAAAABAABBBBBBBBBBBABBBBBBBBBBbbbbbjjjjjjnjjjjjjjjjjjjbbbbbBBBBBAAABBBBBBBl
jjkkjfjppppppppppppppppppppppppppbbBBAAABAAAAABAAAAAAAABBBBBBBBBBBABBBBBBBBBBBBBBBBbbbbbjjjjjnnjjjjjjjjjjjjbbbbbBBBBAAABBBBBBBBl
jjjkkjjppppppppppppppppppppppppppbbbBBABBAAAABBBBAABBBBBBBBBAAAAAAAAAAABBBBBBAAAABBbbbbbjjjjjnjjjjjjjjjjjjbbbbbbBBBBAABBBBBBBBBl
jjjjkjjpppppppppppppppppppppppppppbbBBBBBAAABBBBBBBBBBBABBAAAAAAAAAAAAABBBBBAAAAAABbbbbbjjjjnnjjjjjjjjjjjjbbbbbbBBBAAABBBBABBBBl
jfjkkjjjppppppppppppppppppppppppppbbBBBBBAAABBBBBBBBAAAAAAAABBBBBBBBBAAAABAAAAAAAABbbbbbjjjjnjjjjjjjjjjjjbbbbbbbBBBAAABBAAAABBBl
jjjkjkkjppppppppppppppppppppppppppbbbbBBBAAABBBBBBBAAAAAAABBBBBBBBBBBBAAAAAAAAAAAABbbbbbjjjjnjjjjjjjjjjjbbbbBBBBBAAAABBBAAAAABBl
jjkjjjkjpppppppppppppppppppppppppppbbbBBBBAAAABBBBAAAAAAABBBAAAAABBBBBAAAAAAAAAAABBbbbbbjjjnjjjjjjjjjjjbbbbbBBBBBAAABBBBAAAAAABl
jkkkkjjjpppppppppppppppppppppppppppbbbbbBBAAAAAAAAAAAABBBBAAAAAAABBBBBBAABBBBAAABBBbbbbjjjjjjjjjjjjjjbbbbbbbBBBBAAAABBBBAAAAAABl
kkkjjjjjppppppppppppppppppppppppppppbbbbBBBAAAAAAABBBBBBBAAAAAAAAABBBBAAABBBBBBBBBBbbbbjjjnjjjjjjjbbbbbbbbbbBBBBAAABBBBBAAAAAABl
kjkjjfjppppppppppppppppppppppppppppjbbbbBBBBAAAAABBBBBBBAAAAABBAAAAAAAAAAAAABBBBBBBbbbbjjjnjjjjjbbbbbbbbbbBBBBBBAAABBBBAAAAAAABl
jjkkjjjpppppppppppppppppppppppppjjjjbbbbBBBBBAABBBBBBBBAAAAABBBAAAAAAAAAAAAAABBBBBBbbbbjjnnjjjjbbbbbbbbbbbBBAAAAAAABBBAAAAAAAAAl
jjjkjjjpppppppppppppppppppppppjjjjjjbbbbBBBBBBBBBBBBBAAAAAABBBBAAAAAAAAAAAAAABBBBBBbbbbjjnjjjjbbbbbbbbbbBBBBAAAAAABBBBAAAAAAAAAl
jjjkjjjppppppppppppppppppppjjjjjjjjjjjjbbbBBBBBBBBBBAAAAABBBBBAAAAAAABBBBAAAABBBBBbbbbjjjnjjjbbbbbbbbbbbBBBBAAAABBBBBAAAAAAAAAAl
jfjkjjjppppppppppppppppppjjjjkjjjjjjjjjjjbbbBBBBBBBAAAAABBBBAAAAAAAABBBBBAAAABBBBBbbbbjjjnjjjbbbbbbBBBBBBBAAAABBBBBBBAAAAAAAAABl
jjkjjjjppppppppppppppppjjjjfjkjfjjjjkjjjjjbbbBBBBBBAAAABBBBAAAAAAAAABBBBBAAABBBBBBbbbbjjnjjjbbbbbbbBBBBBBAAAAAABBBBBBAAAAAAAAABl
kkkjjjppppppppppppppjjjjjjjjkkkjjjfkkjjjjjjbbbbBBBBAAAABBBBAAAAAAAABBBBAAABBBBBBBBbbbjjnnjjjbbbbbbBBBBBBAAAAAAABBBBBBBAAAAAAAABl
kjjjjjppppppppppppjjjkjfkkkkkjkkfjkkjjjjjjjjbbbBBBBAAAABBAAAAAAABBBBBBAAAABBBBBBBBbbbjjnjjjbbbbbbbBBBBAAAAABBAAAABBBBBAAAAAAAABl
jjjjjjppppppppppjjkjjkkkkkkjjjjkjjkjjfjjjjjjbbbbBBBBAAABBAAAAAABBBBBAAAAABBBBBBBBbbbjjnnjjjbbbbBBBBBBAAABBBBBBAAAABBBBAAAAAAAABl
jjjfjppppppppppjjjkkfkkkjkjjjfjkkkkjjjjjjfjjjbbbbbBBAAABBAAAAAABBBBBAAAABBBBBBBBbbjjjjngjjjbbbbBBABBBAAABBBBBBAAAABBBBAAAAAAAABl
jkkjjpppppppppjjjfjkkkjjjkkfjjkkjkkjjkkkkjjjjjjbbbBBBBBBBAAAAABBBBBBBBBBBBBBBBbbbjjjjnnjjjjbbbbBAAAAAAABBBAAABBBAAABBBBAAAAAAAAl
jjkjpppppppppjjjjkkkkjjjjjkjjjkjfjkfkkjjkkkjfjejjbbbbbbbMMMNMMMMMMMMBBBBBBBbbbbjjjjjjnjjjjjbbbbBAAAAAAAABBAAAAABAAABBBBBAAAAAAAl
jjkjpppppppppjejjkjjjjjjjjkkjjkkkjkkkjfkkjkkkkjjejjbbbbbMNNNNNNNNNNMBBBBBbbbjjjkjjjjnnjjjjjbbbbBAAAAAAAABBAAAAABAAAABBBBAAAAAAAl
jjkjppppppppjjjjjkkfjjjjjfkjjjkjkkkkjjjkjjjkjkkjjjjejbbbMNNNNNNNNNNMbbbbbbjjjjkkjjjnnjjjjjjbbbbBBBABBBAABBBAABBBBAAABBBBAAAAAAAl
jjkjpppppppjjjjjjjkkkjjjjkkjfjkkjjkjjjkkjfjkjjkkjjjjjjjjMNNNNNNNNNNMjjjjjjjjkkkkjjnnjjkkjjjbbbbBBBBBBBAAABBBABBBBAABBBBBAAAAAABl
fjkjpppppppjjjjfjjjjkkkkkkjjjkkjfjkjjjjkkjjkjfjkfjkjjjjjMNNNNNNNNNNMjjjjjkkkkkkkjnnjjkjjjjjbbbbBBBBBBBAAAABBABBBAAAABBBBAAAAAABl
jjjjpppppppjjjjjjfjjjjkkkjjjkkjjjjjkfjjjkkkkjjkkkkkjfjjjMNNNNNNNNNNMjjjkkkjkkkkjjnnjjkjjkjjbbbbbbbBBBBBAAAABABAAAABBBBBBBAAAAABl
jjjjpppppppjjjjkkkjjfkkjkkfjkjjjkjjkkjjfkkjkkkkkkjjjjjjjMMMMMMMMMNMMjjjjjkkkkkjjnnjjjkjjkjjbbbbbbbBBABBBAAABAAAAAABBBBBBBAAAAABl
jjjjpppppppjjfkkjkkkjkjfjkjjkjfjkkfjkjkkkjjjkjjjjjjejjjjgjjjjjjjjjjgjpppjjjkkjjnnjjjkkkjkjjebbbbbbBBABBBBAAAAAABBBBBBBBBBAAAAABl
jjfjpppppppjjjkjjjjkkkjjjjjjjjjjjkkkkjjkkjfkkjjkkfjjjjjjjjjjjjjjjjjjjppppjjjjjnnjjkkkkkjkjjjbbbbbbbBAABBAAAAABBBBBBBBBBBBBAAAABl
jkkjpppppppjjjkjjfjjjjjbbbbbbbjjjjjkjfjkjkkkkfjkkjkkkfjjjjjjjjjjjjjjjpppppjjjjnnjjkjjkjjkkjjbbbbbbbBAAAAABBAAAABBBBBBBBBAAAAAABl
jjkkpppppppjjjjjjjjbbbbbbbbbbbbbjfjkkjkjjjjjkkkkkkkjkjjjjjjjjjjjjjjjjppppppjjjnjjkkjjjkjekjjjbbbbbbBBAAAABBBBAAAAAABBBAAAAAAAABl
jjjkppppppppjjjjbbbbBBBBBBBBBBbbbbjjjjkkfjjjkkjjjkjjkkjjjjjjjjjjjjjjpppppppjjnnjjkejkjkjjkkjjjbbbbbBBAAABBBBBBAAAAAAAAAAAAAAAABl
jfjjppppppppjejbbbBBAAAAAAAAABBbbbbjjjjkkjjfjkjfkkjfjkjfjjkkkkkkkjjjjpppppjjjnnjjkkkkjkkkkkjejbbbbbBBBBBBBBBBBBBBAAAAAAAAAAAAAAl
jjjkppppppppjjjbbbBAAAAAAAAAAABBBbbjjfjjkjjjjkjjkkkkjjjjjjjjjjjjjjjjjjjppjjjjnnjjkkjjjkkkkjkkjjjbbbBBBBBBBBBBBBBBBAAAAAAAAAAAAAl
jjjkjpppppppjjbbbbBAAAAAAAAAAAAABBbbjjjjjjfjkkjkkjjkkjjjjjjnnnnngnjjjjjjjjkjjnnjkkjkkkkjjkkjkkjjjbbbbbbbbBBBBBBBBBBBAAAAAAAAAAAl
jjjjjppppppppjjjbbBAAAAAAAAAAAAAABbbjjjjjjjkkjjkjfjjjnnnnnnnjjnnnnnnjjjjjjkjnnjjkjkkjjkkjjkjjkkjjjbbbbbbbbbbbbbbBBBBBBAAAAAAAABl
fjkkjjpppppppjjjjbBBAAjjAAAAAAAAABbbjjjjfjkkjfjjjjjjnnjjjjjkkjjjnjnnnnjjjkkjnnjkkkkjjkkjjjkkjjkkjjjjbbbbbbbbbbbbBBBBBBBBBAAABBBl
kkkjjjppppppppjjjjbBAjjjAAAAAAAAABbbjjjjjjjjjjjjjnnjnjjjfjkkjkjjjjjjjjjjjjjjjjjjjjnnnnnjjjnnjkjjjjkkjjjejjjjjkkbbbbbbbbbbAAAlbbb
jjjjjjjppppppppjjjjbjjjjjAAAAAAAABbbjjjjkjjfjjjenjjjjjjjjkkjkkjjjjjjjjjjjjjjjjjjjjjjnnnnnjnnjjsnnnjnnnjnnnjjkkjbbbbbbbbbjjAAlbbb
jjjjjfjpppppppppjjjjjjjjjjAAAAAAABbbjjjjkkkjjjjngjjjkkjjkkjfkjjjjjjjjjjjjjjjjjjjjjjjjjjnnnnnnnnnnnjjjjkjjnjjkjjjjjjjbbbbjjjjbbbb
jjfjjjjjpppppppppjjjjjjjjjjAAAAABBbjjjfjjjkkjjjjjkjjjkfjkjjjkjjjjjjjjjkjjjjjjjjjjjjjjjjjjnnnnjjjjjjkkkkjjjjkkjjjjjjjjbbjjjjjbbbb
jkjjjkkjjpppppppppjjjjjbBBAAAAAABbbjjjjjjjjkjjjjjkjfjkjjjpppkkjjjjjjjjkjjjjjfjjjfjjjjjjjjjnnjjjjjjjjjjjjkkkkjjjjjjjjjjbjjjjbbbbb
jkkjjkkjjppppppppppjjjebbBBAAAABBbjjjjjejfjkjfjjjkjjkkjpppppjkjjjjjjjkkjfjjjjjjjjjjjjbbbJtDDtJbbbbbbbbjjjjjjjjpjjjpppjjjjjbbbbbb
jjkjjjkfjjppppppppppjjjjbbBBBAABbbjjjjjjjjjjjjjjkkjjkjjppppjjkjjjfjjjkjjjjjjkjjfjfjbbbttvvDDDtttEEEttbbbjjjjjpppppppppjjjbbbbbbb
fjjjfjkjjjpppppppppppjjjjbbbBBBBbjjjjfjjjjjjkkjfkjjjkjjpppjjjjjjjjjjkkjkkkjjkkjjjbbbtttvvtDDDDtEEEEEtttbjejjppppppppppjjjbbbbbbb
jjkjjjkkkkjpppppppppppjjjjjbbbbbjjjjjjjjjfjjjkkjjjfkkjjjjjjjjfjjjjjjkjjjkkjjkkjjbbttttvvtvttDDDtEEEEEttbbjjpppppppppppjjjjbbbbbb
kjkjjjjjjkjjjpppppppppjjjjjjjbbjjjfjjkkjjjjjjjkkkjjkjfjjfjjjjkjjjjjkkjjjkkjjkjjbbttFttvtvvDDDDDttEEEEEttbjjppppppppppppjjjjbbbbb
jkkjjjfjfkkjjjppppppppjjfjjjjjjjjjjjkkjjjjfjjfjkkkkkkjjjjjjfkkjjfjjkjjjkkkkkjjbbttttuuuuuuuuuGDDttEEEEEtjjjpppppppppppppjjjjbbbb
jjkjjjjjjjkjjjjpppppppjjjjjjjjjkjjjcjkjjjjjjjjkkjjjjkjjjjjjjkjjjjjkkjfjkjkkkkjbbtFttuKKKLKLLuDDDvtEEEEEtjjjjppppppppppppjjjjbbbb
jjkjfjkkkkkjfjjjpppppppjjjjfjjjkkfjjjkkfjjjjkjjjjjjjkjfjfjjkkjjjjkkjjjjjkkkkkjbbbttHuKKKLKKLuDDDvvtEEEEtjbjjjpppppppppppjjjjjbbb
fjjjjjkjjjkjjjjjjppppppjjjjjjjjjkjjjjjkkkjfjkjjjfjjfjjjjjjjkkfjjjjjjjjjjkkkkkjbbbtHtuLLLLKKLuDvDvvttEEEtjbbjjjpppppppppjjjjjjjbb
jjjjjjkjfkkkkkjfjppppppjjjjjejfjkjjjfkkjjjjkkfkkjjjjjjfjjjjkjjjjjjjjfjjjkkkkjbbbbbtHuKKKKKKLuDDDvDIttEttbbbbjjpppppppppjjjjjjjbb
jjjjjfkjjkjjjkkjjjpppppjjfjjjjjkkjjjkkkjjfjkjkkjjjfjjjjjjfkkjjjjfjjjjjjkkkjjjbbbbbttuKKKKKKKuDDDDDDtttttbbbbjjjpppppppppjjjjjjbb
jjfjjkkjekjfjjkkkjppppppjjjjjjkkjjfjkjjfjjkkjkjjjjjjjfkkkkjjjjjjjjjjjjkkkjjjjjbbbbttuLKKKKKKKDvDDDttttttbbbbbjjppppppppppjjjjjbb
jjkkkjjjjkkkjjjjjjppppppjjjjjjjjjjjkkjjjjjkjjkjfjjjfjkkjjkjjfjjjjjjfkkkkkjjjjjbbbbttuLKKKKKKuDvDDvvtFttttbbbbbjpppppppppppjjjjbb
kkkjjkjjjkkkkjfjjjjpppppjjjjjjjjfjjkjfjjjjjkfkjjjjjjjkjjjjjjjjjjjjkkkjjkkjfjjjbbbbttuLLLLLLLutvDDvvvtttttbbbbbbppppppppppppjjjbb
jjjjjkjfkkjjkjjjjjjpppppjfjjjjjjkkjkkjjjfjjkkkkjjjfjjjjfjjjjjjjfjkkjjjkkkjjjejbbbbtvuuuuuuuuuJvvDDvvvtFttbbbbbbpppOpppppppppjjbb
jjjjjjjkkkjjkkjjjjfpppppjjjjjjjjkjfjkjjjjjjjkjjfjjkkjjjjjjjfjjkkkjkkjjkkkkjjjejbbtvvtttttttttttvvDDDvvtttbbbbbbpppOppOOppppppjbb
jjfjkjkkjjjfjkjjjjjjppppjjjjjjfjkjjjjjjfjjfkkjjjjjjbbbbjjjejjjkkjjkjjjjkjjjjjjjjJtttttttbbbbbtttvDDDvtttbbbbbbppppOpppOppOpppppb
jjjjkjjjfjjjjkjfjjjjppppjjjfjjjjkjjjjjjjjjjkjjjcjjbbbbbbbjjjejkkjjkkfjjjjjjjejjjtvtttbbbbbbbbbbwwwAAAwwbbbbbbbppppOOppOOpOOppOpb
fjjkkjjjjjjjjjjjjjejppppjjjjjjjjkjfjjfjjjjjkjfjjjbbbbbbbbjjjjjkkfjjkjkkjjjjjjjkkvvtbbbbbbbbbbbbBAAAAAACBbbbbbppppppOOppOOpOppOOO
jjjkjjbbbbbbbjjejjjjppppjjjbbbjjkjjjjjjkjfjkjjjjjbbbbbbbbbjjejkkjjjkkkkjfjjjejjjttbbbbbbbbbbbbBBBAAAAAABBbbbbpppOOOOOpppOOOOpOOO
bbjjbbbbbbbbbbjjjbbbpppbbbbbbjjjjjjjjjjkkkkkjbbbbbbbbbbbbbbjjjkjjjjkkkkjjjjjjjjjJbbbbbbbbbbbbBBBBAAAAAABBmbbpppOOOOppppppOOOOOOO
bbbbbbbbbbbbbbjbbbbbbbbbbbbbbbbbbbbbbbbjjjjjbbbbbbbbbbbbbbbbbjjjjfjkkkkjjjjjjjjbbbbbbbbbbbbbbBBBBCAAAABBBmmbppOOOOOpOOOOppOOOOOO
bbbbbbbbbbbbbbbbbbbbbbbbbbbbbbbbbbbbbbbbbbbbbbbbbbbbbbbbbbbbbbbbbbbbbbbbbbbbbbbbbbbbbbbbbbbbbBBBBAAAAABBBmmmpOOOOOOOOOOOOOOOOOOO
bbbbbbbbbbbbbbbbbbbbbbbbbbbbbbbbbbbbbbbbbbbbbbbbbbbbbbbbbbbbbbbbbbbbbbbbbbbbbbbbbbbbbbbbbbbbbBBBBCAAABBBBmmmOOOOOOOOOOOOOOOOOOOO
"}
