"a" = (/obj/structure/interactive/storage/trash_pile/low_chance,/turf/simulated/floor/colored/dirt/path,/area/dmm_suite/clear_area)
"c" = (/turf/simulated/floor/colored/dirt/path,/area/dmm_suite/clear_area)

(1,1,1) = {"
accca
accca
accca
accca
accca
"}
