"a" = (/turf/dmm_suite/clear_turf,/area/dmm_suite/clear_area)
"b" = (/turf/simulated/floor/plating/shuttle,/area/shuttle/flounder)
"c" = (/mob/living/simple/turret/nanotrasen/immortal{icon_state = "active"; dir = 8},/obj/structure/interactive/lighting/fixture/bulb{dir = 8},/turf/simulated/floor/plating/shuttle,/area/shuttle/flounder)
"d" = (/turf/simulated/wall/metal/shuttle,/area/shuttle/flounder)
"e" = (/obj/structure/shuttle_engine/burst/right{icon_state = "burst_r"; dir = 1},/turf/simulated/floor/plating/shuttle,/area/shuttle/flounder)
"f" = (/obj/structure/shuttle_engine/propulsion{icon_state = "propulsion"; dir = 1},/turf/simulated/floor/plating/shuttle,/area/shuttle/flounder)
"g" = (/obj/structure/shuttle_engine/burst/left{icon_state = "burst_l"; dir = 1},/turf/simulated/floor/plating/shuttle,/area/shuttle/flounder)
"h" = (/obj/structure/shuttle_engine/heater{icon_state = "heater"; dir = 1},/turf/simulated/floor/plating/shuttle,/area/shuttle/flounder)
"i" = (/obj/structure/interactive/door/airlock/external,/turf/simulated/floor/tile/shuttle/nanotrasen,/area/shuttle/flounder)
"j" = (/obj/structure/interactive/lighting/fixture/bulb{icon_state = "preview"; dir = 1},/turf/simulated/floor/tile/shuttle/green,/area/shuttle/flounder)
"k" = (/obj/marker/spawning/window/shuttle,/turf/simulated/floor/plating/shuttle,/area/shuttle/flounder)
"l" = (/turf/simulated/wall/metal/shuttle/off_white,/area/shuttle/flounder)
"m" = (/obj/structure/interactive/lighting/fixture/bulb{dir = 8},/turf/simulated/floor/tile/shuttle/nanotrasen,/area/shuttle/flounder)
"n" = (/mob/living/simple/turret/nanotrasen/immortal{icon_state = "active"; dir = 4},/obj/structure/interactive/lighting/fixture/bulb{icon_state = "preview"; dir = 4},/turf/simulated/floor/plating/shuttle,/area/shuttle/flounder)
"o" = (/mob/living/simple/turret/nanotrasen/immortal,/turf/simulated/floor/plating/shuttle,/area/shuttle/flounder)
"p" = (/turf/simulated/floor/tile/shuttle/dark,/area/shuttle/flounder)
"q" = (/obj/structure/interactive/lighting/fixture/bulb{icon_state = "preview"; dir = 4},/turf/simulated/floor/tile/shuttle/nanotrasen,/area/shuttle/flounder)
"r" = (/turf/simulated/floor/tile/shuttle/nanotrasen,/area/shuttle/flounder)
"s" = (/obj/structure/interactive/lighting/fixture/tube{icon_state = "preview"; dir = 4},/obj/structure/interactive/chair{dir = 4},/obj/structure/interactive/chair/shuttle{icon_state = "shuttle_chair"; dir = 4},/turf/simulated/floor/tile/shuttle/nanotrasen,/area/shuttle/flounder)
"t" = (/obj/structure/interactive/lighting/fixture/tube{icon_state = "preview"; dir = 8},/obj/structure/interactive/chair{dir = 8},/obj/structure/interactive/chair/shuttle{icon_state = "shuttle_chair"; dir = 8},/turf/simulated/floor/tile/shuttle/nanotrasen,/area/shuttle/flounder)
"u" = (/obj/structure/interactive/chair{dir = 4},/obj/structure/interactive/chair/shuttle{icon_state = "shuttle_chair"; dir = 4},/turf/simulated/floor/tile/shuttle/nanotrasen,/area/shuttle/flounder)
"v" = (/obj/structure/interactive/chair{dir = 8},/obj/structure/interactive/chair/shuttle{icon_state = "shuttle_chair"; dir = 8},/turf/simulated/floor/tile/shuttle/nanotrasen,/area/shuttle/flounder)
"w" = (/obj/structure/shuttle/wing/left{icon_state = "2,4"},/turf/dmm_suite/clear_turf,/area/dmm_suite/clear_area)
"x" = (/obj/structure/interactive/status_display/local_display,/turf/simulated/wall/metal/shuttle/off_white,/area/shuttle/flounder)
"y" = (/obj/structure/interactive/status_display/local_display,/turf/simulated/wall/metal/shuttle,/area/shuttle/flounder)
"z" = (/obj/structure/interactive/chair/shuttle{icon_state = "shuttle_chair"; dir = 1},/turf/simulated/floor/tile/shuttle/dark,/area/shuttle/flounder)
"A" = (/obj/structure/interactive/chair/shuttle,/turf/simulated/floor/tile/shuttle,/area/shuttle/flounder)
"B" = (/obj/structure/interactive/computer/console/flight_control{icon_state = "computer"; dir = 1},/turf/simulated/floor/tile/shuttle/green,/area/shuttle/flounder)
"C" = (/obj/shuttle_controller,/obj/structure/interactive/chair/shuttle{icon_state = "shuttle_chair"; dir = 1},/turf/simulated/floor/tile/shuttle/dark,/area/shuttle/flounder)
"D" = (/obj/structure/interactive/chair/shuttle,/turf/simulated/floor/tile/shuttle/green,/area/shuttle/flounder)
"E" = (/obj/decal/poster/nanotrasen,/turf/simulated/wall/metal/shuttle/off_white,/area/shuttle/flounder)
"F" = (/obj/structure/sign/no_smoking,/turf/simulated/wall/metal/shuttle/off_white,/area/shuttle/flounder)
"G" = (/turf/dmm_suite/clear_turf,/turf/dmm_suite/clear_turf,/area/dmm_suite/clear_area)

(1,1,1) = {"
aaaaaaaaaaaaaaaa
aaaaaaaaaaaaaaaa
aaaclleffgllnaaa
aaablllhhlllbaaa
aGabimEEEEqibaaa
aaadyrAAAArydaaa
aaakrrpppprrkwaa
aGllsrzCzzrtllGa
aalFurAAAArvFlaa
aaGlxrpppprxlGaa
aaaakujDDjvkaaaa
aaaadddBBdddaaaa
aaaaaddkkddaaaaa
aaaaaaoaaoaaaaaa
aaaaaaaaaaaaaaaa
aaaaaaaaaaaaaaaa
"}
