//MAP CONVERTED BY dmm2tgm.py THIS HEADER COMMENT PREVENTS RECONVERSION, DO NOT REMOVE
"a" = (
/turf/dmm_suite/clear_turf,
/area/dmm_suite/clear_area)
"b" = (
/turf/simulated/floor/plating/shuttle,
/area/shuttle/flounder)
"d" = (
/turf/simulated/wall/metal/shuttle,
/area/shuttle/flounder)
"e" = (
/obj/structure/shuttle_engine/burst/right{
	dir = 1;
	icon_state = "burst_r"
	},
/turf/simulated/floor/plating/shuttle,
/area/shuttle/flounder)
"f" = (
/obj/structure/shuttle_engine/propulsion{
	dir = 1;
	icon_state = "propulsion"
	},
/turf/simulated/floor/plating/shuttle,
/area/shuttle/flounder)
"g" = (
/obj/structure/shuttle_engine/burst/left{
	dir = 1;
	icon_state = "burst_l"
	},
/turf/simulated/floor/plating/shuttle,
/area/shuttle/flounder)
"h" = (
/obj/structure/shuttle_engine/heater{
	dir = 1;
	icon_state = "heater"
	},
/turf/simulated/floor/plating/shuttle,
/area/shuttle/flounder)
"i" = (
/obj/structure/interactive/door/airlock/shuttle,
/turf/simulated/floor/tile/shuttle,
/area/shuttle/flounder)
"j" = (
/turf/simulated/floor/tile/shuttle,
/area/shuttle/flounder)
"k" = (
/obj/marker/spawning/window/shuttle,
/turf/simulated/floor/plating/shuttle,
/area/shuttle/flounder)
"l" = (
/obj/structure/shuttle/wing/left{
	dir = 1;
	icon_state = "1,0"
	},
/turf/dmm_suite/clear_turf,
/area/shuttle/flounder)
"m" = (
/obj/structure/shuttle/wing/right{
	dir = 1;
	icon_state = "1,0"
	},
/turf/dmm_suite/clear_turf,
/area/shuttle/flounder)
"s" = (
/obj/structure/interactive/lighting/fixture/bulb{
	dir = 8
	},
/turf/simulated/floor/plating/shuttle,
/area/shuttle/flounder)
"t" = (
/obj/structure/shuttle/wing/right{
	icon_state = "2,2"
	},
/turf/dmm_suite/clear_turf,
/area/shuttle/flounder)
"u" = (
/obj/structure/shuttle/wing/left{
	icon_state = "2,2"
	},
/turf/dmm_suite/clear_turf,
/area/shuttle/flounder)
"w" = (
/obj/structure/shuttle/wing/left{
	icon_state = "2,4"
	},
/turf/dmm_suite/clear_turf,
/area/dmm_suite/clear_area)
"y" = (
/obj/structure/shuttle/wing/right{
	icon_state = "2,1"
	},
/turf/dmm_suite/clear_turf,
/area/shuttle/flounder)
"z" = (
/obj/structure/interactive/lighting/fixture/tube{
	dir = 4;
	icon_state = "preview"
	},
/turf/simulated/floor/tile/shuttle,
/area/shuttle/flounder)
"A" = (
/obj/structure/interactive/lighting/fixture/tube{
	dir = 8;
	icon_state = "preview"
	},
/turf/simulated/floor/tile/shuttle,
/area/shuttle/flounder)
"B" = (
/obj/structure/interactive/computer/console/flight_control{
	dir = 1;
	icon_state = "computer"
	},
/turf/simulated/floor/tile/shuttle,
/area/shuttle/flounder)
"C" = (
/obj/structure/shuttle/wing/left{
	icon_state = "2,1"
	},
/turf/dmm_suite/clear_turf,
/area/shuttle/flounder)
"D" = (
/obj/structure/shuttle/wing/left{
	dir = 8;
	icon_state = "2,1"
	},
/turf/dmm_suite/clear_turf,
/area/shuttle/flounder)
"E" = (
/obj/structure/shuttle/wing/left{
	dir = 8;
	icon_state = "2,2"
	},
/turf/dmm_suite/clear_turf,
/area/shuttle/flounder)
"F" = (
/obj/structure/interactive/chair,
/obj/shuttle_controller,
/turf/simulated/floor/tile/shuttle,
/area/shuttle/flounder)
"G" = (
/obj/structure/interactive/lighting/fixture/tube{
	dir = 8;
	icon_state = "preview"
	},
/obj/structure/interactive/chair{
	dir = 8
	},
/turf/simulated/floor/tile/shuttle,
/area/shuttle/flounder)
"I" = (
/obj/structure/shuttle/wing/right{
	dir = 4;
	icon_state = "2,2"
	},
/turf/dmm_suite/clear_turf,
/area/shuttle/flounder)
"J" = (
/obj/structure/interactive/lighting/fixture/bulb{
	dir = 8
	},
/turf/simulated/floor/tile/shuttle,
/area/shuttle/flounder)
"K" = (
/obj/structure/interactive/lighting/fixture/bulb{
	dir = 4;
	icon_state = "preview"
	},
/turf/simulated/floor/tile/shuttle,
/area/shuttle/flounder)
"L" = (
/obj/structure/interactive/chair{
	dir = 8
	},
/turf/simulated/floor/tile/shuttle,
/area/shuttle/flounder)
"M" = (
/obj/structure/interactive/lighting/fixture/bulb{
	dir = 4;
	icon_state = "preview"
	},
/turf/simulated/floor/plating/shuttle,
/area/shuttle/flounder)
"N" = (
/obj/structure/shuttle/wing/right{
	dir = 4;
	icon_state = "2,1"
	},
/turf/dmm_suite/clear_turf,
/area/shuttle/flounder)
"W" = (
/obj/structure/interactive/lighting/fixture/tube{
	dir = 4;
	icon_state = "preview"
	},
/obj/structure/interactive/chair{
	dir = 4
	},
/turf/simulated/floor/tile/shuttle,
/area/shuttle/flounder)
"Y" = (
/obj/structure/interactive/chair{
	dir = 4
	},
/turf/simulated/floor/tile/shuttle,
/area/shuttle/flounder)
"Z" = (
/obj/structure/interactive/chair,
/turf/simulated/floor/tile/shuttle,
/area/shuttle/flounder)

(1,1,1) = {"
a
a
a
a
a
a
a
a
a
a
a
a
a
a
a
a
"}
(2,1,1) = {"
a
a
a
a
a
a
a
a
a
a
a
a
a
a
a
a
"}
(3,1,1) = {"
a
a
a
a
a
a
a
a
a
d
t
y
a
a
a
a
"}
(4,1,1) = {"
a
a
a
a
b
s
b
d
k
d
d
d
a
a
a
a
"}
(5,1,1) = {"
a
l
t
y
b
d
i
d
j
W
Y
d
k
d
D
a
"}
(6,1,1) = {"
a
m
d
d
d
d
J
j
j
j
j
z
j
d
E
a
"}
(7,1,1) = {"
a
a
a
a
e
d
d
Z
j
j
Z
j
j
d
d
a
"}
(8,1,1) = {"
a
a
a
a
f
h
d
Z
j
j
Z
j
Z
B
k
a
"}
(9,1,1) = {"
a
a
a
a
f
h
d
F
j
j
Z
j
Z
B
k
a
"}
(10,1,1) = {"
a
a
a
a
g
d
d
Z
j
j
Z
j
j
d
d
a
"}
(11,1,1) = {"
a
l
d
d
d
d
K
j
j
j
j
A
j
d
I
a
"}
(12,1,1) = {"
a
m
u
C
b
d
i
d
j
G
L
d
k
d
N
a
"}
(13,1,1) = {"
a
a
a
a
b
M
b
d
k
d
d
d
a
a
a
a
"}
(14,1,1) = {"
a
a
a
a
a
a
a
a
w
d
u
C
a
a
a
a
"}
(15,1,1) = {"
a
a
a
a
a
a
a
a
a
a
a
a
a
a
a
a
"}
(16,1,1) = {"
a
a
a
a
a
a
a
a
a
a
a
a
a
a
a
a
"}
