"a" = (/turf/dmm_suite/clear_turf,/area/dmm_suite/clear_area)
"b" = (/obj/decal/hazard/box,/obj/structure/interactive/lighting/fixture/floor/stronger,/turf/simulated/floor/plating,/area/dmm_suite/clear_area)
"c" = (/obj/decal/hazard{dir = 1},/turf/simulated/floor/plating,/area/dmm_suite/clear_area)
"d" = (/obj/decal/hazard{dir = 8; icon_state = "line"},/turf/simulated/floor/plating,/area/dmm_suite/clear_area)
"e" = (/turf/simulated/floor/plating,/area/dmm_suite/clear_area)
"f" = (/obj/decal/hazard{dir = 4},/turf/simulated/floor/plating,/area/dmm_suite/clear_area)
"g" = (/obj/decal/hazard,/turf/simulated/floor/plating,/area/dmm_suite/clear_area)
"h" = (/obj/structure/shuttle_engine/propulsion/right{icon_state = "propulsion_r"; dir = 1},/turf/simulated/floor/plating/shuttle,/area/shuttle/minivan)
"i" = (/obj/structure/shuttle_engine/propulsion/left{icon_state = "propulsion_l"; dir = 1},/turf/simulated/floor/plating/shuttle,/area/shuttle/minivan)
"j" = (/turf/simulated/wall/metal/shuttle,/area/shuttle/minivan)
"k" = (/obj/structure/shuttle_engine/heater{icon_state = "heater"; dir = 1},/turf/simulated/floor/plating/shuttle,/area/shuttle/minivan)
"l" = (/obj/structure/interactive/door/airlock/shuttle,/turf/simulated/floor/tile/shuttle,/area/shuttle/minivan)
"m" = (/turf/simulated/floor/tile/shuttle,/area/shuttle/minivan)
"n" = (/obj/marker/spawning/window/shuttle,/turf/simulated/floor/plating/shuttle,/area/shuttle/minivan)
"o" = (/obj/structure/shuttle/wing/right{icon_state = "1,0"; dir = 8},/turf/simulated/floor/plating,/area/shuttle/minivan)
"p" = (/turf/simulated/floor/plating/shuttle,/area/shuttle/minivan)
"q" = (/obj/structure/shuttle/wing/left{icon_state = "1,0"; dir = 4},/turf/simulated/floor/plating,/area/shuttle/minivan)
"r" = (/obj/structure/shuttle/wing/right{icon_state = "2,2"},/turf/simulated/floor/plating,/area/shuttle/minivan)
"s" = (/obj/structure/shuttle/wing/left{icon_state = "2,2"},/turf/simulated/floor/plating,/area/shuttle/minivan)
"t" = (/obj/structure/shuttle/wing/right{icon_state = "2,1"},/turf/simulated/floor/plating,/area/shuttle/minivan)
"u" = (/obj/structure/shuttle/wing/left{icon_state = "2,1"},/turf/simulated/floor/plating,/area/shuttle/minivan)
"v" = (/obj/structure/interactive/computer/console/flight_control{icon_state = "computer"; dir = 1},/turf/simulated/floor/tile/shuttle,/area/shuttle/minivan)
"w" = (/obj/shuttle_controller,/turf/simulated/floor/tile/shuttle,/area/shuttle/minivan)

(1,1,1) = {"
abcccbccccbcccba
adeeeeeeeeeeeefa
adeohijppjhiqefa
aderjkjlljkjsefa
adetjjjmmjjjuefa
abeenmmmmmmneeba
adeenmmmmmmneefa
adeenmmmwmmneefa
adeejjjmmjjjeefa
adeeeplmmlpeeefa
abeeejjmmjjeeeba
adeeenmmmmneeefa
adeeenmvvmneeefa
adeeennjjnneeefa
adeeeeeeeeeeeefa
abgggbggggbgggba
"}
