"a" = (/turf/dmm_suite/clear_turf,/area/dmm_suite/clear_area)
"b" = (/turf/simulated/wall/metal/shuttle/off_white,/area/shuttle/minivan)
"c" = (/obj/structure/interactive/door/airlock/external,/turf/simulated/floor/tile/shuttle/dark,/area/shuttle/minivan)
"d" = (/obj/structure/interactive/door/airlock/external,/turf/simulated/floor/tile/shuttle,/area/shuttle/minivan)
"e" = (/obj/structure/interactive/status_display/local_display,/turf/simulated/wall/metal/shuttle,/area/shuttle/minivan)
"f" = (/obj/structure/interactive/status_display/local_display,/turf/simulated/wall/metal/shuttle/off_white,/area/shuttle/minivan)
"g" = (/obj/decal/poster/nanotrasen{icon_state = ""; dir = 1},/turf/simulated/wall/metal/shuttle/off_white,/area/shuttle/minivan)
"h" = (/obj/structure/shuttle_engine/propulsion/right{icon_state = "propulsion_r"; dir = 1},/turf/simulated/floor/plating/shuttle,/area/shuttle/minivan)
"i" = (/obj/structure/shuttle_engine/propulsion/left{icon_state = "propulsion_l"; dir = 1},/turf/simulated/floor/plating/shuttle,/area/shuttle/minivan)
"j" = (/turf/simulated/wall/metal/shuttle,/area/shuttle/minivan)
"k" = (/obj/structure/shuttle_engine/heater{icon_state = "heater"; dir = 1},/turf/simulated/floor/plating/shuttle,/area/shuttle/minivan)
"l" = (/obj/decal/poster/nanotrasen,/turf/simulated/wall/metal/shuttle,/area/shuttle/minivan)
"m" = (/obj/marker/spawning/window/shuttle,/obj/marker/spawning/window/shuttle,/obj/marker/spawning/window/shuttle,/turf/simulated/floor/plating/shuttle,/area/shuttle/minivan)
"n" = (/obj/marker/spawning/window/shuttle,/turf/simulated/floor/plating/shuttle,/area/shuttle/minivan)
"o" = (/mob/living/simple/turret/nanotrasen/immortal{icon_state = "active"; dir = 1},/turf/simulated/floor/plating/shuttle,/area/shuttle/minivan)
"p" = (/turf/simulated/floor/plating/shuttle,/area/shuttle/minivan)
"q" = (/mob/living/simple/turret/nanotrasen/immortal{icon_state = "active"; dir = 8},/turf/simulated/floor/plating/shuttle,/area/shuttle/minivan)
"r" = (/mob/living/simple/turret/nanotrasen/immortal{icon_state = "active"; dir = 4},/turf/simulated/floor/plating/shuttle,/area/shuttle/minivan)
"s" = (/obj/structure/sign/no_smoking,/turf/simulated/wall/metal/shuttle/off_white,/area/shuttle/minivan)
"t" = (/turf/simulated/floor/tile/shuttle/dark,/area/shuttle/minivan)
"u" = (/obj/structure/interactive/chair/shuttle,/turf/simulated/floor/tile/shuttle/nanotrasen,/area/shuttle/minivan)
"v" = (/obj/shuttle_controller,/turf/simulated/floor/tile/shuttle/dark,/area/shuttle/minivan)
"w" = (/obj/structure/interactive/lighting/fixture/bulb,/turf/simulated/floor/tile/shuttle/nanotrasen,/area/shuttle/minivan)
"x" = (/obj/structure/interactive/chair/shuttle,/turf/simulated/floor/tile/shuttle/dark,/area/shuttle/minivan)
"y" = (/turf/simulated/floor/tile/shuttle/nanotrasen,/area/shuttle/minivan)
"z" = (/obj/structure/interactive/lighting/fixture/bulb{icon_state = "preview"; dir = 1},/turf/simulated/floor/tile/shuttle,/area/shuttle/minivan)
"A" = (/obj/structure/interactive/lighting/fixture/bulb,/turf/simulated/floor/tile/shuttle,/area/shuttle/minivan)
"B" = (/obj/structure/interactive/computer/console/flight_control{icon_state = "computer"; dir = 1},/turf/simulated/floor/tile/shuttle/dark,/area/shuttle/minivan)
"C" = (/obj/structure/interactive/chair/shuttle,/obj/structure/interactive/chair/shuttle,/obj/structure/interactive/chair/shuttle,/turf/simulated/floor/tile/shuttle/nanotrasen,/area/shuttle/minivan)

(1,1,1) = {"
aaaaaaaaaaaaaaaa
aaaaaaaaaaaaaaaa
aaaaaaoaaoaaaaaa
aaajhijppjhijaaa
aaajjkjccjkjjaaa
aaajjletteljjaaa
aaaanuAttAunaaaa
aaaamCzttzCmaaaa
aaaabgsvtsgbaaaa
aaaappdttdppaaaa
aaaaqbfttfbraaaa
aaaaanwxxwnaaaaa
aaaaanyBBynaaaaa
aaaaabnnnnbaaaaa
aaaaaaaaaaaaaaaa
aaaaaaaaaaaaaaaa
"}
