//MAP CONVERTED BY dmm2tgm.py THIS HEADER COMMENT PREVENTS RECONVERSION, DO NOT REMOVE
"a" = (
/turf/dmm_suite/clear_turf,
/area/dmm_suite/clear_area)
"b" = (
/obj/decal/hazard/box,
/obj/structure/interactive/lighting/fixture/floor/stronger,
/turf/simulated/floor/plating,
/area/dmm_suite/clear_area)
"c" = (
/obj/decal/hazard{
	dir = 1
	},
/turf/simulated/floor/plating,
/area/dmm_suite/clear_area)
"d" = (
/obj/decal/hazard{
	dir = 8;
	icon_state = "line"
	},
/turf/simulated/floor/plating,
/area/dmm_suite/clear_area)
"e" = (
/obj/decal/hazard{
	dir = 4
	},
/turf/simulated/floor/plating,
/area/dmm_suite/clear_area)
"f" = (
/obj/decal/hazard,
/turf/simulated/floor/plating,
/area/dmm_suite/clear_area)
"g" = (
/turf/simulated/floor/plating,
/area/dmm_suite/clear_area)
"h" = (
/obj/structure/shuttle_engine/propulsion/right{
	dir = 1;
	icon_state = "propulsion_r"
	},
/turf/simulated/floor/plating/shuttle,
/area/shuttle/shuttlebus)
"i" = (
/obj/structure/shuttle_engine/propulsion{
	dir = 1;
	icon_state = "propulsion"
	},
/turf/simulated/floor/plating/shuttle,
/area/shuttle/shuttlebus)
"j" = (
/obj/structure/shuttle_engine/propulsion/left{
	dir = 1;
	icon_state = "propulsion_l"
	},
/turf/simulated/floor/plating/shuttle,
/area/shuttle/shuttlebus)
"k" = (
/turf/simulated/wall/metal/shuttle,
/area/shuttle/shuttlebus)
"l" = (
/obj/structure/interactive/door/airlock/shuttle,
/turf/simulated/floor/tile/shuttle,
/area/shuttle/shuttlebus)
"m" = (
/obj/structure/shuttle_engine/heater{
	dir = 1;
	icon_state = "heater"
	},
/turf/simulated/floor/plating/shuttle,
/area/shuttle/shuttlebus)
"n" = (
/turf/simulated/floor/tile/shuttle,
/area/shuttle/shuttlebus)
"o" = (
/obj/structure/shuttle/wing/right{
	icon_state = "2,2"
	},
/turf/simulated/floor/plating,
/area/shuttle/shuttlebus)
"p" = (
/obj/structure/shuttle/wing/left{
	icon_state = "2,2"
	},
/turf/simulated/floor/plating,
/area/shuttle/shuttlebus)
"q" = (
/obj/structure/shuttle/wing/right{
	icon_state = "2,1"
	},
/turf/simulated/floor/plating,
/area/shuttle/shuttlebus)
"r" = (
/obj/structure/shuttle/wing/right{
	icon_state = "1,1"
	},
/turf/simulated/floor/plating,
/area/shuttle/shuttlebus)
"s" = (
/obj/structure/shuttle/wing/left{
	icon_state = "1,1"
	},
/turf/simulated/floor/plating,
/area/shuttle/shuttlebus)
"t" = (
/obj/structure/shuttle/wing/left{
	icon_state = "2,1"
	},
/turf/simulated/floor/plating,
/area/shuttle/shuttlebus)
"u" = (
/obj/structure/shuttle/wing/right{
	icon_state = "1,0"
	},
/turf/simulated/floor/plating,
/area/shuttle/shuttlebus)
"v" = (
/obj/structure/shuttle/wing/left{
	icon_state = "1,0"
	},
/turf/simulated/floor/plating,
/area/shuttle/shuttlebus)
"w" = (
/obj/marker/spawning/window/shuttle,
/turf/simulated/floor/tile/shuttle,
/area/shuttle/shuttlebus)
"x" = (
/obj/structure/interactive/computer/console/flight_control{
	dir = 1;
	icon_state = "computer"
	},
/turf/simulated/floor/tile/shuttle,
/area/shuttle/shuttlebus)
"y" = (
/obj/shuttle_controller,
/turf/simulated/floor/tile/shuttle,
/area/shuttle/shuttlebus)
"z" = (
/obj/structure/interactive/computer/console/shuttle_landing{
	icon_state = "computer";
	dir = 1
	},
/turf/dmm_suite/clear_turf,
/area/dmm_suite/clear_area)
"A" = (
/obj/structure/interactive/chair,
/obj/structure/interactive/lighting/fixture/tube{
	icon_state = "preview";
	dir = 1
	},
/turf/simulated/floor/tile/shuttle,
/area/shuttle/shuttlebus)
"B" = (
/obj/structure/interactive/lighting/fixture/tube{
	dir = 4;
	icon_state = "preview"
	},
/turf/simulated/floor/tile/shuttle,
/area/shuttle/shuttlebus)
"C" = (
/obj/structure/interactive/lighting/fixture/tube{
	dir = 8;
	icon_state = "preview"
	},
/turf/simulated/floor/tile/shuttle,
/area/shuttle/shuttlebus)
"D" = (
/obj/structure/interactive/chair,
/obj/structure/interactive/lighting/fixture/tube{
	dir = 4;
	icon_state = "preview"
	},
/turf/simulated/floor/tile/shuttle,
/area/shuttle/shuttlebus)
"E" = (
/obj/structure/interactive/chair,
/obj/structure/interactive/lighting/fixture/tube{
	dir = 8;
	icon_state = "preview"
	},
/turf/simulated/floor/tile/shuttle,
/area/shuttle/shuttlebus)
"K" = (
/obj/structure/interactive/chair,
/turf/simulated/floor/tile/shuttle,
/area/shuttle/shuttlebus)

(1,1,1) = {"
a
a
a
a
a
a
a
a
a
a
a
a
a
a
a
a
"}
(2,1,1) = {"
b
d
d
d
d
b
d
d
d
d
b
d
d
d
d
b
"}
(3,1,1) = {"
c
g
h
k
k
o
q
g
g
g
g
g
g
g
g
f
"}
(4,1,1) = {"
c
g
i
m
k
k
r
u
g
g
g
g
g
g
g
f
"}
(5,1,1) = {"
c
g
j
k
k
k
k
k
w
w
w
w
k
u
g
f
"}
(6,1,1) = {"
b
g
k
k
K
K
K
D
K
K
K
A
k
k
g
b
"}
(7,1,1) = {"
c
g
l
B
n
n
n
n
n
n
n
n
n
w
w
f
"}
(8,1,1) = {"
c
g
l
n
K
n
K
n
K
n
K
n
K
x
w
f
"}
(9,1,1) = {"
c
g
l
n
K
n
K
y
K
n
K
n
K
x
w
f
"}
(10,1,1) = {"
c
g
l
C
n
n
n
n
n
n
n
n
n
w
w
f
"}
(11,1,1) = {"
b
g
k
k
K
K
K
E
K
K
K
A
k
k
g
b
"}
(12,1,1) = {"
c
g
h
k
k
k
k
k
w
w
w
w
k
v
g
f
"}
(13,1,1) = {"
c
g
i
m
k
k
s
v
g
g
g
g
g
g
g
f
"}
(14,1,1) = {"
c
g
j
k
k
p
t
g
g
g
g
g
g
g
g
f
"}
(15,1,1) = {"
b
e
e
e
e
b
e
e
e
e
b
e
e
e
e
b
"}
(16,1,1) = {"
z
a
a
a
a
a
a
a
a
a
a
a
a
a
a
a
"}
