"a" = (/turf/dmm_suite/clear_turf,/area/dmm_suite/clear_area)
"b" = (/turf/simulated/wall/metal/shuttle/off_white,/area/shuttle/shuttlebus)
"c" = (/obj/structure/interactive/door/airlock/external,/turf/simulated/floor/tile/shuttle/nanotrasen,/area/shuttle/shuttlebus)
"d" = (/obj/structure/interactive/chair/shuttle,/obj/structure/interactive/lighting/fixture/tube,/turf/simulated/floor/tile/shuttle,/area/shuttle/shuttlebus)
"e" = (/obj/structure/interactive/lighting/fixture/tube{dir = 1; icon_state = "preview"},/turf/simulated/floor/tile/shuttle/nanotrasen,/area/shuttle/shuttlebus)
"f" = (/obj/structure/interactive/status_display/local_display,/turf/simulated/wall/metal/shuttle/off_white,/area/shuttle/shuttlebus)
"h" = (/obj/structure/shuttle_engine/propulsion/right{dir = 1; icon_state = "propulsion_r"},/turf/simulated/floor/plating/shuttle,/area/shuttle/shuttlebus)
"i" = (/obj/structure/shuttle_engine/propulsion{dir = 1; icon_state = "propulsion"},/turf/simulated/floor/plating/shuttle,/area/shuttle/shuttlebus)
"j" = (/obj/structure/shuttle_engine/propulsion/left{dir = 1; icon_state = "propulsion_l"},/turf/simulated/floor/plating/shuttle,/area/shuttle/shuttlebus)
"m" = (/obj/structure/shuttle_engine/heater{dir = 1; icon_state = "heater"},/turf/simulated/floor/plating/shuttle,/area/shuttle/shuttlebus)
"q" = (/obj/marker/spawning/window/shuttle,/turf/dmm_suite/clear_turf,/area/shuttle/shuttlebus)
"r" = (/mob/living/simple/turret/nanotrasen/immortal{icon_state = "active"; dir = 1},/turf/simulated/floor/plating/shuttle,/area/shuttle/shuttlebus)
"s" = (/mob/living/simple/turret/nanotrasen/immortal,/turf/simulated/floor/plating/shuttle,/area/shuttle/shuttlebus)
"t" = (/obj/structure/interactive/chair/shuttle,/turf/simulated/floor/tile/shuttle,/area/shuttle/shuttlebus)
"u" = (/turf/simulated/floor/tile/shuttle/nanotrasen,/area/shuttle/shuttlebus)
"w" = (/obj/marker/spawning/window/shuttle,/turf/simulated/floor/tile/shuttle,/area/shuttle/shuttlebus)
"x" = (/obj/structure/interactive/computer/console/flight_control{dir = 1; icon_state = "computer"},/turf/simulated/floor/tile/shuttle,/area/shuttle/shuttlebus)
"y" = (/obj/shuttle_controller,/turf/simulated/floor/tile/shuttle/nanotrasen,/area/shuttle/shuttlebus)
"z" = (/turf/simulated/floor/tile/shuttle/dark,/area/shuttle/shuttlebus)
"A" = (/obj/structure/interactive/chair/shuttle,/turf/simulated/floor/tile/shuttle/dark,/area/shuttle/shuttlebus)

(1,1,1) = {"
aaaaaaaaaaaaaaaa
aaaaaraaaaraaaaa
aahijbccccbhijaa
aabmbfuuuufbmbaa
aabbbdtuutdbbbaa
aaabbttuuttbbaaa
aaaawttuuttwaaaa
aaaawttyuttwaaaa
aaaawttuuttqaaaa
aaaawttuuttqaaaa
aaaawttuuttqaaaa
aaaaceuuuuecaaaa
aaaabfzAAzfbaaaa
aaaaabwxxwbaaaaa
aaaaaswwwwsaaaaa
aaaaaaaaaaaaaaaa
"}
