"a" = (/turf/dmm_suite/clear_turf,/area/dmm_suite/clear_area)
"b" = (/obj/structure/interactive/door/airlock/external,/turf/simulated/floor/tile/shuttle/nanotrasen,/area/shuttle/xeno)
"c" = (/turf/simulated/floor/tile/shuttle/nanotrasen,/area/shuttle/xeno)
"d" = (/turf/simulated/floor/tile/shuttle/dark,/area/shuttle/xeno)
"e" = (/obj/structure/interactive/chair/shuttle,/turf/simulated/floor/tile/shuttle/nanotrasen,/area/shuttle/xeno)
"f" = (/obj/shuttle_controller,/turf/simulated/floor/tile/shuttle/nanotrasen,/area/shuttle/xeno)
"g" = (/obj/structure/shuttle_engine/propulsion/right{icon_state = "propulsion_r"; dir = 1},/turf/simulated/floor/plating/shuttle,/area/shuttle/xeno)
"h" = (/obj/structure/shuttle_engine/propulsion{icon_state = "propulsion"; dir = 1},/turf/simulated/floor/plating/shuttle,/area/shuttle/xeno)
"i" = (/obj/structure/shuttle_engine/propulsion/left{icon_state = "propulsion_l"; dir = 1},/turf/simulated/floor/plating/shuttle,/area/shuttle/xeno)
"j" = (/turf/simulated/wall/metal/shuttle,/area/shuttle/xeno)
"k" = (/turf/simulated/wall/metal/shuttle/off_white,/area/shuttle/xeno)
"l" = (/obj/structure/shuttle_engine/heater{icon_state = "heater"; dir = 1},/turf/simulated/floor/plating/shuttle,/area/shuttle/xeno)
"m" = (/turf/simulated/floor/tile/shuttle,/area/shuttle/xeno)
"n" = (/obj/marker/spawning/window/shuttle,/turf/simulated/floor/plating/shuttle,/area/shuttle/xeno)
"o" = (/obj/structure/interactive/lighting/fixture/tube{icon_state = "preview"; dir = 1},/turf/simulated/floor/tile/shuttle/dark,/area/shuttle/xeno)
"p" = (/obj/structure/interactive/lighting/fixture/tube,/turf/simulated/floor/tile/shuttle,/area/shuttle/xeno)
"q" = (/obj/structure/interactive/lighting/fixture/bulb,/turf/simulated/floor/tile/shuttle/dark,/area/shuttle/xeno)
"r" = (/obj/structure/interactive/door/airlock/external,/turf/simulated/floor/tile/shuttle/dark,/area/shuttle/xeno)
"s" = (/mob/living/simple/turret/nanotrasen/immortal{icon_state = "active"; dir = 1},/turf/simulated/floor/plating/shuttle,/area/shuttle/xeno)
"t" = (/turf/simulated/floor/plating/shuttle,/area/shuttle/xeno)
"u" = (/mob/living/simple/turret/nanotrasen/immortal,/turf/simulated/floor/plating/shuttle,/area/shuttle/xeno)
"v" = (/obj/structure/interactive/status_display/local_display,/turf/simulated/wall/metal/shuttle,/area/shuttle/xeno)
"w" = (/obj/structure/interactive/status_display/local_display,/turf/simulated/wall/metal/shuttle/off_white,/area/shuttle/xeno)
"x" = (/obj/decal/poster/nanotrasen{icon_state = ""; dir = 4},/turf/simulated/wall/metal/shuttle,/area/shuttle/xeno)
"y" = (/obj/decal/poster/nanotrasen{icon_state = ""; dir = 8},/turf/simulated/wall/metal/shuttle,/area/shuttle/xeno)
"z" = (/obj/structure/interactive/computer/console/flight_control{icon_state = "computer"; dir = 1},/turf/simulated/floor/tile/shuttle,/area/shuttle/xeno)
"A" = (/obj/decal/poster/nanotrasen{icon_state = ""; dir = 1},/turf/simulated/wall/metal/shuttle/off_white,/area/shuttle/xeno)
"B" = (/obj/structure/sign/no_smoking,/turf/simulated/wall/metal/shuttle,/area/shuttle/xeno)
"C" = (/obj/marker/spawning/window/shuttle,/obj/marker/spawning/window/shuttle,/turf/simulated/floor/plating/shuttle,/area/shuttle/xeno)
"D" = (/obj/structure/interactive/chair/shuttle,/obj/structure/interactive/chair/shuttle,/turf/simulated/floor/tile/shuttle/nanotrasen,/area/shuttle/xeno)

(1,1,1) = {"
aaaaaaaaaaaaaaaa
aaaaaaaaaaaaaaaa
aaaaaasttsaaaaaa
aajghijbbjghijaa
aajjljvccvjljjaa
aajBjxdccdyjBjaa
aaCDDpmccmpDDCaa
aaneemmfcmmeenaa
aaneemmccmmeenaa
aannnAoccoAnnnaa
aaaaukwccwkuaaaa
aaaatrqeeqrtaaaa
aaaaakkzzkkaaaaa
aaaaaaknnkaaaaaa
aaaaaaaaaaaaaaaa
aaaaaaaaaaaaaaaa
"}
