"a" = (/turf/dmm_suite/clear_turf,/area/dmm_suite/clear_area)
"b" = (/obj/decal/hazard/box,/obj/structure/interactive/lighting/fixture/floor/stronger,/turf/simulated/floor/plating,/area/dmm_suite/clear_area)
"c" = (/obj/decal/hazard{dir = 1},/turf/simulated/floor/plating,/area/dmm_suite/clear_area)
"d" = (/obj/decal/hazard{dir = 8; icon_state = "line"},/turf/simulated/floor/plating,/area/dmm_suite/clear_area)
"e" = (/turf/simulated/floor/plating,/area/dmm_suite/clear_area)
"f" = (/obj/decal/hazard{dir = 4},/turf/simulated/floor/plating,/area/dmm_suite/clear_area)
"g" = (/obj/structure/shuttle_engine/propulsion/right{dir = 1; icon_state = "propulsion_r"},/turf/simulated/floor/plating/shuttle,/area/shuttle/xeno)
"h" = (/obj/structure/shuttle_engine/propulsion{dir = 1; icon_state = "propulsion"},/turf/simulated/floor/plating/shuttle,/area/shuttle/xeno)
"i" = (/obj/structure/shuttle_engine/propulsion/left{dir = 1; icon_state = "propulsion_l"},/turf/simulated/floor/plating/shuttle,/area/shuttle/xeno)
"j" = (/turf/simulated/wall/metal/shuttle,/area/shuttle/xeno)
"k" = (/obj/structure/interactive/door/airlock/shuttle,/turf/simulated/floor/tile/shuttle,/area/shuttle/xeno)
"l" = (/obj/structure/shuttle_engine/heater{dir = 1; icon_state = "heater"},/turf/simulated/floor/plating/shuttle,/area/shuttle/xeno)
"m" = (/turf/simulated/floor/tile/shuttle,/area/shuttle/xeno)
"n" = (/obj/marker/spawning/window/shuttle,/turf/simulated/floor/plating/shuttle,/area/shuttle/xeno)
"o" = (/obj/structure/shuttle/wing/right{icon_state = "2,2"},/turf/simulated/floor/plating,/area/shuttle/xeno)
"p" = (/obj/structure/shuttle/wing/left{icon_state = "2,2"},/turf/simulated/floor/plating,/area/shuttle/xeno)
"q" = (/obj/structure/shuttle/wing/right{icon_state = "2,1"},/turf/simulated/floor/plating,/area/shuttle/xeno)
"r" = (/obj/structure/shuttle/wing/right{icon_state = "1,1"},/turf/simulated/floor/plating,/area/shuttle/xeno)
"s" = (/obj/structure/shuttle/wing/left{icon_state = "1,1"},/turf/simulated/floor/plating,/area/shuttle/xeno)
"t" = (/obj/structure/shuttle/wing/left{icon_state = "2,1"},/turf/simulated/floor/plating,/area/shuttle/xeno)
"u" = (/obj/structure/shuttle/wing/right{icon_state = "1,0"},/turf/simulated/floor/plating,/area/shuttle/xeno)
"v" = (/obj/structure/shuttle/wing/left{icon_state = "1,0"},/turf/simulated/floor/plating,/area/shuttle/xeno)
"w" = (/obj/decal/hazard,/turf/simulated/floor/plating,/area/dmm_suite/clear_area)
"x" = (/obj/structure/shuttle/wing/left{dir = 1; icon_state = "2,1"},/turf/simulated/floor/plating,/area/shuttle/xeno)
"y" = (/obj/structure/shuttle/wing/right{dir = 1; icon_state = "2,1"},/turf/simulated/floor/plating,/area/shuttle/xeno)
"z" = (/obj/structure/interactive/computer/console/flight_control{dir = 1; icon_state = "computer"},/turf/simulated/floor/tile/shuttle,/area/shuttle/xeno)
"A" = (/obj/shuttle_controller,/turf/simulated/floor/tile/shuttle,/area/shuttle/xeno)
"B" = (/obj/structure/interactive/chair,/turf/simulated/floor/tile/shuttle,/area/shuttle/xeno)
"C" = (/obj/structure/interactive/computer/console/shuttle_landing{icon_state = "computer"; dir = 1},/turf/dmm_suite/clear_turf,/area/dmm_suite/clear_area)
"D" = (/obj/structure/interactive/chair,/obj/structure/interactive/lighting/fixture/tube,/turf/simulated/floor/tile/shuttle,/area/shuttle/xeno)
"E" = (/obj/structure/interactive/lighting/fixture/tube{icon_state = "preview"; dir = 1},/turf/simulated/floor/tile/shuttle,/area/shuttle/xeno)
"I" = (/obj/structure/interactive/chair{dir = 8},/turf/simulated/floor/tile/shuttle,/area/shuttle/xeno)
"Y" = (/obj/structure/interactive/chair{dir = 4},/turf/simulated/floor/tile/shuttle,/area/shuttle/xeno)

(1,1,1) = {"
abcccbccccbcccbC
adeeeeeeeeeeeefa
adeghijkkjghiefa
adejljjmmjjljefa
adjjjjDmmDjjjjfa
abnYmmmmmmmmInba
adnYmYmmmmImInfa
adnYmYmmAmImInfa
adnnjjEmmEjjnnfa
adeeojjmmjjpeefa
abeeqrjBBjsteeba
adeeeujzzjveeefa
adeeexjnnjyeeefa
adeeeqjeejteeefa
adeeeeeeeeeeeefa
abwwwbwwwwbwwwba
"}
