"a" = (/turf/unsimulated/void,/area/world/temple01/exterior)
"b" = (/obj/effect/fake_lighting/gradient/black,/obj/effect/fake_lighting/gradient/black{icon_state = "gradient"; dir = 4},/turf/simulated/floor/light/reebe,/area/world/temple01/exterior)
"c" = (/obj/effect/fake_lighting/gradient/black,/turf/simulated/floor/light/reebe,/area/world/temple01/exterior)
"d" = (/obj/effect/fake_lighting/gradient/black,/obj/effect/fake_lighting/gradient/black{icon_state = "gradient"; dir = 8},/turf/simulated/floor/light/reebe,/area/world/temple01/exterior)
"e" = (/obj/effect/fake_lighting/gradient/black{icon_state = "gradient"; dir = 4},/turf/simulated/floor/light/reebe,/area/world/temple01/exterior)
"f" = (/turf/simulated/floor/light/reebe,/area/world/temple01/exterior)
"g" = (/obj/effect/fake_lighting/gradient/black{icon_state = "gradient"; dir = 8},/turf/simulated/floor/light/reebe,/area/world/temple01/exterior)
"h" = (/turf/simulated/wall/clockwork,/area/world/temple01/interior)
"i" = (/turf/simulated/floor/clockwork/reebe,/area/world/temple01/interior)
"j" = (/obj/structure/interactive/door/airlock/brass,/turf/simulated/floor/clockwork/reebe,/area/world/temple01/interior)
"k" = (/turf/simulated/floor/clockwork/alt3,/area/world/temple01/interior)
"l" = (/obj/structure/smooth/window/clockwork,/turf/simulated/floor/clockwork/reebe,/area/world/temple01/interior)
"m" = (/obj/structure/smooth/table/brass,/turf/simulated/floor/clockwork/reebe,/area/world/temple01/interior)
"n" = (/obj/structure/smooth/window/clockwork,/turf/simulated/floor/clockwork/alt3,/area/world/temple01/interior)
"o" = (/obj/structure/smooth/table/brass,/turf/simulated/floor/clockwork/alt3,/area/world/temple01/interior)
"p" = (/obj/effect/fake_lighting/gradient/black{icon_state = "gradient"; dir = 1},/turf/simulated/floor/light/reebe,/area/world/temple01/exterior)
"q" = (/turf/simulated/floor/clockwork/alt2,/area/world/temple01/interior)
"r" = (/obj/structure/interactive/door/airlock/brass,/turf/simulated/floor/clockwork/alt3,/area/world/temple01/interior)
"s" = (/turf/simulated/wall/clockwork,/area/world/temple01/interior/safe)
"t" = (/obj/effect/fake_lighting/gradient/black{icon_state = "gradient"; dir = 8},/obj/effect/fake_lighting/gradient/black{icon_state = "gradient"; dir = 1},/turf/simulated/floor/light/reebe,/area/world/temple01/exterior)
"u" = (/turf/simulated/floor/clockwork/reebe,/area/world/temple01/interior/safe)
"v" = (/obj/marker/teleport_location/clockwork_exit,/turf/simulated/floor/clockwork/alt2,/area/world/temple01/interior/safe)
"w" = (/turf/simulated/floor/clockwork/alt3,/area/world/temple01/interior/safe)
"x" = (/obj/structure/smooth/window/clockwork,/turf/simulated/floor/clockwork/reebe,/area/world/temple01/interior/safe)
"y" = (/obj/structure/interactive/wishgranter/normal/clockwork,/turf/simulated/floor/clockwork/alt3,/area/world/temple01/interior/safe)
"z" = (/obj/structure/smooth/table/brass,/turf/simulated/floor/clockwork/reebe,/area/world/temple01/interior/safe)
"A" = (/obj/structure/interactive/door/airlock/brass,/turf/simulated/floor/clockwork/reebe,/area/world/temple01/interior/safe)
"B" = (/obj/structure/interactive/wishgranter/normal/clockwork/boss,/turf/simulated/floor/clockwork/alt3,/area/world/temple01/interior/safe)
"C" = (/obj/trigger/jumpmarker/clockwork_exit,/turf/simulated/floor/clockwork/reebe,/area/world/temple01/interior/safe)
"D" = (/obj/trigger/jumpmarker/clockwork_exit,/turf/simulated/floor/clockwork/alt2,/area/world/temple01/interior/safe)

(1,1,1) = {"
aaaaaaaaaaaaaaaaaaaaaaaaaaaaaaaaaaaaaaaaaaaaaaaaaaaaaaaaaaaaaaaaaaaaaaaaaaaaaaaaaaaaaaaaaaaaaaaaaaaaaaaaaaaaaaaaaaaaaaaaaaaaaaaa
abccccccccccccccccccccccccccccccccccccccccccccccccccccccccccccccccccccccccccccccccccccccccccccccccccccccccccccccccccccccccccccda
aeffffffffffffffffffffffffffffffffffffffffffffffffffffffffffffffffffffffffffffffffffffffffffffffffffffffffffffffffffffffffffffga
aeffffffffffffffffffffffffffffffffffffffffffffffffffffffffffffffffffffffffffffffffffffffffffffffffffffffffffffffffffffffffffffga
aeffffffffffffffffffffffffffffffffffffffffffffffffffffffffffffffffffffffffffffffffffffffffffffffffffffffffffffffffffffffffffffga
aeffffffffffffffffffffffffffffffffffffffffffffffffffffffffffffffffffffffffffffffffffffffffffffffffffffffffffffffffffffffffffffga
aeffffffffffffffffffffffffffffffffffffffffffffffffffffffffffffffffffffffffffffffffffffffffffffffffffffffffffffffffffffffffffffga
aeffffffffffffffffffffffffffffffffffffffffffffffffffffffffffffffffffffffffffffffffffffffffffffffffffffffffffffffffffffffffffffga
aeffffffffffffffffffffffffffffffffffffffffffffffffffffffffffffffffffffffffffffffffffffffffffffffffffffffffffffffffffffffffffffga
aeffffffffffffffffffffffffffffffffffffffffffffffffffffffffffffffffffffffffffffffffffffffffffffffffffffffffffffffffffffffffffffga
aeffffffffffffffffffffffffffffffffffffffffffffffffffffffffffffffffffffffffffffffffffffffffffffffffffffffffffffffffffffffffffffga
aeffffffffffffffffffffffffffffffffffffffffffffffffffffffffffffffffffffffffffffffffffffffffffffffffffffffffffffffffffffffffffffga
aeffffffffffffffffffffffffffffffffffffffffffffffffffffffffffffffffffffffffffffffffffffffffffffffffffffffffffffffffffffffffffffga
aeffffffffffffffffffffffffffffffffffffffffffffffffffffffffffffffffffffffffffffffffffffffffffffffffffffffffffffffffffffffffffffga
aeffffffffffffffffffffffffffffffffffffffffffffffffffffffffffffffffffffffffffffffffffffffffffffffffffffffffffffffffffffffffffffga
aeffffffffffffffffffffffffffffffffffffffffffffffffffffffffffffffffffffffffffffffffffffffffffffffffffffffffffffffffffffffffffffga
aeffffffffffffffffffffffffffffffffffffffffffhhhhhhhhhhhhhhhhhhhhhhhhhhhhhhhhhhhhhhhhhfffffffffffffffffffffffffffffffffffffffffga
aeffffffffffffffffffffffffffffffffffffffffffhiiiiiiiiiiiiiiiiiiiiiiiiiiiiiiiiiiiiiiihfffffffffffffffffffffffffffffffffffffffffga
aeffffffffffffffffffffffffffffffffffffffffffhiiiiiiiiiiiiiiiiiiiiiiiiiiiiiiiiiiiiiiihfffffffffffffffffffffffffffffffffffffffffga
aeffffffffffffffffffffffffffffffffffffffffffhiiiiiiiiiiiiiiiiiiiiiiiiiiiiiiiiiiiiiiihfffffffffffffffffffffffffffffffffffffffffga
aeffffffffffffffffffffffffffffffffffffffffffhiiiiiiiiiiiiiiiiiiiiiiiiiiiiiiiiiiiiiiihfffffffffffffffffffffffffffffffffffffffffga
aeffffffffffffffffffffffffffffffffffffffffffhiiiiiiiiiiiiiiiiiiiiiiiiiiiiiiiiiiiiiiihfffffffffffffffffffffffffffffffffffffffffga
aeffffffffffffffffffffffffffffffffffffffffffhiiiiiiiiiiiiiiiiiiiiiiiiiiiiiiiiiiiiiiihfffffffffffffffffffffffffffffffffffffffffga
aeffffffffffffffffffffffffffffffffffffffffffhiiiiiiiiiiiiiiiiiiiiiiiiiiiiiiiiiiiiiiihfffffffffffffffffffffffffffffffffffffffffga
aeffffffffffffffffffffffffffffffffffffffffffhiiiiiiiiiiiiiiiiiiiiiiiiiiiiiiiiiiiiiiihfffffffffffffffffffffffffffffffffffffffffga
aeffffffffffffffffffffffffffffffffffffffffffhiiiiiiiiiiiiiiiiiiiiiiiiiiiiiiiiiiiiiiihfffffffffffffffffffffffffffffffffffffffffga
aeffffffffffffffffffffffffffffffffffffffffffhiiiiiiiiiiiiiiiiiiiiiiiiiiiiiiiiiiiiiiihfffffffffffffffffffffffffffffffffffffffffga
aeffffffffffffffffffffffffffffffffffffffffffhiiiiiiiiiiiiiiiiiiiiiiiiiiiiiiiiiiiiiiihfffffffffffffffffffffffffffffffffffffffffga
aeffffffffffffffffffffffffffffffffffffffffffhiiiiiiiiiiiiiiiiiiiiiiiiiiiiiiiiiiiiiiihfffffffffffffffffffffffffffffffffffffffffga
aeffffffffffffffffffffffffffffffffffffffffffhiiiiiiiiiiiiiiiiiiiiiiiiiiiiiiiiiiiiiiihfffffffffffffffffffffffffffffffffffffffffga
aeffffffffffffffffffffffffffffffffffffffffffhiiiiiiiiiiiiiiiiiiiiiiiiiiiiiiiiiiiiiiihfffffffffffffffffffffffffffffffffffffffffga
aeffffffffffffffffffffffffffffffffffffffffffhiiiiiiiiiiiiiiiiiiiiiiiiiiiiiiiiiiiiiiihfffffffffffffffffffffffffffffffffffffffffga
aeffffffffffffffffffffffffffffffffffffffffffhiiiiiiiiiiiiiiiiiiiiiiiiiiiiiiiiiiiiiiihfffffffffffffffffffffffffffffffffffffffffga
aeffffffffffffffffffffffffffffffffffffffffffhiiiiiiiiiiiiiiiiiiiiiiiiiiiiiiiiiiiiiiihfffffffffffffffffffffffffffffffffffffffffga
aeffffffffffffffffffffffffffffffffffffffffffhhhhhhhhhhhhhhhhhhhiiihhhhhhhhhhhhhhhhhhhfffffffffffffffffffffffffffffffffffffffffga
aeffffffffffffffffffffffffffffffffffffffffffffffffffffffhiiiiiiiiiiiiiiihfffffffffffffffffffffffffffffffffffffffffffffffffffffga
aeffffffffffffffffffffffffffffffffffffffffffffffffffffffhiiiiiiiiiiiiiiihfffffffffffffffffffffffffffffffffffffffffffffffffffffga
aeffffffffffffffffffffffffffffffffffffffffffffffffffffffhiiiiiiiiiiiiiiihfffffffffffffffffffffffffffffffffffffffffffffffffffffga
aeffffffffffffffffffffffffffffffffffffffffffffffffffffffhiiiiiiiiiiiiiiihfffffffffffffffffffffffffffffffffffffffffffffffffffffga
aeffffffffffffffffffffffffffffffffffffffffffffffffffffffhiiiiiiiiiiiiiiihfffffffffffffffffffffffffffffffffffffffffffffffffffffga
aeffffffffffffffffffffffffffffffffffffffffffffffffffffffhiiiiiiiiiiiiiiihfffffffffffffffffffffffffffffffffffffffffffffffffffffga
aeffffffffffffffffffffffffffffffffffffffffffffffffffffffhiiiiiiiiiiiiiiihfffffffffffffffffffffffffffffffffffffffffffffffffffffga
aeffffffffffffffffffffffffffffffffffffffffffffffffffffffhiiiiiiiiiiiiiiihfffffffffffffffffffffffffffffffffffffffffffffffffffffga
aeffffffffffffffffffffffffffffffffffffffffffffffffffffffhiiiiiiiiiiiiiiihfffffffffffffffffffffffffffffffffffffffffffffffffffffga
aeffffffffffffffffffffffffffffffffffffffffffffffffffffffhiiiiiiiiiiiiiiihfffffffffffffffffffffffffffffffffffffffffffffffffffffga
aeffffffffffffffffffffffffffffffffffffffffffffffffffffffhiiiiiiiiiiiiiiihfffffffffffffffffffffffffffffffffffffffffffffffffffffga
aeffffffffffffffffffffffffffffffffffffffffffffffffffffffhiiiiiiiiiiiiiiihfffffffffffffffffffffffffffffffffffffffffffffffffffffga
aeffffffffffffffffffffffffffffffffffffffffffffffffffffffhhhhssssAsssshhhhfffffffffffffffffffffffffffffffffffffffffffffffffffffga
aeffffffffffffffffffffffffffffffffffffffffffffffffffffffffffswwwwwwwsfffffffffffffffffffffffffffffffffffffffffffffffffffffffffga
aeffffffffffffffffffffffffffffffffffffffffffffffffffffffffffxwwwwwwwxfffffffffffffffffffffffffffffffffffffffffffffffffffffffffga
aeffffffffffffffffffffffffffffffffffffffffffffffffffffffffffxwwwwwwwxfffffffffffffffffffffffffffffffffffffffffffffffffffffffffga
aeffffffffffffffffffffffffffffffffffffffffffffffffffffffffffxwwwBwwwxfffffffffffffffffffffffffffffffffffffffffffffffffffffffffga
aeffffffffffffffffffffffffffffffffffffffffffffffffffffffffffxwwwwwwwxfffffffffffffffffffffffffffffffffffffffffffffffffffffffffga
aeffffffffffffffffffffffffffffffffffffffffffffffffffffffffffxwwwwwwwxfffffffffffffffffffffffffffffffffffffffffffffffffffffffffga
aeffffffffffffffffffffffffffffffffffffffffffffffffffffffffffswwwwwwwsfffffffffffffffffffffffffffffffffffffffffffffffffffffffffga
aeffffffffffffffffffffffffffffffffffffffffffhhlllllllllllllhssssAsssshlllllllllllllhhfffffffffffffffffffffffffffffffffffffffffga
aeffffffffffffffffffffffffffffffffffffffffffhiiiiiiiiiiiiiiiiiiiiiiiiiiiiiiiiiiiiiiihfffffffffffffffffffffffffffffffffffffffffga
aeffffffffffffffffffffffffffffffffffffffffffhiiiiiiiiiiiiiiiiiiiiiiiiiiiiiiiiiiiiiiihfffffffffffffffffffffffffffffffffffffffffga
aeffffffffffffffffffffffffffffffffffffffffffhiiiiiiiiiiiiiiiiiiiiiiiiiiiiiiiiiiiiiiihfffffffffffffffffffffffffffffffffffffffffga
aeffffffffffffffffffffffffffffffffffffffffffhiiiiiiiiiiiiiiiiiiiiiiiiiiiiiiiiiiiiiiihfffffffffffffffffffffffffffffffffffffffffga
aeffffffffffffffffffffffffffffffffffffffffffhiiiiiiiiiiiiiiiiiiiiiiiiiiiiiiiiiiiiiiihfffffffffffffffffffffffffffffffffffffffffga
aeffffffffffffffffffffffffffffffffffffffffffhiiiiiiiiiiiiiiiiiiiiiiiiiiiiiiiiiiiiiiihfffffffffffffffffffffffffffffffffffffffffga
aeffffffffffffffffffffffffffffffffffffffffffhiiiiiiiiiiiiiiiiiiiiiiiiiiiiiiiiiiiiiiihfffffffffffffffffffffffffffffffffffffffffga
aeffffffffffffffffffffffffffffffffffffffffffhhhjhhhhhhhhhhhhhhhhhhhhhhhhhhhhhhhhhjhhhfffffffffffffffffffffffffffffffffffffffffga
aeffffffffffffffffffffffffffffffffffffffffffhiiiiihiiihhiiiiiiiiiiiiiiiiihhiiihiiiiihfffffffffffffffffffffffffffffffffffffffffga
aeffffffffffffffffffffffffffffffffffffffffffhiiiiihiiihhiiihhhhjjjhhhhiiihhiiihiiiiihfffffffffffffffffffffffffffffffffffffffffga
aeffffffffffffffffffffffffffffffffffffffffffhiiiiiiiiihhiiihkkkkkkkkkhiiihhiiiiiiiiihfffffffffffffffffffffffffffffffffffffffffga
aeffffffffffffffffffffffffffffffffffffffffffhiiiiiiiiihhiiihkkkkkkkkkhiiihhiiiiiiiiihfffffffffffffffffffffffffffffffffffffffffga
aefffffffffffffffffffffffffffffffffffffffffhhhhhhhhiiiiiiiihkkkkkkkkkhiiiiiiiihhhhhhhhffffffffffffffffffffffffffffffffffffffffga
aeffffffffffffffffffffffffffffffffffffffffflmkkkkkhiiiiiiiihkkknnnkkkhiiiiiiiihkkkkkmlffffffffffffffffffffffffffffffffffffffffga
aeffffffffffffffffffffffffffffffffffffffffflmkkkkkhhhhhhhhhhkkknonkkkhhhhhhhhhhkkkkkmlffffffffffffffffffffffffffffffffffffffffga
aeffffffffffffffffffffffffffffffffffffffffflmkkkkkjiiiiiiiijkkknnnkkkjiiiiiiiijkkkkkmlffffffffffffffffffffffffffffffffffffffffga
aeffffffffffffffffffffffffffffffffffffffffflmkkkkkhhhhhhhhhhkkkkkkkkkhhhhhhhhhhkkkkkmlffffffffffffffffffffffffffffffffffffffffga
aeffffffffffffffffffffffffffffffffffffffffflmkkkkkhhkkkkkkkhkkkkkkkkkhkkkkkkkhhkkkkkmlffffffffffffffffffffffffffffffffffffffffga
aefffffffffffffffffffffffffffffffffffffffffhhhhjhhhhkkkkkkkhkkkkkkkkkhkkkkkkkhhhhjhhhhffffffffffffffffffffffffffffffffffffffffga
aeffffffffffffffffffffffffffffffffffffffffffhiiiiiihkknnnkkhhhhhhhhhhhkknnnkkhiiiiiihfffffffffffffffffffffffffffffffffffffffffga
aeffffffffffffffffffffffffffffffffffffffffffhiiiiiijkknonkkhiiiiiiiiihkknonkkjiiiiiihfffffffffffffffffffffffffffffffffffffffffga
aeffffffffffffffffffffffffffffffffffffffffffhiiiiiihkknnnkkjiiiiiiiiijkknnnkkhiiiiiihfffffffffffffffffffffffffffffffffffffffffga
aeffffffffffffffffffffffffffffffffffffffffffhhhhhhhhkkkkkkkhiiiiiiiiihkkkkkkkhhhhhhhhfffffffffffffffffffffffffffffffffffffffffga
aeffffffffffffffffffffffffffffffffffffffffffhiiiiiihkkkkkkkhihhlllhhihkkkkkkkhiiiiiihfffffffffffffffffffffffffffffffffffffffffga
aeffffffffffffffffffffffffffffffffffffffffffhihhhiihhhhhhhhhjhfffffhjhhhhhhhhhiihhhihfffffffffffffffffffffffffffffffffffffffffga
aeffffffffffffffffffffffffffffffffffffffffffhiiihiiiiiiiiiiiihfffffhiiiiiiiiiiiihiiihfffffffffffffffffffffffffffffffffffffffffga
aefffffffffffffffffffffffffffffffffffffffffhhhhjhhhhhhhhhhhhhhfffffhhhhhhhhhhhhhhjhhhhffffffffffffffffffffffffffffffffffffffffga
aeffffffffffffffffffffffffffffffffffffffffflmiiiiiiiiiihiiiiihfffffhiiiiihiiiiiiiiiimlffffffffffffffffffffffffffffffffffffffffga
aeffffffffffffffffffffffffffffffffffffffffflmiiiiiiiiiihiqiqilfffffliqiqihiiiiiiiiiimlffffffffffffffffffffffffffffffffffffffffga
aeffffffffffffffffffffffffffffffffffffffffflmiiiiiiiiiijiiiiilfffffliiiiijiiiiiiiiiimlffffffffffffffffffffffffffffffffffffffffga
aeffffffffffffffffffffffffffffffffffffffffflmiiiiiiiiiihiqiqilfffffliqiqihiiiiiiiiiimlffffffffffffffffffffffffffffffffffffffffga
aeffffffffffffffffffffffffffffffffffffffffflmiiiiiiiiiihiiiiihfffffhiiiiihiiiiiiiiiimlffffffffffffffffffffffffffffffffffffffffga
aefffffffffffffffffffffffffffffffffffffffffhhhhhhhhhhhhhhhjhhhhlllhhhhjhhhhhhhhhhhhhhhffffffffffffffffffffffffffffffffffffffffga
aeffffffffffffffffffffffffffffffffffffffffffhiiiiiiiiiiiiiihkkkkkkkkkhiiiiiiiiiiiiiihfffffffffffffffffffffffffffffffffffffffffga
aeffffffffffffffffffffffffffffffffffffffffffhjhhhhhhhhhhhhhhkkkkkkkkkhhhhhhhhhhhhhhjhfffffffffffffffffffffffffffffffffffffffffga
aeffffffffffffffffffffffffffffffffffffffffffhiiiiiiiiiiiiiihkkkkkkkkkhiiiiiiiiiiiiiihfffffffffffffffffffffffffffffffffffffffffga
aeffffffffffffffffffffffffffffffffffffffffffhiiiiiiiiiiiiiihkkkkkkkkkhiiiiiiiiiiiiiihfffffffffffffffffffffffffffffffffffffffffga
aeffffffffffffffffffffffffffffffffffffffffffhiiiiiiiiiiiiiijkkkkkkkkkjiiiiiiiiiiiiiihfffffffffffffffffffffffffffffffffffffffffga
aeffffffffffffffffffffffffffffffffffffffffffhiiiiiiiiiiiiiihkkkkkkkkkhiiiiiiiiiiiiiihfffffffffffffffffffffffffffffffffffffffffga
aeffffffffffffffffffffffffffffffffffffffffffhiiiiiiiiiiiiiihkkkkkkkkkhiiiiiiiiiiiiiihfffffffffffffffffffffffffffffffffffffffffga
aefffffffffffffffffffffffffffffffffffffffffhhhhhhhhhhhhhhhhhhhhkkkhhhhhhhhhhhhhhhhhhhhffffffffffffffffffffffffffffffffffffffffga
aefffffffffffffffffffffffffffffffffffffffffhmmmmmmmmmmmmmmmmmmhrrrhmmmmmmmmmmmmmmmmmmhffffffffffffffffffffffffffffffffffffffffga
aefffffffffffffffffffffffffffffffffffffffffhllllllllllllllllllhkkkhllllllllllllllllllhffffffffffffffffffffffffffffffffffffffffga
aefffffffffffffffffffffffffffffffffffffffffhiiiiiiiiiiiiiiiiiiiiiiiiiiiiiiiiiiiiiiiiihffffffffffffffffffffffffffffffffffffffffga
aefffffffffffffffffffffffffffffffffffffffffhiiiiiiiiiiiiiiiiiiiiiiiiiiiiiiiiiiiiiiiiihffffffffffffffffffffffffffffffffffffffffga
aefffffffffffffffffffffffffffffffffffffffffhiiiiiiiiiiiiiiiiiiiiiiiiiiiiiiiiiiiiiiiiihffffffffffffffffffffffffffffffffffffffffga
aefffffffffffffffffffffffffffffffffffffffffhssxxAxxsssxxAxxsssxxAxxsssxxAxxsssxxAxxsshffffffffffffffffffffffffffffffffffffffffga
aeffffffffffffffffffffffffffffffffffffffffffsuuuuuuusuuuuuuusuuuuuuusuuuuuuusuuuuuuusfffffffffffffffffffffffffffffffffffffffffga
aeffffffffffffffffffffffffffffffffffffffffffxuuuuuuuxuuuuuuuxuuuuuuuxuuuuuuuxuuuuuuuxfffffffffffffffffffffffffffffffffffffffffga
aeffffffffffffffffffffffffffffffffffffffffffxuuuuuuuxuuuuuuuxuuuuuuuxuuuuuuuxuuuuuuuxfffffffffffffffffffffffffffffffffffffffffga
aaaaaaaaaaaaaaaaaaaaaaffffffffffffffffffffffxuuuvuuuxuuuvuuuxuuuvuuuxuuuvuuuxuuuvuuuxfffffffffffffffffffffffffffffffffffffffffga
aaaaaaaaaaaaaaaaaaaaaaffffffffffffffffffffffxuuuuuuuxuuuuuuuxuuuuuuuxuuuuuuuxuuuuuuuxfffffffffffffffffffffffffffffffffffffffffga
aaaaaaaaaaaaaaaaaaaaaaffffffffffffffffffffffxuuuuuuuxuuuuuuuxuuuuuuuxuuuuuuuxuuuuuuuxffffffffffffffffffsssssffffffffffffffffffga
aaaaaaaaaaaaaaaaaaaaaaffffffffffffffffffffffsuuuuuuusuuuuuuusuuuuuuusuuuuuuusuuuuuuusffffffffffffffffffsCCCsffffffffffffffffffga
aaaaaaaaaaaaaaaaaaaaaaffffffffffffffffffffffsssxxxsssssxxxsssssxxxsssssxxxsssssxxxsssffffffffffffffffffsCDCsffffffffffffffffffga
aaaaaaaaaaaaaaaaaaaaaaffffffffffffffffffffffffszzzsfffszzzsfffszzzsfffszzzsfffszzzsffffffffffffffffsssssCCCsssssffffffffffffffga
aaaaaaaaaaaaaaaaaaaaaaffffffffffffffffffffffffsssssfffsssssfffsssssfffsssssfffsssssffffffffffffffffswwwwwwwwwwwsffffffffffffffga
aaaaaaaaaaaaaaaaaaaaaafffffffffffffffffffffffffffffffffffffffffffffffffffffffffffffffffffffffffffffxwwwwwwwwwwwxffffffffffffffga
aaaaaaaaaaaaaaaaaaaaaafffffffffffffffffffffffffffffffffffffffffffffffffffffffffffffffffffffffffffffxwwwwwwwwwwwxffffffffffffffga
aaaaaaaaaaaaaaaaaaaaaafffffffffffffffffffffffffffffffffffffffffffffffffffffffffffffffffffffffffffffxwwwwwwwwwwwxffffffffffffffga
aaaaaaaaaaaaaaaaaaaaaafffffffffffffffffffffffffffffffffffffffffffffffffffffffffffffffffffffffffffffxwwwwwwwwwwwxffffffffffffffga
aaaaaaaaaaaaaaaaaaaaaafffffffffffffffffffffffffffffffffffffffffffffffffffffffffffffffffffffffffffffxwwwwwwwwwwwxffffffffffffffga
aaaaaaaaaaaaaaaaaaaaaafffffffffffffffffffffffffffffffffffffffffffffffffffffffffffffffffffffffffffffxwwwwwwwwwwwxffffffffffffffga
aaaaaaaaaaaaaaaaaaaaaafffffffffffffffffffffffffffffffffffffffffffffffffffffffffffffffffffffffffffffxwwwwwwwwwwwxffffffffffffffga
aaaaaaaaaaaaaaaaaaaaaafffffffffffffffffffffffffffffffffffffffffffffffffffffffffffffffffffffffffffffxwwwwwywwwwwxffffffffffffffga
aaaaaaaaaaaaaaaaaaaaaafffffffffffffffffffffffffffffffffffffffffffffffffffffffffffffffffffffffffffffswwwwwwwwwwwsffffffffffffffga
aaaaaaaaaaaaaaaaaaaaaafffffffffffffffffffffffffffffffffffffffffffffffffffffffffffffffffffffffffffffsssxxxxxxxsssffffffffffffffga
aaaaaaaaaaaaaaaaaaaaaafffffffffffffffffffffffffffffffffffffffffffffffffffffffffffffffffffffffffffffffszzzzzzzsffffffffffffffffga
aaaaaaaaaaaaaaaaaaaaaafffffffffffffffffffffffffffffffffffffffffffffffffffffffffffffffffffffffffffffffsssssssssffffffffffffffffga
aaaaaaaaaaaaaaaaaaaaaaffffffffffffffffffffffffffffffffffffffffffffffffffffffffffffffffffffffffffffffffffffffffffffffffffffffffga
aaaaaaaaaaaaaaaaaaaaaappppppppppppppppppppppppppppppppppppppppppppppppppppppppppppppppppppppppppppppppppppppppppppppppppppppppta
aaaaaaaaaaaaaaaaaaaaaaaaaaaaaaaaaaaaaaaaaaaaaaaaaaaaaaaaaaaaaaaaaaaaaaaaaaaaaaaaaaaaaaaaaaaaaaaaaaaaaaaaaaaaaaaaaaaaaaaaaaaaaaaa
"}
