"a" = (/turf/simulated/floor/chasm/end,/area/world/abyss/exterior)
"b" = (/turf/simulated/floor/basalt,/area/world/abyss/exterior)
"c" = (/mob/living/advanced/npc/ashwalker/hunter,/turf/simulated/floor/basalt,/area/world/abyss/exterior)
"d" = (/turf/simulated/floor/lava,/area/world/abyss/exterior)
"e" = (/turf/simulated/wall/rock/basalt,/area/world/abyss/exterior)
"f" = (/mob/living/advanced/npc/ashwalker/hunter,/turf/simulated/floor/colored/ash/dark,/area/world/abyss/exterior)
"g" = (/turf/simulated/floor/colored/ash/dark,/area/world/abyss/exterior)
"h" = (/turf/simulated/wall/xenomorph,/area/world/abyss/exterior)
"i" = (/mob/living/advanced/npc/ashwalker/warrior,/turf/simulated/floor/boss,/area/world/abyss/exterior)
"j" = (/turf/simulated/floor/xenomorph,/area/world/abyss/exterior)
"l" = (/mob/living/simple/npc/xenomorph,/turf/simulated/floor/xenomorph,/area/world/abyss/exterior)
"m" = (/mob/living/advanced/npc/ashwalker/warrior,/turf/simulated/floor/basalt,/area/world/abyss/exterior)
"n" = (/turf/simulated/floor/boss,/area/world/abyss/exterior)
"o" = (/turf/simulated/wall/boss,/area/world/abyss/exterior)

(1,1,1) = {"
oooooooooooooooooooooooooooooooooooooooooooooooooooooooooooooooooooooooooooooooooooooooooooooooooooooooooooooooooooooooooooooooo
oooooooooooooooooooooooooooooooooooooooooooooooooooooooooooooooooooooooooooooooooooooooooooooooooooooooooooooooooooooooooooooooo
oooooooooooooooooooooooooooooooooooooooooooooooooooooooooooooooooooooooooooooooooooooooooooooooooooooooooooooooooooooooooooooooo
oooooooooooooooooooooooooooooooooooooooooooooooooooooooooooooooooooooooooooooooooooooooooooooooooooooooooooooooooooooooooooooooo
oooooooooooooooooooooooooooooooooooooooooooooooooooooooooooooooooooooooooooooooooooooooooooooooooooooooooooooooooooooooooooooooo
oooooooooooooooooooooooooooooooooooooooooooooooooooooooooooooooooooooooooooooooooooooooooooooooooooooooooooooooooooooooooooooooo
ddddddddddddddddddddddddddddddddddddddddddddddddddddddddddddddddddddddddddddddnnnnnnnnnnnnnnnnnnnnnnddddddddddddddddddddddddddee
ddddddddddddddddddddddddddddddddddddddddddddddddddddddddddddddddddddddddddddddnnnnnnnnnnnnnnnnnnnnnnddddddddddddddddddddddddddee
ddddddddddddddddddddddddddddddddddddddddddddddddddddddddddddddddddddddddddddddnnnnnnnnnnnnnnnnnnnnnnddddddddddddddddddddddddddee
ddddddddddddddddddddddddddddddddddddddddddddddddddddddddddddddddddddddddddddddnnnnnnnninnnninnnnnnnnddddddddddddddddddddddddddee
dddddddddddddddddddddddddddddddddddddddddddddddddddddddddddddddddddddddddddddddddddddddnnnndddddddddddddddddddddddddddddddddddee
dddddddddddddddddddddddddddddddddddddddddddddddddddddddddddddddddddddddddddddddddddddddnnnndddddddddddddddddddddddddddddddddddee
dddddddddddddddddddddddddddddddddddddddddddddddddddddddddddddddddddddddddddddddddnnndddnnnndddnnnddddddddddddddddddddddddddddeee
dddddddddddddddddddddddddddddddddddddddddddddddddddddddddddddddddddddddddddddddddnnndddnnnndddnnndddddddddddddddddddddddddddeeee
dddddddddddddddddddddddddddddddddddddddddddddddddddddddddddddddddddddddddddddddddnnndddnnnndddnnnddddddddddddddddddddddddddeeeee
dddddddddddddddddddddddddddddddddddddddddddddddddddddddddddddddddddddddddddddddddddddddnnnndddddddddddddddddddddddddddddddeeeeee
dddddddddddddddddddddddddddddddddddddddddddddddddddddddddddddddddddddddddddddddddddddddnnnndddddddddddddddddddddddddddddddeeeeee
dddddddddddddddddddddddddddddddddddddddddddddddddddddddddddddddddddddddddddddddddddddddnnnnddddddddddddddddddddddddddddddeeeeeee
dddddddddddddddddddddddddddddddddddddddddddddddddddddddddddddddddddddddddddddddddddddddnnnnddddddddddddddddddddddddddddddeeeeeee
dddddddddddddddddddddddddddddddddddddddddddddddddddddddddddddddddddddddddddddddddddddddnnnnddddddddddddddddddddddddddddddeeeeeee
dddddddddddddddddddddddddddddddddddddddddddddddddddddddddddddddddddddddddddddddddddddddnnnndddddddddddddddddddddddddddddddeeeeee
dddddddddddddddddddddddddddddddddddddddddddddddddddddddddddddddddddddddddddddddddddddddnnnnddddddddddddddddddddddddeddddddeeeeee
dddddddddddddddddddddddddddddddddddddddddddddddddddddddddddddddddddddddddddddddddddddddnnnndddddddddddddddddddddddeeedddddeeeeee
dddddddddddddddddddddddddddddddddddddddddddddddddddddddddddddddddddddddddddddddddddddddnnnndddddddddddddddddddddeeeeeeddddeeeeee
ddddddddddddddddddddddddddddddddddddddddddddddddddddddddddddddddddddddddddddddddddnnnddnnnnddnnnddddddddddddddeeeeeeeeddddeeeeee
ddddddddddddddddddddddddddddddddddddddddddddddddddddddddddddddddddddddddddddddddddnnnddnnnnddnnndddddddddddddddeeeeeeedddeeeeeee
ddddddddddddddddddddddddddddddddddddddddddddddddddddddddddddddddddddddddddddddddddnnnddnnnnddnnnddddddbbbbbbddddeeeeeedddeeeeeee
dddddddddddddddddddddddddddddddddddddddddddddddddddddddddddddddddddddbbbbbbddddddddddddnnnndddddddddbbbbbbbbbdddddeeeddddeeeeeee
ddddddddddddddddddddddddddddddddddddddddddddddddddddddddddddddddbbbbbbbbbbbbbbbbbbdddddnnnnddddddddbbbbbcbbbbbdddddeeddddeeeeeee
ddddddddddddddddddddddddddddddddddddddddddddddddddddddddddddddbbbbbbbbbbeeebbbbbbbbbbbmbbbbmbbbbbbbbbbbbbbbbbbbddddddddddeeeeeee
dddddddddddddddddddddddddddddddddddddddddddddddddddddddddeedddbbbbbbbbeeeeeeeebbbbbbbbbbbbbbbbbbbbbbbbbbbbbbbbbbddddddddeeeeeeee
ddddddddddddddddddddddddddddddddddddddddddddddddddddddddeeeeddbbbcbbbeeeeeeeeeebbbbbbbbbbbbbbbbbbbbbbbbbbbbbbbbbbdddddddeeeeeeee
ddddddddddddddddddddddddddddddddddddddddddddddddddddddddeeeeddbbbbbbeeeeeeeeeeddbbbbbbbbbbbbbbbbbbbbbdddddbbbbbbbdddddddeeeeeeee
dddddddddddddddddddddddddddddddddddddddddddddddddddddddeeeeedddbbbbbeeeeeeeeeddddbbbbbbbbbbbbbbbbbbddddddddbbbbbbbdddddeeeeeeeee
dddddddddddddddddddddddddddddddddddddddddddddddddddddddeeeeedddbbbbbeeeeeeeeeddddbbbbbebbbbbbbbbbbdddddddddbbbbbbbddddddeeeeeeee
dddddddddddddddddddddddddddddddddddddddddddddddddddddddeeeedddddbbbbeeeeeeeeedddbbbbbeebbbbbbbbbdddddddddddbbbbbbbbddddddeeeeeee
ddddddddddddddddddddddddddddddddddddddddddddddddddddddeeeeeddddddbbbeeeeeeeeddddbbbbeeebbbbbbbdddddddddddddbbbbbbbbbdddddeeeeeee
dddddddddddddddddddddddddddddddddddddddddddddddddddddeeeeeeddddddbbbggeeeeedddddbbbeeebbbbbbbddddddddddddddbbbbbbbbbdddddeeeeeee
dddddddddddddddddddddddddddddddddddddddddddddddddddddeeeeeddddddddbbggeeeeeddddbbbeeeebbbbbdddddddddddddddbbbbbbbbbddddddeeeeeee
ddddddddddddddddddddddddddddddddddddddddddddddddddddeeeeeeddddddddbbbggeeeddddbbbbeeebbbbbdddddddddddddddbbbbbbbbbbdddddeeeeeeee
ddddddddddddddddddddddddddddddddddddddddddddddddddddeeeeeddddddddbbbbbggeedddbbbbeebbbbbbddddddddddddddddbbbbbbbbbbdddddeeeeeeee
dddddddddddddddddddddddddddddddddddddddddddddddddddeeeeeeddddddddbbbbbbgedddbbbbbbbbbbbbdddddddddddddddbbbbbbbbbbbddddddeeeeeeee
dddddddddddddddddddddddddddddddddddddddddddddddddddeeeeeedddddddbbbbbbbgeddbbbbbbbbbbbbdddddddddddddddbbbbbbcbbbbbdddddeeeeeeeee
ddddddddddddddddddddddddddddddddddddddddddddddddddeeeeeeddddddddbbbbbbbbbbbbbbbbbbbbbbddddddddddddddbbbbbbbbbbbbbbddddeeeeeeeeee
eddddddddddddddddddddddddddddddddddddddddddddddddeeeeeedddddddddbbbbbbbbbbbbbbbbcbbbbddddddddddddbbbbbbbbbbbbbbbbbdddeeeeeeeeeee
eeddddddddddddddddddddddddddddddddddddddddddddddeeeeeeeddddddddbbbbbbbbbbbbbbbbbbbbbbbbddddbbbbbbbbbbbbbbbbbbbbbbddddeeeeeeeeeee
eeeddddddddddddddddddddddddddddddddddddddddddddeeeeeeedddddddddbbbbbbbbbdddbbbbbbbbbbbbbbbbbbbbbbbbbbbbgggggbbbbbddddeeeeeeeeeee
eeedddddddddddddddddddddddddddddddddddddddddddeeeeeeddddddddddbbbbcbbbbbddddbbbbbbbbbbbbbbbbbbbbbbbbbggggggggbbbbdddeeeeeeeeeeee
eeedddddddddddddddddddddddddddddddddddddddddeeeeeeedddddddddbbbbbbbbbbbddedddbbbbbbbbbbbbbbbbbbbbbbbbggggeeeebbbbdddeeeeeeeeeeee
eedddddddddddddddddddddddddddddddddddddddddddeeeedddddddddbbbbbbbbbbbbbddeeddbbbbbbbbbbbbggbbbbbbbbbbggeeeeeebbbbddeeeeeeggbeeee
eedddddddddddddddddddddddddddddddddddddddddddddddddddddbbbbbbbbbbbbbbbddeeeddbbbbggggggggggggggbbbbbbgeeeeeeeebbbddeeeeeeggggeee
eeedddddddddddddddddddddddddddddddddddddddddddddddddddbbbbbbbbbbbbbbbddeeeedbbbbeeeeeeeeeeeegggggbbbggeeeeeeeebbbdeeeeegggggggee
eeeddddddeddddddddddddddddddddddddddddddddddddddbbbbbbbbbbbbbbbbbbbdddeeeeedbbbbddeeeeeeeeeeeggggbbbgeeeeeeeeebbbeeeeeggggggggee
eeeeddeeeeeedddddddddddddddddddddddddddddddddddbbbbbbbbbbbbbbbbbbbdddeeeeeddbbbbddddddddeeeeeeggggbbgeeeeeeeeebbbeebgggbbbggfgee
eeeeeeeeeeeeeedddddddddddddddddddddddddddbbbbbbbbbbbbbbbbbbbbbbbbdddeeeeedddbbbbbddddddddeeeeeegggbbgeeeeeeeeebbbeeggbbbbeggggee
eeggggggggeeeeeeddddddddddddddddddddddbbbbbbbbbbbbbbbbbbbbbbbbbbbdeeeeeeddddbbbbbddddddddeeeeeeeggbggeeeeeeeeebbbbbbbbbbeeggggee
eeeggbbbgggggeeeedddddddddddddddddddbbbbbbbbbbbbbbbbbbbbbbbbbbbbbeeeeeeeddddbbbbbddddddddeeeeeeeegbbbeeeeeeeeebbbbbbbbbeeeegggee
eeggbbbbbgggggeeedddddddddbddbbbdbbbbbbbbbbbbbbbbbbdddddddbbbbbbbbbeeeeeedddbbbbbdddddddeeeeeeeeeebbbbeeeeeeebbbbbbbbbeeeeeeggee
ebggbbbbbbbggggeeedddddddbbbbbbbbbbbbbbbbbbbbbddddddddddddddbbbbbbbbeeeedddebbbbbdddddddeeeeeeeeeebbbbbbeeebbbbbbbbbeeeeeeeebeee
egggbbbbbbbbbgggeeddddddbbbbbbbbbbbbbbbbbbbbbbdddddddeeeeddddbbbbbbbbeeeedebbbbbbddddddeeeeeeeeeeebbbbbbbbbbbbbbbbeeeeeeeeeebeee
eggbbbbbbbbbbbgggeeddddebbbbbbbbbbbbbbbbbbbbbdddddddeeeeeeddddbbbbbbbeeeeeebbbbbdddddddeeeeeeeeeebbbcbbbbbbbbbbbbeeeeeeeeeeebeee
egbbbbbbbbbbbbbggeeddddeebbbbbbbbbbbbbbbbbbbddddddddeeeeeedddddbbbbbbbeeeeebbbbbddddddeeeeeeeeeeebbbbbbbbbbbbbeeeeeeeeeeeeeegeee
eebbbbbbbbbbbbbbgeedddeeeeebbbbbbbbbbbbbbbdddddddddeeeeeeeddddddbbcbbbeeeebbbbbdddddeeeeebbbeeeebbbbbbbeeeeeeeeeeeeeeeeeeeegggee
eebbbbbbbbbbbbbbeeedddeeeeeeeebbbbbbbbbbbddddddddddeeeeeeeddddddbbbbbbeeeebbbbbeeeeeeebbbbbbbbbbbbbbbbbeeeeeeeeeeeeeeeeeeeggggee
eebbbbbbbbbbbbeeeeedddeeeeeeeeeebbbbbbbbbedddddddddeeeeeeeedddddbbbbbeeeebbbbbbeeeeebbbbbbbbbbbbbbbbbbeeeeeeeeeeeeeeeeeeebgggeee
eebbbbbeeeeeeeeeeedddddeeeeeeeebbbbbbbbbeeeeddddddeeeeeeeeeddddbbbbbbeeeebbbbbeeeeebbbgggggggggggbbbbbeeeeeeeeeggggggggggggggeee
eebbbbbeeeeeeeeeeddbbbddeeebbbbbbbbbbbbbbgggedddddeeeeeeeeeddddbbbbbbeeeebbbbbeeeeebbggggggbbbbbggggbbbbeeeeggggeeeeeeeeebbgggee
eeeebbbbeeeeebbbbbbbbbbbbbbbbbbbbbeeebbbbgggeeddddeeeeeeeedddddbbbbbbeeebbbbbbbbbbbbgggfggbbbbbbbbbgggbbggggggbbbeeeeeeeebbbggee
eeeeebbbbbbbbbbbbbbbbbbbbbbbbbbbeeeeeebbbbgggebdddeeeeeeeeddddbbbbbbbbbbbbbbbbbbbbbggggggggbbbeeeeeebggggbbbbbbddddeeeeeebbbggee
eedeeebbbbbbbbbbbbbbbbbbbbbbbbbbeeeeeeebbbbggeedddeeeeeeeedddbbbbbbbbbbbbbbbbggbbgggggggggggeeeeeeeebgggbbbbbbbddddddeedebbbgeee
eddeeeebbbbbbbddddbbbbbbbbbbbbbbbeeeeeebbbbgggeeddeeeeeeeedddbbbbbbgggggbbggggggggggggggeeeeeeeeeeebgggbbbbbbbbdddddddddddbbeeee
edddeddddddddddddddeeeeeeeeebbbbbbbeeeebbbbbggeeddeeeeeeeedddbbbbbgggggggggggggeeeeeeeeeeeeeeeeeeeggggbbcbbbbbdddddbbbddddddeeee
eddddddddddddddddeeehhhhhhheeebbbbbbbbbbbbbbggeeddeeeeeeedddbbbbbgggggggggeeggeeeeeeeeeeeeeeeeeeebgggbbbbbbbbdddddbbbbbbddddeeee
edddddddddddddddeeehhjjjjjhheeebbbbbbbbbbbbbggeeddeeeeeeedddbbgggggggggeeeeeggeeeddddeeeeeeeeeeeeggggbbbbbbbdddddbbbbbbbbdddeeee
eedddddddddddddeeehhjjjjjjjhheeeeeeeebbbbbbgggeedddeeeeeddddbgggggggeeeeeeebggebbbbbddddddeeeeeeegggbbbbbbbbdddddbbbbbbbbddbeeee
eeeedeeeeeeeeeeeehhjjjjjjjjjhhehhhhheebbbbbgggeeddddeeeddddbggggeeeeeeeeeebbbggggbbbbbbddddeeeeeeggbbbbdbbbbddddbbbbbbbbbdbbbeee
eeeeeeeeeeeeeeeehhjjjljjjljjjhhhjjjhheebbbbggeeedddddedddddbeeeeeeeeeeeeebbbbbbbbbbbbbbbbdddeeeeeggbbbbdbbbbddddbbbbbbbbbdbbbeee
hhhhhhhhhhhhhhhhhjjjjjjjjjjjjjhjjjjjhhebbbbggeedddddddddddeeeeeeeeeeeeebbbbbbbbbbbbbbbbbbbdddeeebggbbbbddbbbddddbbbbbbbbddbbbbee
hhhhhhhhhhhhhhhhhjjjljjjjjljjjjjjljjjhebbbggeeddddddddddeeeeeeeddddedbbbbbbbbbbbddddbbbbbbbddeeebgbbbbdddbbbddddbbbbbbbbbbbbbbee
hhhhjjjjjhhhhhhhhjjjjjjjjjjjjjjjjjjjjhebbbgeeddddddddddeeeeeeddddddddbbbbbbbbbbddddddbbbbbbbddeebbbbbbdddbbbdddbbbbbbdbbbbbbbdee
hhhjjjjjjjhhhhhhhjjjjljjjljjjjjjjjjjjhebbeeeedddddddddeeeeeeddddbbbbbbbbbbbbddddddddddbbbbbbbdeebbbbbbdddbbbdddbbbbdddbbbbbbddee
hhjjjjjjjjjhhhhhhjjjjjjjjjjjjjhjjjjjhhebbeeeeddddddbeeeeeeedddbbbbbbbbbbbbdddddddddddbbbbbbbbbeebbbbbdddbbbbdddbbbddbbbbbbbdddde
hjjjljjjljjjhhhhhhjjjjjjjjjjjhhhjjjhheebeeeddddddddeeeeeeeeddbbbbbbbbbbbbdddddddddddbbbbbcbbbbbbbbbbbdddbbbbbddddddbbbbbbbddddde
hjjjjjjjjjjjhhhhhhhjjjjjjjjjhhjjjhhheebbeeddddddddbeeeeeeeeddbbbbbbbbbbbbbddddddddbbbbbbbbbbbbbbbbbbbdddbbbbbbbbbbbbbbbbbddeedde
hjjjjjjjjjjjhhhhhhhhjjjjjjjhhjjjjjhhebbbeddddddddeeeeeeeeeeddbbbbbbbbbbbbbbddddddbbbbbbbbbbbbbbbbbebdddbbbbbbbbbbbbbbbbdddeeedde
hjjjjjjjjjjjhhhhhhhhhjjjjjhhjjjjjjjhebeeedddddddeeeeeeeeeeeeddbbbbbbbbbbbbbbbbbbbbbbbbeeeeebbbbeeeeddddbbbbbbbbbbbbbbbddeeeeedde
hjjjjljjjjjhhhhhhhhhhhjjjhhhjjljjjjhebeeedddddeeeebbbbgeeeeeeddbbbbbbbbbbbbbbbbbbbbbbeeeeeebeeeeeeddddbbbbbbbbbbbbdddddeeeeeeede
hhjjjjjjjjhhjjjhhhhhhjjjjjhhjjjjjjjhebeedddddeeebbbbbgggeeeeeeebbbbbbbbbbbbbbbbbdddeeeeeeeeeeeeeddddddbbbggggbbbbdddbeeeeeeeeede
hhhjjjjjjhhjjljjhhhhjjjjjjjhhjjjjjhhebedddddeeebbbbbgggeeeeeeeeebbbbbbbbbbbbddddddeeeeeeeeeeebbddddddbbbgggeeedbbdeeeeeeeeeeeeee
hhhhjjjjhhjjjjjjjhhjjjjjjjjjhhjjjhheebbddddeeebbbbbbbbbbeeeeeeeeeeeedddddddddddeeeeeeeeeeebbbbddddddbgggggeeeedbbdeeeeeeeeddeeee
hhhhhjjhhhjjjjjjjjjjjjjljjjjjhhhhhheebbddeeeebbbbbbbbbbbbbeeeeeeeeeeedddddddeeeeeeeeebbbbbbdddddddbggggggeeeeedbbdeeeeeeeddddeee
hhhhjjjjhhjljjjljjjjjjjjjjjjjhhhhhhebbbeeeeeebbbbbbbebbbbbbeeeeeeeeeeeeeeeeeeeeeeeebbbbbbbddddddeeeeeeeeeeeeeedbbdddeeeddddddeee
hhhjjjjjjhhjjjjjhhjjjjjjjjljjhhhhhhebbeeeeeebbbbbbbeeebbbbbbeeeeeeeeeeeeeeebbbbbbbbbbbbbbddddddeeeeeeeeeeeeedddbbddddddddddddeee
hhjjjjjjjjhhjjjhhhjjjjjjjjjjjhhhhhhebbeeeeebbbbbbeeeeeebbbbbeeeeeeeeeebbbbbbbbbbbbbbbbbdddddddeeeeeeeeeedddddbbbbbbbbbdbdddddeee
hjjjjjjjjjjhjjjhhhjjjljjjjjjhhhhhhhebbbeeebbbbbbeeeeeeeebbbbeeeeeeeebbbbbbbbbbbbbbbbbbddddddddeeeeeeebdddbbbbbbbbbbbbbbbddddddee
hjjjljjjljjjjjjjhhhjjjjjjjjhhjjjhhhebbbbeebbbbbeeeeeeeeebbbbbbeeeebbbbbbbbbbbbbbbeeeddddddddddebbbbbbbbbbbbbbbbbbbbbbbbbbdddddee
hjjjjjjjjjjjjjjjhhhhjjjjjjhhjjjjjhhebbbbbbbbbbbbeeeeeeeeebbbbbeebbbbbbbcbbbbbbbeeeeddddddddddddbbbbbbbbbbbbbbbbbbbbbbbbbbbddddee
hjjjjjjjjjjjjjjjhhhhhjjjjhhjjljjjjhebbbbbbbbbbbbbbbeeeeeeebbbbbbbbbbbbbbbbbbbeeeeeddddddddddddbbbbbbbbbbbbbbbbbbbbbbbbbbebeddeee
hjjjjjljjjjhjjjhhhhhhhjhhhhjjjjjjjhebbbbbbbbbbddddbbbbeeeeebbbbbbbbbbbbbbbbeeeeeeeddddddddddbbbbbbbbbbbbbbbbbbbbbbbbbbbbeeebeeee
hhjjjjjjjjhhjjjhhhhhhjjjhhhjjjjljjheebbbbbbbbdddddddbbeeeeeebbbbbbbbbbbbbeeeebeeeddddddddddbbbbbbeebeeebbbbgbbbbbbbbbbbbbbbbeeee
ehhjjjjjjhhjjjjjhhhhhjjjhhhhjjjjjhhebbbbbbbbbbdddddddbbeeeeebbbbbbbbeeeeeeeeeeeeddddddddddbbbbbbeeeeeebbbbggbbbbeeeeeebbbbbbbeee
eehhjjjjhhjjjjjjjhhhhhjhhhhhhjjjhheebbbbbbbbbbbdddddddbbbeeeebbbbbbeeeeeeeeeeeeeddddddddbbbbbbbeeeeeeebbbggbbbbeeeeeeebbbbbbbeee
eeehhjjhhhjjjljjjhhhhjjjhhhhhhjjheebbbbbeeebbbbbdddddddbbeeeebbbbbeeeeegeeeeeeedddeeeddbbbbbbeeeeedeeebbbgbbbeeeeeeeebbbbbbbbbee
eehhjjjjhhjjjjjjjhhhjjjjjhjjjjjjhebbbbbeeeeeeebbbddddddbbbeeebbbbeeeeggggeeeeeedddeeedbbbbbbeeeebddeeebbggbeeeeddbbbbbbeeebbbbee
ehhjjjjjjhhjjjjjhhhjjjjljjjjjjjjhebbbeeeeeeeeeeeeeddddddbbeeeebbbeegggbbdddeeedddbeeebbbbbeeeeedddddeegggbeeeedddbbbbeeeeeebbbee
hhjjjjjjjjhhjjjhhhhjjjjjjjjjjjjjhebbeeeedeeeeeeeeeddddddbbeeeebbbbbbbbbdddddeedddeeebbbbbbeeeddddddeeeggbeeeeddbbbbbeeeeeeeeeeee
hjjjjjjjjjjhhhhhjhhjjljjjjjjjjjjhebbeeeddeeeeeeeeeedddddbbeeeebbbbbbbbddddddddddbeeebbbbbbeedddddddeebgggeeedddbbbbbbbbbeeeeeeee
hjjljjjljjjjhhjjjjhhjjjjjhjjjjjjhebbeeddddeeeeeeeeeddddddbeeeebbbbbbbbddddddddddeeebbbbbbbbbdddddddeeeeggeeeddbbbbbbbbbbbbbbeeee
hjjjjjjjjjjjjjjjjjjhhjjjhhhhhhjhheebbeeddddeeeeeeeeedddddbeeebbbbbbgbbddddddddddeebbbbbbbbbbddddddeeeeeggeeddbbbbbbbbbbbbbbbeeee
hjjjjjjjjjjjjjjjljjjhhhhhhhhhhjheeebbeeddddeeeeeeeeeddddbbeeebbbbeegggddddddbdddeebbbbbbbbbbbddddeeeebbggeedbbbbbbbbbbbbddbbbaee
hjjjjjjjjjjjjjjjjjjjhhjjjjhhhhjheeebbbeeddddeeeeeeeeddddbeeeebbbbeeeeggddddeedddebbbbbbbbbbbbbbeeeeeebggggebbbbbbbbbbbbbbddbbaee
hhjjjljjjjjhhhjjjjjhhjjjjjjhhhlheeebbbeeeddddeeeeeeeddddeeeebbbbbeeeeeeedeeeeeddddbbbbbbbbbbbbeeeeeebbgbggebbbbbbbbbbbbbbdddbaee
ehhjjjjjjjjhhhhjjjhhjjjjjjjjhhjheeebbbbeeddddeeeeeeddddeeeebbbbbbeeeeeeeeeeeeedddddbbbbbbbbbbbeeeeeebbbbbgeebbbbbbebbbbbbdddbaee
eehhjjjjhjjhhhhhhhhjjjjjjjjjjhjheeeebbbbeeddddeeeeeddddeeebbbbbbbbbeeeeeeeeeeeddddddbbbbbbbbbeeeeeebbbbbbbbbbbbbbbeebbbbbbdddaae
eeehhhhhhjjjjjhhhhjjjjjjljjjjhjheeeeebbbbeeddddeeeeddddeebbbbbbbbbbbbeeeeeeeeeddddddbbbbbbbbbeeeeddddddbbbbbbbbbbgeebbbbbbdddaae
eeeeeehhjjjjjjjhhhjjjjjjjjjjjhjheeeeeebbbbeddddeeeeddddddbbbbbbbbbbbbbbeeeeeeeddddddbbbbbbbbbbddddddddddbbbbbbbbbgeeebbbbbbdbbae
eeeeehhjjjjjjjjjhhjjjjjjjjjjjhjheeeeeebbbbbddddeeeedddddddbbbbbbbbbbbbbbeeeeeddddddbbbbbbbbbbbddddddddddbbbbbbbbggeebbbbbbddbbae
eeeeehjjjjjjjjjjjjjjjljjjjjjhhjhheeeeebbbbbbdddeeeeddddddddbbbbbbbbbbbbbeeeeedddddbbbbdbbbbbbbdbdddddddddbbbbbbgggeebbbbbdddbbae
eeeeehjjjjjjljjjjjjjjjjjjjjhhjjjhheeebbbbbbdddddeeedddddddddbbbbbbbbbbbbbeeeedddddbbbdddbbbbbbbbdbdddddddbbbbgggeeebbbbbbdddbbae
eeeeehjjjjjjjjjjjhhhjjjjjjhhjjjjjhhebbbbbbbdddddeeedddddddddddbbbbbbbbbbbeeeddddbbbbbdddddbbbbbbbbbddddddbbgggeeeeebbbbbbdddbaae
eeeeehjjjjjjjjjjjhhhhjjjjhhjjljjjjjbbbbbbbddddddeeddddddddddddddbbbbbbbbdddddddbbbbbbddddeebbbbbbbbbbbddddbggeeeeeebbbbbbdbbbaae
eeeeehjjljjjjjjjjhhhhhhhhhhjjjjjjjjbbbbbbbdddddbeddddddbddddddddddbbbbbddddddddbbbbbbddddeebbbbbbbbbbbddddeeeeeeebbbbbbbddbbbaae
eeeeehhjjjjjjjjjjjjjjjjjjjjjjjjljjjbbbbbddddddeeedddddbbbdddddddddddddddddddddddbbbbddddeeebbbbbbbbbbddddeeeeeebbbbbbbbbdbbaaaae
eeeeeehhjjjjjjjhhhhhhhhhhhhhjjjjjhhebbbdddddeeeeeedddeebbbbdddddddddddddddddddddbbdddddeeeeebbbbbbbbdddddeeeebbbbbbbbbbbdbaaaaee
eeeeeeehhjjjjjjjjjjjjjjjjjjjjjjjhheeeedddddddeeedddddeeebbbbbddddddddddddddddddddddddeeeeeeebbbbbbddddddeeeebbbbbbbbbbbbaaaaaeee
eeeeeeeehhhhhhhhhhhhhhhhhhhhhhhhheeeeeeededddddddddeeeeeeebbbbbbdddddddddeeeeeeeedddeeeeeeeebbddddddddddeebbbbbbbbbbbbbbaaaaeeee
eeeeeeeeeeeeeeeeeeeeeeeeeeeeeeeeeeeeeeeeeeedddddddeeeeeeeeeebbbbbbbbbbbeeeeeeeeeeeeeeeeeeeeeedddddddddddeebbbbbbbbbbbbbaaaeeeeee
eeeeeeeeeeeeeeeeeeeeeeeeeeeeeeeeeeeeeeeeeeeeeeeeeeeeeeeeeeeeeeeeeeeeeeeeeeeeeeeeeeeeeeeeeeeeeeddddddddddeeebbbbbbbbbbbbeeeeeeeee
"}
