"a" = (/turf/simulated/wall/rock,/area/world/caves/interior)
"b" = (/turf/simulated/floor/cave_dirt,/area/world/caves/interior)
"c" = (/turf/simulated/wall/cult,/area/world/caves/interior)
"d" = (/turf/simulated/floor/wood/dock,/area/world/caves/interior)
"e" = (/turf/simulated/wall/diona,/area/world/caves/interior/safe)
"f" = (/turf/simulated/floor/colored/dirt/cave,/area/world/caves/interior)
"g" = (/turf/simulated/wall/rock,/area/world/caves/exterior)
"h" = (/turf/simulated/wall/wood/brown,/area/world/caves/interior)
"i" = (/turf/simulated/floor/wood/brown,/area/world/caves/interior)
"j" = (/turf/simulated/floor/diona,/area/world/caves/interior/safe)
"k" = (/obj/structure/interactive/wishgranter/normal/caves/nymph,/turf/simulated/floor/cave_dirt,/area/world/caves/interior/safe)
"l" = (/turf/simulated/wall/rock,/area/world/caves/interior/safe)
"m" = (/turf/simulated/floor/river,/area/world/caves/exterior)
"n" = (/turf/simulated/floor/colored/dirt/cave,/area/world/caves/exterior)
"o" = (/turf/simulated/floor/river,/area/world/caves/interior)
"p" = (/turf/simulated/floor/cave_dirt,/area/world/jungle/exterior)
"q" = (/turf/simulated/floor/river,/area/world/jungle/exterior)
"r" = (/turf/simulated/floor/colored/grass,/area/world/caves/interior/safe)
"s" = (/turf/simulated/floor/wood/dock,/area/world/caves/exterior)
"t" = (/turf/simulated/floor/cave_dirt,/area/world/caves/exterior)
"u" = (/turf/simulated/floor/diona,/area/world/caves/interior)
"v" = (/obj/structure/scenery/grass,/turf/simulated/floor/colored/grass,/area/world/caves/interior/safe)
"w" = (/turf/simulated/wall/diona,/area/world/caves/interior)
"x" = (/turf/simulated/floor/colored/dark_grass,/area/world/caves/exterior)
"y" = (/obj/structure/scenery/rocks,/turf/simulated/floor/cave_dirt,/area/world/caves/interior/safe)
"z" = (/obj/structure/scenery/evergreen,/turf/simulated/floor/colored/grass,/area/world/caves/interior/safe)
"A" = (/obj/structure/interactive/wishgranter/normal/caves,/turf/simulated/floor/colored/grass,/area/world/caves/interior/safe)
"B" = (/obj/structure/scenery/rocks,/turf/simulated/floor/colored/dirt/cave,/area/world/caves/exterior)
"C" = (/obj/structure/scenery/rocks,/turf/simulated/floor/cave_dirt,/area/world/caves/interior)
"D" = (/obj/structure/scenery/rocks,/turf/simulated/floor/cave_dirt,/area/world/caves/exterior)
"E" = (/obj/structure/scenery/rocks,/turf/simulated/floor/cave_dirt,/area/world/jungle/exterior)
"F" = (/obj/structure/scenery/evergreen,/turf/simulated/floor/colored/dark_grass,/area/world/caves/exterior)
"H" = (/turf/simulated/floor/cave_dirt,/area/world/caves/interior/safe)
"I" = (/obj/structure/scenery/rocks,/turf/simulated/floor/colored/dirt/cave,/area/world/caves/interior/safe)
"J" = (/turf/simulated/floor/colored/dirt/cave,/area/world/caves/interior/safe)
"K" = (/obj/structure/interactive/wishgranter/normal/caves/hidden,/turf/simulated/floor/cave_dirt,/area/world/caves/interior/safe)
"L" = (/turf/simulated/floor/cult,/area/world/caves/exterior)
"M" = (/obj/structure/scenery/grass,/turf/simulated/floor/colored/dark_grass,/area/world/caves/exterior)
"N" = (/turf/simulated/floor/cult,/area/world/caves/interior)
"P" = (/mob/living/simple/npc/slime/cyan,/turf/simulated/floor/cave_dirt,/area/world/caves/interior)
"Q" = (/mob/living/simple/npc/slime/grey,/turf/simulated/floor/cave_dirt,/area/world/caves/interior)
"R" = (/mob/living/simple/npc/slime/red,/turf/simulated/floor/cave_dirt,/area/world/caves/interior)
"T" = (/mob/living/simple/npc/spacecarp/leader,/turf/simulated/floor/river,/area/world/caves/interior)
"U" = (/mob/living/simple/npc/spacecarp,/turf/simulated/floor/river,/area/world/caves/interior)

(1,1,1) = {"
aaaaaaaaaaaaaaaaaaaaaaaaaaaaaaaaaaaaaaooooaaaaaaaaaaaaaaaaaaaaaaaaaaaaaaaaaaaaaaaaaabbbbbaaaaaaaaaaaaaaaaaaaaaaaaaaaaaaaaaaaaaaa
aaaaaaaaaaaaaaaaaaaaaaaaaaaaaaaaaaaaaaooooaaaaaaaaaaaaaaaaaaaaaaaaaaaaaaaaaaaaaaaabbbbbbbCCaaaaaaaaaaaaaaaaaaaaaaaaaaaaaaaaaaaaa
aaaaaaaaaaaaaaaaaaaaaaaaaaaaaaaaaaaaaaoooooaaaaaaaaaaaaaaaaaaaaaaaaaaaaaaaaaaaaaabbbbbbbbbCCaaaaaaaaaaaaaaaaaaaaaaaaaaaaaaaaaaaa
aaaaaaaaaaaaaaaaaaaaaaaaaaaaaaaaaaaaaaoooooaaaaaaaaaaaaaaaaaaaaaaaaaaaaaaaaaaaaaabbbbbbbbbbbCCCaaaaaaaaaaaaaaaaaaaaaaaaaaaaaaaaa
aaaaaaaaaaaaaaaaaaaaaaaaaaaaaaaaaaaaaaooooooaaaaaaaaaaaaaaaaaaaaaaaaaaaaaaaaaaaaabbbbbbbbbbbbbCCCaaaaaaaaaaaaaaaaaaaaaaaaaaaaaaa
aaaaaaaaaaaaaayyyyyyyyyaaaaaaaaaaaaaaaooooooaaaaaaaaaaaaaaaaaaaaaaaaaaaaaaaaaaaaCbbbbbbbbbbbbbbbbCaaaaaaaaaaaaaaaaaaaaaaaaaaaaaa
aaaaaaaaaaaaayyHHHHHHHHHHHHaaaaaaaaaaaooUooUaaaaaaaaaaaaaaaaaaaaaaaaaaaaaaaaaaaaCbbbbbbbbbbbbbbbbCCaaaaaaaaaaaaaaaaaaaaaaaaaaaaa
aaaaaaaaaaaaayHHHHHHHHHHHHHHaaaaaaaaaaaoooooaaaaaaaaaaaaaaaaaaaaaaaaaaaaaaaaaaaaCCCbbbbbbbbbbbbbbbCCaaaaaaaaaaaaaaaaaaaaaaaaaaaa
aaaaaaaaaaabHHHHHHHHHHHHHHHHHHaaaaaaaaaaoUoooaaaaaaaaaaaaaaaaaaaaaaaaaaaaaaaaaaaCCCCbbbbbbbbbbbbbbbbaaaaaaaaaaaaaaaaaaaaaaaaaaaa
aaaaaaaaaaHHHHHHHHHHHHHHHHHHHHHHaaaaaaaaoooooooaaaaaaaaaaaaaaaaaaaaaaaaaaaaaaaaaaCCCCbbbbbbbbbbbbbbbaaaaaaaaaaaaaaaaaaaaaaaaaaaa
aaaaaaaaaaHHHHHHKHHHHHHHHHHHHHHHHaaaaaaaoooToomBnnaaaaaaaaaaaaaaaaaaaaaaaaaaaaaaaaCCCCCCbbbbbbbbbbbbabaaaaaaaaaaaaaaaaaaaaaaaaaa
aaaaaaaaaaHHHHHHHHHHHHHHHHHHHHHHHHaaaaaaoooommmBxnnnaaaaaaaaaaaaaaaaaCCCCaaaaaaaaaaaaCCCCCCCCbbbbbbbbbbaaaaaaaaaaaaaaaaaaaaaaaaa
aaaaaaaaaaaHHHHHHHHHHHHHyyHHHHHHHHHHHHaaaoommmmBMMMnnnaaaaaaaaaaaaaaCCCbCCCaaaaaaaaaaaaaaCCCCCCCCCCbbbbbbaaaaaaaaaaaaaaaaaaaaaaa
aaaaaaaaaaaHHHHHHHHHHHaaayyyaaaaHHHHHIIaammmmmmBxxMMMnnnaaaaaaaaaaaaCCbbbbCCCCaaaaaaaaaaaaaaaaaaaaCCabbbbbaaaaaaaaaaaaaaaaaaaaaa
aaaaaaaaaaaHyHHHHHHHHHaaaaaaaaaaaaaHHJIIammmmmmBxxxxMMMnnnnaaaaaaaaaCbbbbbbbbCCaaaaaaaaaaaaaaaaaaaaaaabbbbbCaaaaaaaaaaaaaaaaaaaa
aaaaaaaaaaaayyyyHHHyyaaaaaaaaaaaaaaaHHJngmmmmmmBBxxxxMMMMMnnnaaaaaaaCbbbbbbbbbbbaaaaaaaaaaaaaaaaaaaaaaabbbbCCaaaaaaaaaaaaaaaaaaa
aaaaaaaaaaaaaaayyyyaaaaaaaaaaaaaaaaaaHJnBgmmmmmmBxxxxxxxMMMMnnnaaaabbbbbbbbbbbbbbaaaaaaaaaaaaaaaaaaaaaaabbbbCaaaaaaaaaaaaaaaaaaa
aaaaaaaaaaaaaaaaaaaaaaaaaaaaaaaaaaaaaaannBxmmmmmBxxxxxxxxxMMMMnnaabbbbbbbbbbbbbbbbaaaaaaaaaabbbbbbbaaaaaabbbCCaaaaaaaaaaaaaaaaaa
aaaaaaaaaaaaaaaaaaaaaaaaaaaaaaaacccccccnnxxmmmmmBBxxxxxxxxxMMMMnabbbbbbbbbbbbbbbbbaaaaaaaaabbbbbbbbbaaaaaabbbCaaaaaaaaaaaaaaaaaa
aaaaaaaaaaaaaaaaaaaaaaaaaaaaaaaacNNNNNcBxxxmmmmmmBxxFxxxxxxxMMMnbbbbbbCCbbbbbbbbbbaaaaaaaabbbbbbbbbCaaaaaaabbCCaaaaaaaaaaaaaaaaa
cccccccccccccccccccccccccccccccccNNNNNcBxxxmmmmmmBxxxxxxxxxxxMMMnnbaaaaCbbbbbbbbbbaaaaaaaabbbbbbbbCCaaaaaaabbbCaaaaaaaaaaaaaaaaa
cNNNNNNNNNNNNNNNNNNNNNNNNNNNNNNNNNNNNNcgxxxmmmmmmBxxxxxxxxxxxxMMMnaaaaaCCCCbbbbbbbabbbbbbbbbbbbbbCCCaaaaaaaCbbCaaaaaaaaaaaaaaaaa
cNcccccccccccccccccccccccccccccccNNNNNcgxxxmmmmmmBxxxxxxxFxxxxxMMnaaaaaaaaCbbbbbbbbbbbbbbbbbbbbCCCaaaaaaaaaCbbCaaaaaaaaaaaaaaaaa
cNcLLLLLLLLLLLLLLLLLLLLLLLLLLLLLcNNNNNcggxMBmmmmmBxxxxxxxxxxxxxMMnaaaaaaaCCbbbbbbbbbbbbbbbbbCCCCaaaaaaaaaaabbbCCaaaaaaaaaaaaaaaa
cNcLMMMLMMMMMMMMMMMLLMMMMMMMMMMLcccNcccggxMBmmmmmBxxxxxxxxxxxxxxMnaaaabbbbbbbbbbbbbaaaaaaCCCCaaaaaaaaaaaaabbbbbCaaaaaaaaaaaaaaaa
cNcLMMMLMMMMMMMMMMMLLMMMMMMMMMMLLLcNcggggxMBmmmmmBxxxxxxxxxxxxxxMnnaaaabbbbbbbbbbbbaaaaaaaaaaaaaaaaCCCCCCbbbbbCCaaaaaaaaaaaaaaaa
cNcLMMMLMMMMMMMMMMMLLMMMMMMMMMMMMLcNcggggMMBmmmmmBxxxxxxxxxxxxxxMMnaaaaabbbbbbbbbbbaaaaaaaaaaaaaaCCCbbbbbbbbbCCaaaaaaaaaaaaaaaaa
cNcLMMMLMMMMMMMMMMMLLMMMMMMMMMMMMLcNcgggxMBBmmmmmBxxFxxxxxxxxxxxMMnaaaaaaabbbbbbbbaaaaaaaaaaaaaaCCCCbbbbbbbCCCaaaaaaCCCCCCCaaaaa
cNcLMMMLMMMMMMMMMMMLLMMMMMMMMMMMMLcNcgggxMBmmmmmmBxxxxxxxxxxxxxxxMnnaaaaaaCCCbbbbbaaaaaaaaaaaaaCCCCbbbbbaaaaaaaaaaaCCCbbbbCCaaaa
cNcLMMMLMMMMMMMMMMMLLMMMMMMMMMMMMLcNcgggMMBmmmmmmBxxxxxxxxxxxxxxMMMnaaaaaaaaCCCCCCaaaaaaaaaaaaCCCCbbbbbaaaaaaaaaaCCCbbbbbbbCCaaa
cNcLMMMLMMMMMMMMMMMLLMMMMMMMMMMMLLcNcggxMBBmmmmmBBxxxxxxxxFxxxxMMMMnnaaaaaaaaaaaaaaaaaaaaaaaaaCCbbbbbaaaaaaaaaaaaCbbbbbbbbbbCCaa
cNcLMMMLMMMMMMMMMMMLLMMMMMMMMMMMLccNccgxMBmmmmmmBxxxxxxxxxxxxxMMMMMMnaaaaaaaaaaaaaaaaaaaaaaaaaaCbbbbaaaaaaaaaaaaCCbbbbbbbbbbbCCa
cNcLLLLLLLLLLLLLLLLLLLLLLLLLLLLLLcNNNcgxMBmmmmmBBxxxxxxxxxxxxMMMMMMnnaaaaaaaaaaaaaaCCCCCaaaaaaaCbbbbaaaaaaaaaaaaCbbbbbbbbbbbbbbb
cNcccccLMMMMMMMMMMMLLMMMMMMMMMMMLcNNNcgxMBmmmmmBxxxxxxxxxxxxMMMMMMnnCaaaaaaaaaaaaCCCCCCCCCCbbbbbbbbbaaaaaaaaaaaDCbbbbbbbbbbbbbbb
cNcNNNcLMMMMMMMMMMMLLMMMMMMMMMMMLNNNNcgxMBmmmmmBxxxxxxxxxxxxMMMnnnnCCCCaaaaaaaaaaCbCCCCbbbbbbbbbbbbbaaaaaaaaallDtbbbbbbbbbbbbbbb
NNNNNNcLMMMMMMMMMMMLLMMMMMMMMMMMLcNNNcxxMBmmmmmBxxxFxxxxxxxMMMMnnbbbbCCCCCCCCCCCaaCCbbbbbbbbbbbbbbbbbaaaaaalllJJttbbbbbbbbbbbbba
NNNNNNcLMMMMMMMMMMMLLMMMMMMMMMMMLcNNNcxMMBmmmmmBxxxxxxxxxxxMMMMnbbbbbbbbbbbbbbbbbbbbbbbbbbbbbbbbbbbbbbaaaallJJJJJJtbbbbbbbbbbbaa
NNNNNNcLMMMMMMMMMMMLLMMMMMMMMMMMLccNccMMBBmmmmBBxxxxxxxxxxxxMMMntbbbbbbbbbbbbbbbbbbbbbbbbbaaaaaabbbbbblllllJJJrrrJJtbbbbbbbbbaaa
NNNNNNNLLLLLLLLLLLLLLLLLLLLLLLLLLLLLLLLssssssssxxxxxxxxxxxxxxMMnnbbbbbbbbbbbbbbbbbbbbbbbbaaaaaaaaabbbJJJllJJJrrrrrJJtbbbbbbbaaaa
NNNNNNNLLLLLLLLLLLLLLLLLLLLLLLLLLLLLLLLssssssssxxxxxxxxxxxxxxxMMnbbbbbbbbbbbbbbbbbbbbbbbbaaaaaaaaaabJJJlJJJJrrrrrrrJJttbbbbaaaaa
NNNNNNcLMMMMMMMMMMMLLMMMMMMMMMMMLccNccBBmmmmmmBxxxxxxxxxxxxxxxxxntbbbbbbbbbbbbCCaaabbbbbbaaaaaaaaaalJJJJJJrrrrvvvvrrJJttbbaaaaaa
NNNNNNcLMMMMMMMMMMMLLMMMMMMMMMMMLcNNNcBmmmmmmBBxxxxxxxxxxxxxxxxxnnbbbbbbbbbbbbCaaaabbbbbbaaaaaaaaaalJJJJJrrrrzvvvvrrrJJttaaaaaaa
NNNNNNcLMMMMMMMMMMMLLMMMMMMMMMMMLcNNNcBmmmmmmBMxxFxxxxxxxxxxxxxxxnnbbbCCCbbbbCCaaaaabbbbbbaaaaaaaallJJJJrrrvvvvvvvrrrrJJlaaaaaaa
cNcNNNcLMMMMMMMMMMMLLMMMMMMMMMMMLNNNNcBmmmmmBBMxxxxxxxxxxxxxxxxxxxnnbaaCCCCCCCaaaaaaabbbbbbaaaaaaalJJJJrrrvvvvvvvvrrrrrJllaaaaaa
cNcccccLMMMMMMMMMMMLLMMMMMMMMMMMLcNNNcBmmmmmBMMxxxxxxxxxxxxFxxxxxxMnnaaaaaaaaaaaaaaaabbbbbbbbbCCaalJJrrrrvvvvvvvvvrrrrrrJlaaaaaa
cNcLLLLLLLLLLLLLLLLLLLLLLLLLLLLLLcNNNcBmmmmmBMMxxxxxxxxxxxxxxxxxxMMnaaaaaaaaaaaaaaaaaabbbbbbbbbCCalJrrrrvvvvvvAvvvrrrrrJJlaaaaaa
cNcLMMMLMMMMMMMMMMMLLMMMMMMMMMMMLccNccBmmmmmBBMxxxxxxxxxxxxxxxxxMMMnaaaaaaaaaaaaaaaaaaabbbbbbbbbCalJrrrrvzvvvvvvvrrrrrJJJlaaaaaa
cNcLMMMLMMMMMMMMMMMLLMMMMMMMMMMMLLcNcBBmmmmmmBMMxxxxxxxxxxxxxxMMMMnnaaaaaaaaaaaaaaaaaaaaabbbbbbbCalJrrrrrvvvvvvrrrrrrrJJllaaaaaa
cNcLMMMLMMMMMMMMMMMLLMMMMMMMMMMMMLcNcBmmmmmmmBBMxxxxxxxxxxxxMMMMMnnaaaaaaaaaaaaaaaaaaaaaabbbbbbbCalJJrrrrvvvvrrrrrrrrrrJllaaaaaa
cNcLMMMLMMMMMMMMMMMLLMMMMMMMMMMMMLcNcBmmmmmmmmBMxxxFxxxxxMMMMMMnnnaaaaaaaaaaaaaaaaaaaaaaabbbbbbbCallJJrrrrvvrrrrrrrrrrrJllaaaaaa
cNcLMMMLMMMMMMMMMMMLLMMMMMMMMMMMMLcNcBmmmmmmmmBMxxxxxxxMMMMMMnnnaaaaaaaaaaaaaaaaaaaaaaaaaabbbbbbCaalJJJrrrrrrrrrrrrrrrrJlaaaaaaa
cNcLMMMLMMMMMMMMMMMLLMMMMMMMMMMMMLcNcBmmmmmmmmBMxxxxxxMMMMMnnnaaaaaaaaaaaaaaaaaaaaaaaaaaaaabbbbCCaalJJJJrrrrrrrrrrrrrrJJlaaaaaaa
cNcLMMMLMMMMMMMMMMMLLMMMMMMMMMMLLLcNcBmmmmmmmmBMxxMMMMMnnnnnaaaaaaaaaaaaaaaaaaaaaaaaaaaCCCabbbCCaaalJJJJJrrrrrrrrrrrrJJllaaaaaaa
cNcLMMMLMMMMMMMMMMMLLMMMMMMMMMMLcccNcccooooommBMMMMMMnnnaaaaaaaaaaaaaaaaaaaaaaaaaaaaCCCCbbbbbbaaaaffJJJJJJJrrrrrrrJJJJllaaaaaaaa
cNcLLLLLLLLLLLLLLLLLLLLLLLLLLLLLcNNNNNcooooommBMMMnnnnaaaaaaaaaaaaaaaaaaaaaaaaaaaaaCCbbbbbbbbbaaaffffJJJJJJrrrrJJJJJlllaaaaaaaaa
cNcccccccccccccccccccccccccccccccNNNNNcaooooomBnnnnaaaaaaaaaaaaaaaaaaaaaaaaaaaaaaaCCbbbbbbbbbbaaffffflllllJJrrJJJbCllaaaaaaaaaaa
cNNNNNNNNNNNNNNNNNNNNNNNNNNNNNNNNNNNNNcaooooomaaaaaaaaaaaaaaaaaaaaaaaaaaaaaaaaaaaCCbbbbbbbbbbbbffffaaaaaaaaJJJJbbbCaaaaaaaaaaaaa
cccccccccccccccccccccccccccccccccNNNNNcaoooooaaaaaaaaaaaaaaaaaaaaaaaaaaaaaaaaaaaCCbbbabbbbbbbbbbfaaaaaaaaaaaaabbbbCCaaaaaaaaaaaa
aaaaaaaaaaaaaaaaaaaaaaaaaaaaaaaacNNNNNcaoooooaaaaaaaaaaaaaaaaaaaaaaaaaaaaaaaaaaaCbbaaaabbbbbbbbbbaaaCCCCaaaaaCbbbbbCCaaaaaCCCaaa
aaaaaaaaaaaaaaaaaaaaaaaaaaaaaaaacccccccaoooooaaaaaaaaaaaaaaaaaaaaaaaaaaaaaaaaaaCCbbaaaabbbbbCCCbbbaaCCbCCCCCCCbbbbbbCCCCCCCbCCaa
aaaaaaaaaaaaaaaaaaaaaaaaaaaaaaaaaaaaaaaaoooooaaaaaaaaaaaaaaaaaaaaaaaaaaaaaaaaaCCbbbaaaaaCbbCCaabbbbbbbbbbbbbbbbbbbbbbbbbbbbbbCCa
aaaawwwwwwwwwwwwwwwwwwwwwaaaaaaaaaaaaaaooooooaaaaaaaaaaaaaaaaaaaaaaaaaaaaaaaaaCbbbbbaaaCCbCCaaaabbbbbbbbbbbbbbbbbbbbbbbbbbbbbbbb
aaaawuuuuuuuuuuuuuuuuuuuwaaaaaaaaaaaaaoooooooaaaaaaaaaaaaaaaaaaaaaaaaaaaaaaaaaCbbbbbaaCCbbCaaaabbbbbbbbbbbbbbbbbbbbbbbbbbbbbbbbb
aaaawuuuuuuuuuuuuuuuuuuuwaaaaaaaaaaaaaoooooooaaaaaaaaaaaaaaaaaaaaaaaaaaaaaaaaabbbbbbbCCbbbCCaabbbCCbbbbbbbbbbbbbbbbbbbbbbbbbbbbb
aaaawuuwwwwuuuuuuuwwwwuuwaaaaaaaaaaaaooooooooaaaaaaaaaaaaCCCCCaaaaaaaaaaaaaaaabbbbbbbbCCCbbbbbbbCCaahhihhhhhhhhhihhaaaCCbbbbbCCa
aaaawuuwaawuuuuuuuwaawuuwwwwwwwaaaaaaoooooooooaaaaaaaaaaCCCCCCCaaaaaaaaaaaaaaabbbbbbbCCaCCbbbbbCCaaahiiiiiiiiiiiiihaaaaCCCCCCCaa
aaaawuuwaawuuuuuuuwaawuuuuuuuuwaaaaaaaooooooooaaaaaaaaaCCCCCCCCCaaaaaaaaaaaaaabbbbbbbaaaaCbbbbCCaaaahiiiiiiiiiiiiihaaaaaaaaaaaaa
aaaawuuwwwwuuuuuuuwwwwuuuuuuuuwaaaaaaaoooooooooaaaaaaaaaCCCCCCCCCCaaaaaaaaaaabbbbbbbaaaaaCbbbCCaaaaahiiiiiiiiiiiiihaaaaaaaaaaaaa
aaaawuuuuuuuuuuuuuuuuuuuwwwwwwwaaaaaaaoooooooooaaaaaaaaaaCCCCCCbbaaaaaaaaabbbbbbbbbbbaaabbbbbCaaaaaahiiiiiiiiiiiiihaaaaaaaaaaaaa
aaaawuuuuuuuuuuuuuuuuuuuwaaaaaaaaaaaaaooooooooooaaaaaaaaaCaCbbbbbbbaaaaabbbbbbbbbbbbbbabbbbbCCaaaaaahiiiiiiiiiiiiihaaaaaaaaaaaaa
aaaawwwwwwwwwwuuwwwwwwuuwaawwwwaaaaaaaaaooooooooaaaaaaaaaaCCaabbbbbbbbbbbbbbbbbbbbbbbbbbbbbbCaaaaaaahhhhhhhhhhhhhhhaaaaaaaaaaaaa
aawwwwwwwwwwwwuuwaaaawuuwaawuuwaaaaaaaaaooooooooaaaaaaaaaaaCCCbbbbbbbbbbbbbbbbCCaabbbbbbbbbbaaaaaaaaaaaaaaaaaaaaaaaaaaaaaaaaaaaa
aawuuuuuuuuuuuuuwaaaawuuwaawuuwaaawwwwaaaooooooooaaaaaaaaaaaaabbbbbbbbbbbbbbCCCaaaaabbbbbbbbaaaaaaaaaaaaaaaaaaaaaaaaaaaaaaaaaaaa
aawuuuuuuuuuuuuuwaaaawuuwaawuuwaaawuuwaaaaoooooooooaaaaaaaaaaaaaCCCobbbbbCCCCaaaaaaaaaCCCbbbaaaaaaaaaaaaaaaaaaaaaaaaaaaaaaaaaaaa
aawuuwwwwwwwwwuuwaaaawuuwaawuuwaaawuuwaaaaaooooooooooaaaaaaaaaooooooooddoooaaaaaaaaaaaaaCbbbaaaaaaaaaaCCCaaaaaaaaaaaaaaaaaaaaaaa
aawuuwaawwwwwwuuwwwwwwuuwwwwuuwwwwwuuwaaaaaoooooooooooaaaaaaaoooooooooddooooaaaaaaaaaaaaCbbbaaaaaaaaaCCbCCCaaaaaaaaaaaaaaaaaaaaa
aawuuwaawuuuuuuuuuuuuuuuuuuuuuuuuuuuuwaaaaaaooooooooooooooaaooooooooooddooooaaaaaaaaaaaaCbbbbaaaaaaaCCbbbbCCaaaaaaaaaaaaaaaaaaaa
aawuuwaawuuuuuuuuuuuuuuuuuuuuuuuuuuuuwaaaaaaooooooooooooooooooooooooooddooooaaaaaaaaaaaaCbbbbaaaaaabCbbbbbbbbaaaaaaaaaaaaaaaaaaa
aawwwwaawuuwwwwwwwwwuuwwwwwwwwwwwwwwwwaaaaaaaoooooooooooooooooooooooooddoooooaaaaaaaaaaaabbbbbaaabbbbbCCCCbbbbaaaaaaaaaaaaaaaaaa
aaaaaaaawuuwaaaaaaawuuwaaaaaaaaaaaaaaaaaaaaaaaaaooooooooooooooooooooooddoooooaaaaaaaaaaaabbbbbbbbbbbbCCaaCCbbbbaaaaaaaaaaaaaaaaa
aaaaaaaawuuwaaaaaaawuuwaaaaaaaaaaaaaaaaaaaaaaaaaaaooooooooooooooddddddddooooooaaaaaaaaaaaabbbbbbbbbbbaaaaaabbbbCaaaaaaaaaaaaaaaa
aaaaaaaawuuwaaaaaaawuuwaaawwwwwwwwwwwwwwwwwaaaaaaaaaooooooooooooddddddddooooooaaaaaaaaaaaaabbbbbbCCaaaaaaaaabbbCCaaaaaaaaaaaaaaa
aaaaaaaawuuwaaaaaaawuuwaaawuuuuuuuuwwuuuuuwaaaaaaaaaaaaaaoooooooddoooooooooooooaaaaaaaaaaaaaCCCbCCaaaaaaaaaaCCbbCaaaaaaaaaaaaaaa
aaaaaaaawuuwaawwwwwwuuwaaawuuuuuuuuwwuuuuuwaaaaaaaaaaaaaaaooooooddoooooooooooooaaaaaaaaaaaaaaaCCCaaaaaaaaaaaaCbbCaaaaaaaaaaaaaaa
aaaaaaaawuuwaawuuuuuuuwaaawwwwwwwuuwwwwwuuwaaaaaaaaaaaaaaaaoooooddooooooooooooooaaaaaaaaaCCCCaaaaaaaaaaaaaaaaCbbCCaaaaaaaaaaaaaa
aaaaaaaawuuwaawuuuuuuuwaaaaaaaaawuuwaaawuuwaaaaaaaaaaaaaaaaaooooddooooooooooooooaaaaaaaaCCbbbbaaaaabbaaaaaaaaCbbbCaaaaaaaaaaaaaa
aaaaaaaawwwwaawuuwwwuuwaaaaaaaaawuuwaaawuuwaaaaaaaaaaaaaaaaaaoooddddddoooooooooooaaaaaaCCbbbbbbbbbbbbbaaaaaCCCbbbCaaaaaaaaaaaaaa
aaaaaaaaaaaaaawuuwawuuwwwwwwwwwwwuuwwwwwuuwaaaaaaaaaaaaaaaaaaoooddddddooooooooooooaaaaaCbbbbbbbbbbbbbbbbabbCCCbbbCaaaaaaaaaaaaaa
aaaaaaaaaaaaaawuuwawuuuuuuuuuuuuuuuuuuuuuuwaaaaaaaaaaaaaaaaaaoooooooddooooooooooooaaaaCCbbbbbbbbbbbbbbbbbbCCCCCbbCaaaaaaaaaaaaaa
aaaaaaaaaaaaaawuuwawuuuuuuuuuuuuuuuuuuuuuuwaaeeeeeeeHHHHaaaaaaooooooddoooooooooooooaaaCbbbbbbbbbaaaaaabbbbCCCCCbbCaaaaaaaaaaaaaa
aaaaaaaawwwwwwwuuwawuuwwwwwwuuwwwwwwuuwwwwweeejjjjjHHHHHHaaaaaooooooddooooooToooooooaaCbbbbbbbbaaaaaaaaabbbCCCCbbCaaaaaaaaaaaaaa
aaaaaaaawuuuuuuuuwawuuwaaaawuuwaaaawuuwaaaeejjjjjjHHHHHHHHaaaaaoooooddoooooooooUoooooaabbbbbbaaaaaaaaaaaaCbbCCbbbCaaaaaaaaaaaaaa
aaaaaaaawuuuuuuuuwawuuwaaaawwwwaaaawuuwaaaejjjjjjHHHHHHHHHHaaaaoooooddoooooooooooooooaabbbbbbaaaaaaaaaaaaCbbbbbbbCaaaaaaaaaaaaaa
aaaaaaaawwwwwwwuuwawuuwaaaaaaaawwwwwuuwaawejjjjjjHHHHHHHHHHHaaooooooddoooooooUooooooooaabbbbbaaaaaaaaaaaaCCbbbbbbCaaaaaaaaaaaaaa
aaaaaaaaaaaaaawuuwawuuwaaaaaaaawuuuuuuwaaejjjjjjHHHHHHHHHHHHHHooooooddoooooooooooooooooaaabbbbbbaaaaaaaaaCCbbbbbbCaaaaaaaaaaaaaa
aaaawwwwwwwwwwwuuwawuuwaaaaaaaawuuuuuuwaeejjjjjjHHHHHHHHHHHHHHHdddddddoooooooooooUoooooaaaaCCbbbbbaaaaaaaCCCbbbbbCaaaaaaaaaaaaaa
aaaawuuuuuuuuuuuuwawuuwwwwwwwwwwuuwwwwwaejjjjjjHHHHHHHHHHHHHHHHdddddddoooooooooooooooooaaaaaCCCbbbbbaaaaaCCCbbbbbaaaaaaaaaaaaaaa
aaaawuuuuuuuuuuuuwawuuuuuuuuuuuuuuwaaaaaejjjjjjjHHHHHHHHHHHHHHHddoooooooooooooooooooooooaaaaaaCbbbbbbaaaaCCbbbbbbaaaaaaaaaaaaaaa
aaaawuuwwwwuuwwwwwawuuuuuuuuuuuuuuwaaaaeejjjjjjjHHkHHHHHHHHHHHHddoooooooooooooooooooooooaaaaaaaCCbbbbbbaaCbbbbbbaaaaaaaaaaaaaaaa
aaaawuuwaawuuwaaaaawuuwwwwuuwwwwuuwwwwwejjjjjjjjHHHHHHHHHHHHHHHddooooooooooooooooooooooooaaaaaaaabbbbbbbbbbbbbbaaaaaaaaaaaaaaaaa
aaaawuuwaawuuwaaaaawuuwaawuuwaawuuuuuuujjjjjjjjjHHHHHHHHHHHHHHHddooooooooooooooooooooooooaaaaaaaaaabbbbbbbbbbbaaaaaaaaaaaaaaaaaa
aaaawuuwaawuuwwwwwwwuuwaawuuwaawuuuuuuujjjjjjjjjHHHHHHHHHHHHHaaaaooooooooooooooooooooooooaaaaaaaaaabbbbbbbbbbaaaaaaaaaaaaaaaaaaa
aaaawuuwaawuuuuuuuuuuuwaawuuwaawwwwwwwweejjjjjjjHHHHHHHHHHHHaaaaaaoooooooooooooooooooooooaaaaaaaaaabbbbbbbbaaaaaaaaaaaaaaaaaaaaa
aaaawuuwaawuuuuuuuuuuuwaawuuwwwwwwwwwwwleejjjjjjjHHHHHHHHHHaaaaaaaoooooooooooooooooooooooaaaaaaaaCCbbbbbaaaaaaaaaaaaaaaaaaaaaaaa
aaaawuuwaawwwwwwwwwwwwwaawuuuuuuuuuuuuwaaeejjjjjjHHHHHHHHaaaaaaaaaoooooooooooooooooooooooaaaaaaCCCbbbbaaaaaaaaaaaaaaaaaaaaaaaaaa
aaaawuuwaaaaaaaaaaaaaaaaawuuuuuuuuuuuuwaaaeeejjjjHHHHHHaaaaaaaaaaooooooooooooooooooooooooaaaaaCCbbbbbbaaaaaaaaaaaaaaaaaaaaaaaaaa
aaaawuuwwwwwwwaaaaaaaaaaawuuwwwwwwwwuuwaaaaaeeejjjHHHHHaaaaaaaaaoooooooooooooooooooooooooaaaaCCbbbbbbaaaaaaaaaaaaaaaaaaaaaaaaaaa
aaaawuuuuuuuuwaaawwwwwwwwwuuwwwwwaawuuwaaaaaaaeeeeeHaaaaaaaaaaaaoooooooooooooooooooooooooaaaaCbbbbbaaaaaaaaaaaaaaaaaaaaaaaaaaaaa
aaaawuuuuuuuuwaaawuuuuuuuuuuuuuuwaawuuwaaaaaaaaaaaaaaaaaaaaaaaaaooooooooooooooooooooooooaaaaaCbbbbbbaaaaaaaaaaaaaaabbaaaaaaaaaaa
aaaawwwwuuwwwwaaawuuuuuuuuuuuuuuwaawuuwaaaaaaaaaaaaaaaaaaaaaaaaaooooooooooooooooooooooooaaaaaCbbbbbbbaaaaaaaaaaaabbbbbbbbbbaaaaa
aaaaaaawuuwaawwwwwuuwwwwwwwwwwuuwaawuuwwwwwwwwwwwaaaaaaaaaaaaaaaoooooooooooooooooooooooaaaaaCCbbbbbbbaaaaaaaabbbbbbbbbbbbbbbaaaa
aaaaaaawuuwaawuuuuuuwaaaaaaaawuuwaawuuuuuuuuuuuuwaaaaawwwwwwwwwwaooooooooooooooooooooooaaaaCCbbbbbbbbbaaabbbbbbbRbbRbaaabbbbbaaa
aaaaaaawuuwaawuuuuuuwaaaaaaaawuuwaawuuuuuuuuuuuuwaaaaawuuuuuuuuwaooooooooooooooooooooooaaaaCbbbbbbbbbbbbbbbbbbbbbbbbbaaaaabbbbaa
aaaaaaawuuwwwwwwwwwwwwwwaaaaawuuwaawwwwwwwwwwwwwwaaaaawuuuuuuuuwaaoooooooooooooooooooooaaaCCbbbbbbbbbbbbbbbbbbbbbbbbbbaaaaabbbba
aaaaaaawuuuuuuuuuuuuuuuwaaaaawuuwaaaaaaaaaaaaaaaaawwwwwuuuuuuuuwaaooooooooooooooooooooooaCCbbbbbbbbbbbbbbaaaaabbbRbbbbbaaabbbbba
aaaaaaawuuuuuuuuuuuuuuuwaaaaawuuwaaaaaaaaaaaaaaaaawuuuuuuuuuuuuwaaaooooooooooooooooooooobbbbbbbbbbbbbbCaaaaaaabbbbbbbbbbbbbbbbba
aaaaaaawwwwwwwwwwwwwwuuwawwwwwuuwwwwwwwwwwwwaaaaaawuuuuuuuuuuuuwaaaooooooooooooooooooooobbbbbbbbbbbbbbCaaaaabbbbaabbbbbbbbQbbbaa
aaaaaaaaaaaaaaaaaaaawuuwawuuuuuuuuuuuuuuuuuwaaaaaawuuwwuuuuuuuuwaaaaoooooooooooooooooooobbbbbbbbbbbbbbCaaaabbbbbaaaabbbbbbbbbaaa
aaaaaaaaaaaaaaaaaaaawuuwawuuuuuuuuuuuuuuuuuwaaaaaawuuwwuuuuuuuuwaaaaoooooooooooooooooooobbbbbbbbbbbbbbCaaaabbbbbaaaaabbQbbQbaaaa
aaaaaaawwwwwwwwwwwwwwuuwawwwwwwwwwwuuwwwwuuwaaaaaawuuwwuuuuuuuuwaaaaaooooooooooooooooooobbbbbbbbbbbbbCCaaaaabbbbbbaaabbbbbbaaaaa
aaaaaaawuuuuuuuuuuuuuuuwaaaaaaaaaawuuwaawuuwaaaaaawuuwwwwwwwwwwwaaaaaoooooooooooooooooooobbbbbbbbbbbbCaaaaaabbbbbbbbbbbbbaaaaaaa
aaaaaaawuuuuuuuuuuuuuuuwaaaaaaaaaawuuwaawuuwwwwwwwwuuwaaaaaaaaaaaaaaaaooooooooooooooooooobbbbbbppbbbCCaaaaabbbbbbbbbbbbbaaaaaaaa
aaaaaaawwwwwwwuuwwwwwwwwaaaaaaaaaawuuwaawuuuuuuuuuuuuwaaaaaaaaaaaaaaaaaooooooooooooooooooobbbbppppbbCaaaaabPbbPbbbbbbbbaaaaaaaaa
aaaaaaaaaaaaawuuwaaaaaaaaaaaaaaaaawuuwaawuuuuuuuuuuuuwaaaaaaaaaaaaaaaaaaoooooooooooooooooobbbppppppCCaaaaabbbbbbbbbbbaaaaaaaaaaa
aaaaaaaaaaaaawuuwaaaaaaaaaaaaaaaaawwwwaawwwwwwwwwwwwwwaaaaaaaaaaaaaaaaaaaooooooooooqqqqqqqqppppppppEaaaaaaabPbbaaaaaaaaaaaaaaaaa
aaaaaaaaaaaaawwwwaaaaaaaaaaaaaaaaaaaaaaaaaaaaaaaaaaaaaaaaaaaaaaaaaaaaaaaaaoooooqqqqqqqqqqqqqpppppppaaaaaaaaabbaaaaaaaaaaaaaaaaaa
aaaaaaaaaaaaaaaaaaaaaaaaaaaaaaaaaaaaaaaaaaaaaaaaaaaaaaaaaaaaaaaaaaaaaaaaaaaooqqqqqqqqqqqqqqqqppppppaaaaaaaaaaaaaaaaaaaaaaaaaaaaa
aaaaaaaaaaaaaaaaaaaaaaaaaaaaaaaaaaaaaaaaaaaaaaaaaaaaaaaaaaaaaaaaaaaaaaaaaaaaqqqqqqqqqqqqqqqqqqpppppaaaaaaaaaaaaaaaaaaaaaaaaaaaaa
"}
