"a" = (/turf/simulated/wall/rock,/area/world/caves/cave)
"b" = (/turf/simulated/floor/cave_dirt,/area/world/caves/cave)
"c" = (/turf/simulated/wall/cult,/area/world/caves/cave)
"d" = (/turf/simulated/floor/cult,/area/world/caves/cave)
"e" = (/turf/simulated/floor/stair/cult{icon_state = "stair"; dir = 8},/area/world/caves/cave)
"f" = (/turf/simulated/floor/colored/dirt/cave,/area/world/caves/cave)
"g" = (/turf/simulated/wall/rock,/area/world/caves/exterior)
"h" = (/turf/simulated/wall/wood/brown,/area/world/caves/cave)
"i" = (/turf/simulated/floor/wood/brown,/area/world/caves/cave)
"j" = (/turf,/area)
"k" = (/turf/simulated/floor/colored/dirt/cave,/area/world/caves/exterior)
"l" = (/turf/simulated/floor/cave_dirt,/area/world/caves/exterior)
"m" = (/turf/simulated/wall/rock,/area)
"n" = (/turf/simulated/wall/river,/area)
"o" = (/turf/simulated/wall/river,/area/world/caves/cave)
"p" = (/turf/simulated/floor/cave_dirt,/area/world/jungle/exterior)
"q" = (/turf/simulated/wall/river,/area/world/jungle/exterior)
"r" = (/turf/simulated/floor/colored/grass,/area/world/caves/exterior)

(1,1,1) = {"
jjjjjjjjjjjjjjjjjjjjjjjjjjjjjjjjjjjjjjjjjjjjjjjjjjjjjjjjjjjjjjjjjjjjjjjjjjjjaaaaaaaabbbbbaaaaaaaaaaaaaaaaaaaaaaaaaaaaaaaaaaaaaaa
jjjjjjjjjjjjjjjjjjjjjjjjjjjjjjjjjjjjjjjjjjjjjjjjjjjjjjjjjjjjjjjjjjjjjjjjjjjjaaaaaabbbbbbbbbaaaaaaaaaaaaaaaaaaaaaaaaaaaaaaaaaaaaa
jjjjjjjjjjjjjjjjjjjjjjjjjjjjjjjjjjjjjjjjjjjjjjjjjjjjjjjjjjjjjjjjjjjjjjjjjjjjaaaaabbbbbbbbbbbaaaaaaaaaaaaaaaaaaaaaaaaaaaaaaaaaaaa
jjjjjjjjjjjjjjjjjjjjjjjjjjjjjjjjjjjjjjjjjjjjjjjjjjjjjjjjjjjjjjjjjjjjjjjjjjjjaaaaabbbbbbbbbbbbbbaaaaaaaaaaaaaaaaaaaaaaaaaaaaaaaaa
jjjjjjjjjjjjjjjjjjjjjjjjjjjjjjjjjjjjjjjjjjjjjjjjjjjjjjjjjjjjjjjjjjjjjjjjjjjjaaaaabbbbbbbbbbbbbbbbaaaaaaaaaaaaaaaaaaaaaaaaaaaaaaa
jjjjjjjjjjjjjjjjjjjjjjjjjjjjjjjjjjjjjjjjjjjjjjjjjjjjjjjjjjjjjjjjjjjjjjjjjjjjaaaabbbbbbbbbbbbbbbbbbaaaaaaaaaaaaaaaaaaaaaaaaaaaaaa
jjjjjjjjjjjjjjjjjjjjjjjjjjjjjjjjjjjjjjjjjjjjjjjjjjjjjjjjjjjjjjjjjjjjjjjjjjjjaaaabbbbbbbbbbbbbbbbbbbaaaaaaaaaaaaaaaaaaaaaaaaaaaaa
jjjjjjjjjjjjjjjjjjjjjjjjjjjjjjjjjjjjjjjjjjjjjjjjjjjjjjjjjjjjjjjjjjjjjjjjjjjjaaaabbbbbbbbbbbbbbbbbbbbaaaaaaaaaaaaaaaaaaaaaaaaaaaa
jjjjjjjjjjjjjjjjjjjjjjjjjjjjjjjjjjjjjjjjjjjjjjjjjjjjjjjjjjjjjjjjjjjjjjjjjjjjaaaabbbbbbbbbbbbbbbbbbbbaaaaaaaaaaaaaaaaaaaaaaaaaaaa
jjjjjjjjjjjjjjjjjjjjjjjjjjjjjjjjjjjjjjjjjjjjjjjjjjjjjjjjjjjjjjjjjjjjjjjjjjjjaaaaabbbbbbbbbbbbbbbbbbbaaaaaaaaaaaaaaaaaaaaaaaaaaaa
jjjjjjjjjjjjjjjjjjjjjjjjjjjjjjjjjjjjjjjjjjjjjjjjjjjjjjjjjjjjjjjjjjjjjjjjjjjjaaaaaabbbbbbbbbbbbbbbbbbabaaaaaaaaaaaaaaaaaaaaaaaaaa
jjjjjjjjjjjjjjjjjjjjjjjjjjjjjjjjjjjjjjjjjjjjjjjjjjjjjjjjjjjjjjjjjjjjjjjjjjjjaaaaaaaaabbbbbbbbbbbbbbbbbbaaaaaaaaaaaaaaaaaaaaaaaaa
jjjjjjjjjjjjjjjjjjjjjjjjjjjjjjjjjjjjjjjjjjjjjjjjjjjjjjjjjjjjjjjjjjjjjjjjjjjjaaaaaaaaaaaaabbbbbbbbbbbbbbbbaaaaaaaaaaaaaaaaaaaaaaa
jjjjjjjjjjjjjjjjjjjjjjjjjjjjjjjjjjjjjjjjjjjjjjjjjjjjjjjjjjjjjjjjjjjjjjjjjjjjaaaaaaaaaaaaaaaaaaaaaabbabbbbbaaaaaaaaaaaaaaaaaaaaaa
jjjjjjjjjjjjjjjjjjjjjjjjjjjjjjjjjjjjjjjjjjjjjjjjjjjjjjjjjjjjjjjjjjjjjjjjjjjjaaaaaaaaaaaaaaaaaaaaaaaaaabbbbbbaaaaaaaaaaaaaaaaaaaa
jjjjjjjjjjjjjjjjjjjjjjjjjjjjjjjjjjjjjjjjjjjjjjjjjjjjjjjjjjjjjjjjjjjjjjjjjjjjaaaaaaaaaaaaaaaaaaaaaaaaaaabbbbbbaaaaaaaaaaaaaaaaaaa
jjjjjjjjjjjjjjjjjjjjjjjjjjjjjjjjjjjjjjjjjjjjjjjjjjjjjjjjjjjjjjjjjjjjjjjjjjjjaaaaaaaaaaaaaaaaaaaaaaaaaaaabbbbbaaaaaaaaaaaaaaaaaaa
jjjjjjjjjjjjjjjjjjjjjjjjjjjjjjjjjjjjjjjjjjjjjjjjjjjjjjjjjjjjjjjjjjjjjjjjjjjjaaaaaaaaaaaaaaaaaaaaaaaaaaaaabbbbbaaaaaaaaaaaaaaaaaa
jjjjjjjjjjjjjjjjjjjjjjjjjjjjjjjjjjjjjjjjjjjjjjjjjjjjjjjjjjjjjjjjjjjjjjjjjjjjaaaaaaaaaaaaaaaaaaaaaaaaaaaaaabbbbaaaaaaaaaaaaaaaaaa
jjjjjjjjjjjjjjjjjjjjjjjjjjjjjjjjjjjjjjjjjjjjjjjjjjjjjjjjjjjjjjjjjjjjjjjjjjjjaaaaaaaaaaaaaaaaaaaaaaaaaaaaaaabbbbaaaaaaaaaaaaaaaaa
jjjjjjjjjjjjjjjjjjjjjjjjjjjjjjjjjjjjjjjjjjjjjjjjjjjjjjjjjjjjjjjjjjjjjjjjjjjjaaaaaaaaaaaaaaaaaaaaaaaaaaaaaaabbbbaaaaaaaaaaaaaaaaa
jjjjjjjjjjjjjjjjjjjjjjjjjjjjjjjjjjjjjjjjjjjjjjjjjjjjjjjjjjjjjjjjjjjjjjjjjjjjaaaaaaaaaaaaaaaaaaaaaaaaaaaaaaabbbbaaaaaaaaaaaaaaaaa
jjjjjjjjjjjjjjjjjjjjjjjjjjjjjjjjjjjjjjjjjjjjjjjjjjjjjjjjjjjjjjjjjjjjjjjjjjjjaaaaaaaaaaaaaaaaaaaaaaaaaaaaaaabbbbaaaaaaaaaaaaaaaaa
jjjjjjjjjjjjjjjjjjjjjjjjjjjjjjjjjjjjjjjjjjjjjjjjjjjjjjjjjjjjjjjjjjjjjjjjjjjjaaaaaaaaaaaaaaaaaaaaaaaaaaaaaaabbbbbaaaaaaaaaaaaaaaa
jjjjjjjjjjjjjjjjjjjjjjjjjjjjjjjjjjjjjjjjjjjjjjjjjjjjjjjjjjjjjjjjjjjjjjjjjjjjaaaaaaaaaaaaaaaaaaaaaaaaaaaaaabbbbbbaaaaaaaaaaaaaaaa
jjjjjjjjjjjjjjjjjjjjjjjjjjjjjjjjjjjjjjjjjjjjjjjjjjjjjjjjjjjjjjjjjjjjjjjjjjjjaaaaaaaaaaaaaaaaaaaaaaabbbbbbbbbbbbbaaaaaaaaaaaaaaaa
jjjjjjjjjjjjjjjjjjjjjjjjjjccccccccccccaaaaaaaaaaaaaaaaaaaaaaaaaaaaaaaaaaaaaaaaaaaaaaaaaaaaaaaaaaabbbbbbbbbbbbbbaaaaaaaaaaaaaaaaa
jjjjjjjjjjjjjjjjjjjjjjjjjjccccccccccccaaaaaaaaaaaaaaaaaaaaaaaaaaaaaaaaaaaaaaaaaaaaaaaaaaaaaaaaaabbbbbbbbbbbbbbaaaaaabbbbbbbaaaaa
jjjjjjjjjjjjjjjjjjjjjjjjjjccddddddddccaaaaaaaaaaaaaaaaaaaaaaaaaaaaaaaaaaaaaaaaaaaaaaaaaaaaaaaaabbbbbbbbbaaaaaaaaaaabbbbbbbbbaaaa
jjjjjjjjjjjjjjjjjjjjjjjjjjccddddddddccaaaaaaaaaaaaaaaaaaaaaaaaaaaaaaaaaaaaaaaaaaaaaaaaaaaaaaaabbbbbbbbbaaaaaaaaaabbbbbbbbbbbbaaa
jjjjjjjjjjjjjjjjjjjjjjjjjjccddddddddccaaaaaaaaaaaaaaaaaaaaaaaaaaaaaaaaaaaaaaaaaaaaaaaaaaaaaaaabbbbbbbaaaaaaaaaaaabbbbbbbbbbbbbaa
jjjjjjjjjjjjjjjjjjjjjjjjjjccddddddddccaaaaaaaaaaaaaaaaaaaaaaaaaaaaaaaaaaaaaaaaaaaaaaaaaaaaaaaaabbbbbaaaaaaaaaaaabbbbbbbbbbbbbbba
jjjjjjjjjjjjjjjjjjjjjjjjjjccddddddddccaaaaaaaaaaaaaaaaaaaaaaaaaaaaaaaaaaaaaaaaaaaaabbbbbaaaaaaabbbbbaaaaaaaaaaaabbbbbbbbbbbbbbbb
ccccccccccccccccccccccccccccddddddddccccccccccccaaaaaaaaaaaaaaaaaaaaaaaaaaaaaaaaabbbbbbbbbbbbbbbbbbbaaaaaaaaaaabbbbbbbbbbbbbbbbb
ccccccccccccccccccccccccccccddddddddccccccccccccccccaaaaaaaaaaaaaaaaaaaaaaaaaaaaabbbbbbbbbbbbbbbbbbbaaaaaaaaaggbbbbbbbbbbbbbbbbb
ddddddddddddddddddddddddddddddddddddeddddddddeddddddddeddddddddeddddbbbdbbbbbbbbaabbbbbbbbbbbbbbbbbbbaaaaaagggkkllllbbbbbbbbbbba
ddddddddddddddddddddddddddddddddddddeddddddddeddddddddeddddddddeddddbddddbbbbbbbbbbbbbbbbbbbbbbbbbbbbbaaaaggkkkkkklllbbbbbbbbbaa
ddddddddddddddddddddddddddddddddddddeddddddddeddddddddeddddddddedddbddbddbbbbbbbbbbbbbbbbbaaaaaabbbbbbgggggkkkrrrkkllbbbbbbbbaaa
ddddddddddddddddddddddddddddddddddddeddddddddeddddddddeddddddddebdbdddddbddbbbbbbbbbbbbbbaaaaaaaaabbbkkkggkkkrrrrrkkllbbbbbbaaaa
ddddddddddddddddddddddddddddddddddddeddddddddeddddddddeddddddddedddddbddddbbbbbbbbbbbbbbbaaaaaaaaaabkkkgkkkkrrrrrrrkkllbbbbaaaaa
ddddddddddddddddddddddddddddddddddddeddddddddeddddddddeddddddddedddddddddbbbbbbbaaabbbbbbaaaaaaaaaagkkkkkkrrrrrrrrrrkklbbbaaaaaa
ddddddddddddddddddddddddddddddddddddeddddddddeddddddddeddddddddedddddddbbbbbbbbaaaabbbbbbaaaaaaaaaagkkkkkrrrrrrrrrrrrkkbbaaaaaaa
ddddddddddddddddddddddddddddddddddddeddddddddeddddddddeddddddddedddbddbbbbbbbbbaaaaabbbbbbaaaaaaaaggkkkkrrrrrrrrrrrrrrkkgaaaaaaa
ccccccccccccccccccccccccccccddddddddccccccccccccccccaaaaaaaaaaaaaaaaaaabbbbbbbaaaaaaabbbbbbaaaaaaagkkkkrrrrrrrrrrrrrrrrkggaaaaaa
ccccccccccccccccccccccccccccddddddddcccccccccccccccaaaaaaaaaaaaaaaaaaaaaaaaaaaaaaaaaabbbbbbbbbbbaagkkrrrrrrrrrrrrrrrrrrrkgaaaaaa
jjjjjjjjjjjjjjjjjjjjjjjjjjccddddddddccaaaaaaaaaaaaaaaaaaaaaaaaaaaaaaaaaaaaaaaaaaaaaaaabbbbbbbbbbbagkrrrrrrrrrrrrrrrrrrrkkgaaaaaa
jjjjjjjjjjjjjjjjjjjjjjjjjjccddddddddccaaaaaaaaaaaaaaaaaaaaaaaaaaaaaaaaaaaaaaaaaaaaaaaaabbbbbbbbbbagkrrrrrrrrrrrrrrrrrrkkkgaaaaaa
jjjjjjjjjjjjjjjjjjjjjjjjjjccddddddddccaaaaaaaaaaaaaaaaaaaaaaaaaaaaaaaaaaaaaaaaaaaaaaaaaaabbbbbbbbagkrrrrrrrrrrrrrrrrrrkkggaaaaaa
jjjjjjjjjjjjjjjjjjjjjjjjjjccddddddddccaaaaaaaaaaaaaaaaaaaaaaaaaaaaaaaaaaaaaaaaaaaaaaaaaaabbbbbbbbagkkrrrrrrrrrrrrrrrrrrkggaaaaaa
jjjjjjjjjjjjjjjjjjjjjjjjjjccddddddddccaaaaaaaaaaaaaaaaaaaaaaaaaaaaaaaaaaaaaaaaaaaaaaaaaaabbbbbbbbaggkkrrrrrrrrrrrrrrrrrkggaaaaaa
jjjjjjjjjjjjjjjjjjjjjjjjjjccccccccccccaaaaaaaaaaaaaaaaaaaaaaaaaaaaaaaaaaaaaaaaaaaaaaaaaaaabbbbbbbaagkkkrrrrrrrrrrrrrrrrkgaaaaaaa
jjjjjjjjjjjjjjjjjjjjjjjjjjccccccccccccaaaaaaaaaaaaaaaaaaaaaaaaaaaaaaaaaaaaaaaaaaaaaaaaaaaaabbbbbbaagkkkkrrrrrrrrrrrrrrkkgaaaaaaa
jjjjjjjjjjjjjjjjjjjjjjjjjjjjjjjjjjjjjjjjjjjjjjjjjjjjjjjjjjjjjjjjjjjjjjjjjjjjaaaaaaaaaaabbbabbbbbaaagkkkkkrrrrrrrrrrrrkkggaaaaaaa
jjjjjjjjjjjjjjjjjjjjjjjjjjjjjjjjjjjjjjjjjjjjjjjjjjjjjjjjjjjjjjjjjjjjjjjjjjjjaaaaaaaabbbbbbbbbbaaaaffkkkkkkkrrrrrrrkkkkggaaaaaaaa
jjjjjjjjjjjjjjjjjjjjjjjjjjjjjjjjjjjjjjjjjjjjjjjjjjjjjjjjjjjjjjjjjjjjjjjjjjjjaaaaaaabbbbbbbbbbbaaaffffkkkkkkrrrrkkkkkgggaaaaaaaaa
jjjjjjjjjjjjjjjjjjjjjjjjjjjjjjjjjjjjjjjjjjjjjjjjjjjjjjjjjjjjjjjjjjjjjjjjjjjjaaaaaabbbbbbbbbbbbaafffffgggggkkrrkkkllggaaaaaaaaaaa
jjjjjjjjjjjjjjjjjjjjjjjjjjjjjjjjjjjjjjjjjjjjjjjjjjjjjjjjjjjjjjjjjjjjjjjjjjjjaaaaabbbbbbbbbbbbbbffffaaaaaaaaffkkllbbaaaaaaaaaaaaa
jjjjjjjjjjjjjjjjjjjjjjjjjjjjjjjjjjjjjjjjjjjjjjjjjjjjjjjjjjjjjjjjjjjjjjjjjjjjaaaabbbbbabbbbbbbbbbfaaaaaaaaaaaaabbbbbbaaaaaaaaaaaa
jjjjjjjjjjjjjjjjjjjjjjjjjjjjjjjjjjjjjjjjjjjjjjjjjjjjjjjjjjjjjjjjjjjjjjjjjjjjaaaabbbaaaabbbbbbbbbbaaabbbbaaaaabbbbbbbbaaaaabbbaaa
jjjjjjjjjjjjjjjjjjjjjjjjjjjjjjjjjjjjjjjjjjjjjjjjjjjjjjjjjjjjjjjjjjjjjjjjjjjjaaabbbbaaaabbbbbbbbbbbaabbbbbbbbbbbbbbbbbbbbbbbbbbaa
jjjjjjjjjjjjjjjjjjjjjjjjjjjjjjjjjjjjjjjjjjjjjjjjjjjjjjjjjjjjjjjjjjjjjjjjjjjjaabbbbbaaaaabbbbbaabbbbbbbbbbbbbbbbbbbbbbbbbbbbbbbba
jjjjjjjjjjjjjjjjjjjjjjjjjjjjjjjjjjjjjjjjjjjjjjjjjjjjjjjjjjjjjjjjjjjjjjjjjjjjaabbbbbbaaabbbbbaaaabbbbbbbbbbbbbbbbbbbbbbbbbbbbbbbb
jjjjjjjjjjjjjjjjjjjjjjjjjjjjjjjjjjjjjjjjjjjjjjjjjjjjjjjjjjjjjjjjjjjjjjjjjjjjaabbbbbbaabbbbbaaaabbbbbbbbbbbbbbbbbbbbbbbbbbbbbbbbb
jjjjjjjjjjjjjjjjjjjjjjjjjjjjjjjjjjjjjjjjjjjjjjjjjjjjjjjjjjjjjjjjjjjjjjjjjjjjaabbbbbbbbbbbbbbaabbbbbbbbbbbbbbbbbbbbbbbbbbbbbbbbbb
jjjjjjjjjjjjjjjjjjjjjjjjjjjjjjjjjjjjjjjjjjjjjjjjjjjjjjjjjjjjjjjjjjjjjjjjjjjjaabbbbbbbbbbbbbbbbbbbbaahhihhhhhhhhhihhaaabbbbbbbbba
jjjjjjjjjjjjjjjjjjjjjjjjjjjjjjjjjjjjjjjjjjjjjjjjjjjjjjjjjjjjjjjjjjjjjjjjjjjjaabbbbbbbbbabbbbbbbbbaaahiiiiiiiiiiiiihaaaabbbbbbbaa
jjjjjjjjjjjjjjjjjjjjjjjjjjjjjjjjjjjjjjjjjjjjjjjjjjjjjjjjjjjjjjjjjjjjjjjjjjjjaabbbbbbbaaaabbbbbbbaaaahiiiiiiiiiiiiihaaaaaaaaaaaaa
jjjjjjjjjjjjjjjjjjjjjjjjjjjjjjjjjjjjjjjjjjjjjjjjjjjjjjjjjjjjjjjjjjjjjjjjjjjjaaabbbbbaaaaabbbbbbaaaaahiiiiiiiiiiiiihaaaaaaaaaaaaa
jjjjjjjjjjjjjjjjjjjjjjjjjjjjjjjjjjjjjjjjjjjjjjjjjjjjjjjjjjjjjjjjjjjjjjjjjjjjaaabbbbbbaaabbbbbbaaaaaahiiiiiiiiiiiiihaaaaaaaaaaaaa
jjjjjjjjjjjjjjjjjjjjjjjjjjjjjjjjjjjjjjjjjjjjjjjjjjjjjjjjjjjjjjjjjjjjjjjjjjjjaaaabbbbbbabbbbbbbaaaaaahiiiiiiiiiiiiihaaaaaaaaaaaaa
jjjjjjjjjjjjjjjjjjjjjjjjjjjjjjjjjjjjjjjjjjjjjjjjjjjjjjjjjjjjjjjjjjjjjjjjjjjjaaaaabbbbbbbbbbbbaaaaaaahhhhhhhhhhhhhhhaaaaaaaaaaaaa
jjjjjjjjjjjjjjjjjjjjjjjjjjjjjjjjjjjjjjjjjjjjjjjjjjjjjjjjjjjjjjjjjjjjjjjjjjjjaaaaaabbbbbbbbbbaaaaaaaaaaaaaaaaaaaaaaaaaaaaaaaaaaaa
jjjjjjjjjjjjjjjjjjjjjjjjjjjjjjjjjjjjjjjjjjjjjjjjjjjjjjjjjjjjjjjjjjjjjjjjjjjjaaaaaaaabbbbbbbbaaaaaaaaaaaaaaaaaaaaaaaaaaaaaaaaaaaa
jjjjjjjjjjjjjjjjjjjjjjjjjjjjjjjjjjjjjjjjjjjjjjjjjjjjjjjjjjjjjjjjjjjjjjjjjjjjaaaaaaaaaabbbbbbaaaaaaaaaaaaaaaaaaaaaaaaaaaaaaaaaaaa
jjjjjjjjjjjjjjjjjjjjjjjjjjjjjjjjjjjjjjjjjjjjjjjjjjjjjjjjjjjjjjjjjjjjjjjjjjjjaaaaaaaaaaaabbbbaaaaaaaaaabbbaaaaaaaaaaaaaaaaaaaaaaa
jjjjjjjjjjjjjjjjjjjjjjjjjjjjjjjjjjjjjjjjjjjjjjjjjjjjjjjjjjjjjjjjjjjjjjjjjjjjaaaaaaaaaaaabbbbaaaaaaaaabbbbbbaaaaaaaaaaaaaaaaaaaaa
jjjjjjjjjjjjjjjjjjjjjjjjjjjjjjjjjjjjjjjjjjjjjjjjjjjjjjjjjjjjjjjjjjjjjjjjjjjjaaaaaaaaaaaabbbbbaaaaaaabbbbbbbbaaaaaaaaaaaaaaaaaaaa
jjjjjjjjjjjjjjjjjjjjjjjjjjjjjjjjjjjjjjjjjjjjjjjjjjjjjjjjjjjjjjjjjjjjjjjjjjjjaaaaaaaaaaaabbbbbaaaaaabbbbbbbbbbaaaaaaaaaaaaaaaaaaa
jjjjjjjjjjjjjjjjjjjjjjjjjjjjjjjjjjjjjjjjjjjjjjjjjjjjjjjjjjjjjjjjjjjjjjjjjjjjaaaaaaaaaaaaabbbbbaaabbbbbbbbbbbbbaaaaaaaaaaaaaaaaaa
jjjjjjjjjjjjjjjjjjjjjjjjjjjjjjjjjjjjjjjjjjjjjjjjjjjjjjjjjjjjjjjjjjjjjjjjjjjjaaaaaaaaaaaaabbbbbbbbbbbbbbaabbbbbbaaaaaaaaaaaaaaaaa
jjjjjjjjjjjjjjjjjjjjjjjjjjjjjjjjjjjjjjjjjjjjjjjjjjjjjjjjjjjjjjjjjjjjjmmmmmmmaaaaaaaaaaaaaabbbbbbbbbbbaaaaaabbbbbaaaaaaaaaaaaaaaa
jjjjjjjjjjjjjjjjjjjjjjjjjjjjjjjjjjjjjjjjjjjjjjjjjjjjjjjjjjjjjjjjjjjjjmmmmmmmaaaaaaaaaaaaaaabbbbbbbbaaaaaaaaabbbbbaaaaaaaaaaaaaaa
jjjjjjjjjjjjjjjjjjjjjjjjjjjjjjjjjjjjjjjjjjjjjjjjjjjjjjjjjjjjjjjjjjjjjmmmmmmmaaaaaaaaaaaaaaaabbbbbbaaaaaaaaaabbbbbaaaaaaaaaaaaaaa
jjjjjjjjjjjjjjjjjjjjjjjjjjjjjjjjjjjjjjjjjjjjjjjjjjjjjjjjjjjjjjjjjjjjjmmmmmmmaaaaaaaaaaaaaaaaaabbbaaaaaaaaaaaabbbbaaaaaaaaaaaaaaa
jjjjjjjjjjjjjjjjjjjjjjjjjjjjjjjjjjjjjjjjjjjjjjjjjjjjjjjjjjjjjjjjjjjjjmmmmmmmaaaaaaaaaaaaabbbbaaaaaaaaaaaaaaaabbbbbaaaaaaaaaaaaaa
jjjjjjjjjjjjjjjjjjjjjjjjjjjjjjjjjjjjjjjjjjjjjjjjjjjjjjjjjjjjjjjjjjjjjmmmmmmmaaaaaaaaaaaabbbbbbaaaaabbaaaaaaaabbbbbaaaaaaaaaaaaaa
jjjjjjjjjjjjjjjjjjjjjjjjjjjjjjjjjjjjjjjjjjjjjjjjjjjjjjjjjjjjjjjjjjjjjmmmmmmmaaaaaaaaaaabbbbbbbbbbbbbbbaaaaabbbbbbbaaaaaaaaaaaaaa
jjjjjjjjjjjjjjjjjjjjjjjjjjjjjjjjjjjjjjjjjjjjjjjjjjjjjjjjjjjjjjjjjjjjjmmmmmnnooooaaaaaaabbbbbbbbbbbbbbbbbabbbbbbbbbaaaaaaaaaaaaaa
jjjjjjjjjjjjjjjjjjjjjjjjjjjjjjjjjjjjjjjjjjjjjjjjjjjjjjjjjjjjjjjjjjjjjmmmnnnnooooooaaaabbbbbbbbbbbbbbbbbbbbbbbbbbbbaaaaaaaaaaaaaa
jjjjjjjjjjjjjjjjjjjjjjjjjjjjjjjjjjjjjjjjjjjjjjjjjjjjjjjjjjjjjjjjjjjjjmmmnnnnoooooooaaabbbbbbbbbbaaaaaabbbbbbbbbbbbaaaaaaaaaaaaaa
jjjjjjjjjjjjjjjjjjjjjjjjjjjjjjjjjjjjjjjjjjjjjjjjjjjjjjjjjjjjjjjjjjjjjmmnnnnnooooooooaabbbbbbbbbaaaaaaaaabbbbbbbbbbaaaaaaaaaaaaaa
jjjjjjjjjjjjjjjjjjjjjjjjjjjjjjjjjjjjjjjjjjjjjjjjjjjjjjjjjjjjjjjjjjjjjmmnnnnnoooooooooaabbbbbbaaaaaaaaaaaabbbbbbbbbaaaaaaaaaaaaaa
jjjjjjjjjjjjjjjjjjjjjjjjjjjjjjjjjjjjjjjjjjjjjjjjjjjjjjjjjjjjjjjjjjjjjmmnnnnnoooooooooaabbbbbbaaaaaaaaaaaabbbbbbbbbaaaaaaaaaaaaaa
jjjjjjjjjjjjjjjjjjjjjjjjjjjjjjjjjjjjjjjjjjjjjjjjjjjjjjjjjjjjjjjjjjjjjmmnnnnnooooooooooaabbbbbaaaaaaaaaaaabbbbbbbbbaaaaaaaaaaaaaa
jjjjjjjjjjjjjjjjjjjjjjjjjjjjjjjjjjjjjjjjjjjjjjjjjjjjjjjjjjjjjjjjjjjjjmmnnnnnoooooooooooaaabbbbbbaaaaaaaaabbbbbbbbbaaaaaaaaaaaaaa
jjjjjjjjjjjjjjjjjjjjjjjjjjjjjjjjjjjjjjjjjjjjjjjjjjjjjjjjjjjjjjjjjjjjjmmnnnnnoooooooooooaaaabbbbbbbaaaaaaabbbbbbbbbaaaaaaaaaaaaaa
jjjjjjjjjjjjjjjjjjjjjjjjjjjjjjjjjjjjjjjjjjjjjjjjjjjjjjjjjjjjjjjjjjjjjmmnnnnnoooooooooooaaaaabbbbbbbbaaaaabbbbbbbbaaaaaaaaaaaaaaa
jjjjjjjjjjjjjjjjjjjjjjjjjjjjjjjjjjjjjjjjjjjjjjjjjjjjjjjjjjjjjjjjjjjjjmmnnnnnoooooooooooaaaaaaabbbbbbbaaaabbbbbbbbaaaaaaaaaaaaaaa
jjjjjjjjjjjjjjjjjjjjjjjjjjjjjjjjjjjjjjjjjjjjjjjjjjjjjjjjjjjjjjjjjjjjjmmnnnnnoooooooooooaaaaaaaabbbbbbbbaabbbbbbbaaaaaaaaaaaaaaaa
jjjjjjjjjjjjjjjjjjjjjjjjjjjjjjjjjjjjjjjjjjjjjjjjjjjjjjjjjjjjjjjjjjjjjmmnnnnnoooooooooooaaaaaaaaaabbbbbbbbbbbbbbaaaaaaaaaaaaaaaaa
jjjjjjjjjjjjjjjjjjjjjjjjjjjjjjjjjjjjjjjjjjjjjjjjjjjjjjjjjjjjjjjjjjjjjmmnnnnnoooooooooooaaaaaaaaaaaabbbbbbbbbbbaaaaaaaaaaaaaaaaaa
jjjjjjjjjjjjjjjjjjjjjjjjjjjjjjjjjjjjjjjjjjjjjjjjjjjjjjjjjjjjjjjjjjjjjmmnnnnnoooooooooooaaaaaaaaaaaabbbbbbbbbbaaaaaaaaaaaaaaaaaaa
jjjjjjjjjjjjjjjjjjjjjjjjjjjjjjjjjjjjjjjjjjjjjjjjjjjjjjjjjjjjjjjjjjjjjmmnnnnnoooooooooooaaaaaaaaaaaabbbbbbbbaaaaaaaaaaaaaaaaaaaaa
jjjjjjjjjjjjjjjjjjjjjjjjjjjjjjjjjjjjjjjjjjjjjjjjjjjjjjjjjjjjjjjjjjjjjmmnnnnnoooooooooooaaaaaaaaaabbbbbbbaaaaaaaaaaaaaaaaaaaaaaaa
jjjjjjjjjjjjjjjjjjjjjjjjjjjjjjjjjjjjjjjjjjjjjjjjjjjjjjjjjjjjjjjjjjjjjmmnnnnnoooooooooooaaaaaaaabbbbbbbaaaaaaaaaaaaaaaaaaaaaaaaaa
jjjjjjjjjjjjjjjjjjjjjjjjjjjjjjjjjjjjjjjjjjjjjjjjjjjjjjjjjjjjjjjjjjjjjmmnnnnnoooooooooooaaaaaaabbbbbbbbaaaaaaaaaaaaaaaaaaaaaaaaaa
jjjjjjjjjjjjjjjjjjjjjjjjjjjjjjjjjjjjjjjjjjjjjjjjjjjjjjjjjjjjjjjjjjjjjmmnnnnnoooooooooooaaaaaabbbbbbbbaaaaaaaaaaaaaaaaaaaaaaaaaaa
jjjjjjjjjjjjjjjjjjjjjjjjjjjjjjjjjjjjjjjjjjjjjjjjjjjjjjjjjjjjjjjjjjjjjmmnnnnnoooooooooooaaaaaabbbbbbaaaaaaaaaaaaaaaaaaaaaaaaaaaaa
jjjjjjjjjjjjjjjjjjjjjjjjjjjjjjjjjjjjjjjjjjjjjjjjjjjjjjjjjjjjjjjjjjjjjmmnnnnnoooooooooooaaaaaabbbbbbbaaaaaaaaaaaaaaaaaaaaaaaaaaaa
jjjjjjjjjjjjjjjjjjjjjjjjjjjjjjjjjjjjjjjjjjjjjjjjjjjjjjjjjjjjjjjjjjjjjmmnnnnnoooooooooooaaaaaabbbbbbbbaaaaaaaaaaaaaaaaaaaaaaaaaaa
jjjjjjjjjjjjjjjjjjjjjjjjjjjjjjjjjjjjjjjjjjjjjjjjjjjjjjjjjjjjjjjjjjjjjmmnnnnnoooooooooooaaaaabbbbbbbbbaaaaaaaaaaaaaaaaaaaaaaaaaaa
jjjjjjjjjjjjjjjjjjjjjjjjjjjjjjjjjjjjjjjjjjjjjjjjjjjjjjjjjjjjjjjjjjjjjmmnnnnnoooooooooooaaaabbbbbbbbbbbaaaaaaaaaaaaaaaaaaaaaaaaaa
jjjjjjjjjjjjjjjjjjjjjjjjjjjjjjjjjjjjjjjjjjjjjjjjjjjjjjjjjjjjjjjjjjjjjmmnnnnnoooooooooooaaaabbbbbbbbbbbaaaaaaaaaaaaaaaaaaaaaaaaaa
jjjjjjjjjjjjjjjjjjjjjjjjjjjjjjjjjjjjjjjjjjjjjjjjjjjjjjjjjjjjjjjjjjjjjmmnnnnnoooooooooooaaabbbbbbbbbbbbbaaaaaaaaaaaaaaaaaaaaaaaaa
jjjjjjjjjjjjjjjjjjjjjjjjjjjjjjjjjjjjjjjjjjjjjjjjjjjjjjjjjjjjjjjjjjjjjmmnnnnnooooooooooooabbbbbbbbbbbbbbaaaaaaaaaaaaaaaaaaaaaaaaa
jjjjjjjjjjjjjjjjjjjjjjjjjjjjjjjjjjjjjjjjjjjjjjjjjjjjjjjjjjjjjjjjjjjjjmmnnnnnoooooooooooobbbbbbbbbbbbbbbaaaaaaaaaaaaaaaaaaaaaaaaa
jjjjjjjjjjjjjjjjjjjjjjjjjjjjjjjjjjjjjjjjjjjjjjjjjjjjjjjjjjjjjjjjjjjjjmmnnnnnoooooooooooobbbbbbbbbbbbbbbaaaaaaaaaaaaaaaaaaaaaaaaa
jjjjjjjjjjjjjjjjjjjjjjjjjjjjjjjjjjjjjjjjjjjjjjjjjjjjjjjjjjjjjjjjjjjjjmmnnnnnoooooooooooobbbbbbbbbbbbbbbaaaaaaaaaaaaaaaaaaaaaaaaa
jjjjjjjjjjjjjjjjjjjjjjjjjjjjjjjjjjjjjjjjjjjjjjjjjjjjjjjjjjjjjjjjjjjjjmmnnnnnoooooooooooobbbbbbbbbbbbbbbaaaaaaaaaaaaaaaaaaaaaaaaa
jjjjjjjjjjjjjjjjjjjjjjjjjjjjjjjjjjjjjjjjjjjjjjjjjjjjjjjjjjjjjjjjjjjjjmmnnnnnoooooooooooobbbbbbbbbbbbbbbaaaaaaaaaaaaaaaaaaaaaaaaa
jjjjjjjjjjjjjjjjjjjjjjjjjjjjjjjjjjjjjjjjjjjjjjjjjjjjjjjjjjjjjjjjjjjjjmmnnnnnooooooooooooobbbbbbbbbbbbbaaaaaaaaaaaaaaaaaaaaaaaaaa
jjjjjjjjjjjjjjjjjjjjjjjjjjjjjjjjjjjjjjjjjjjjjjjjjjjjjjjjjjjjjjjjjjjjjmmnnnnnooooooooooooobbbbbbppbbbbbaaaaaaaaaaaaaaaaaaaaaaaaaa
jjjjjjjjjjjjjjjjjjjjjjjjjjjjjjjjjjjjjjjjjjjjjjjjjjjjjjjjjjjjjjjjjjjjjmmnnnnnoooooooooooooobbbbppppbbbaaaaaaaaaaaaaaaaaaaaaaaaaaa
jjjjjjjjjjjjjjjjjjjjjjjjjjjjjjjjjjjjjjjjjjjjjjjjjjjjjjjjjjjjjjjjjjjjjmmmnnnnoooooooooooooobbbppppppbbaaaaaaaaaaaaaaaaaaaaaaaaaaa
jjjjjjjjjjjjjjjjjjjjjjjjjjjjjjjjjjjjjjjjjjjjjjjjjjjjjjjjjjjjjjjjjjjjjmmmmnnnoooooooqqqqqqqqpppppppppaaaaaaaaaaaaaaaaaaaaaaaaaaaa
jjjjjjjjjjjjjjjjjjjjjjjjjjjjjjjjjjjjjjjjjjjjjjjjjjjjjjjjjjjjjjjjjjjjjmmmmmnnoooqqqqqqqqqqqqqpppppppaaaaaaaaaaaaaaaaaaaaaaaaaaaaa
jjjjjjjjjjjjjjjjjjjjjjjjjjjjjjjjjjjjjjjjjjjjjjjjjjjjjjjjjjjjjjjjjjjjjmmmmmmnoqqqqqqqqqqqqqqqqppppppaaaaaaaaaaaaaaaaaaaaaaaaaaaaa
jjjjjjjjjjjjjjjjjjjjjjjjjjjjjjjjjjjjjjjjjjjjjjjjjjjjjjjjjjjjjjjjjjjjjmmmmmmmqqqqqqqqqqqqqqqqqqpppppaaaaaaaaaaaaaaaaaaaaaaaaaaaaa
"}
