"a" = (/turf/simulated/wall/rock,/area/world/caves/cave)
"b" = (/turf/simulated/floor/cave_dirt,/area/world/caves/cave)
"c" = (/turf/simulated/wall/cult,/area/world/caves/cave)
"d" = (/turf/simulated/floor/wood/dock,/area/world/caves/cave)
"e" = (/turf/simulated/wall/rock,/area/world/caves/exterior_unsafe)
"f" = (/turf/simulated/floor/colored/dirt/cave,/area/world/caves/cave)
"g" = (/turf/simulated/wall/rock,/area/world/caves/exterior)
"h" = (/turf/simulated/wall/wood/brown,/area/world/caves/cave)
"i" = (/turf/simulated/floor/wood/brown,/area/world/caves/cave)
"j" = (/turf/simulated/wall/diona,/area/world/caves/exterior)
"k" = (/turf/simulated/floor/colored/dirt/cave,/area/world/caves/exterior)
"l" = (/turf/simulated/floor/cave_dirt,/area/world/caves/exterior)
"m" = (/turf/simulated/wall/river,/area/world/caves/exterior_unsafe)
"n" = (/turf/simulated/floor/colored/dirt/cave,/area/world/caves/exterior_unsafe)
"o" = (/turf/simulated/wall/river,/area/world/caves/cave)
"p" = (/turf/simulated/floor/cave_dirt,/area/world/jungle/exterior)
"q" = (/turf/simulated/wall/river,/area/world/jungle/exterior)
"r" = (/turf/simulated/floor/colored/grass,/area/world/caves/exterior)
"s" = (/turf/simulated/floor/wood/dock,/area/world/caves/exterior_unsafe)
"t" = (/turf/simulated/floor/cave_dirt,/area/world/caves/exterior_unsafe)
"u" = (/turf/simulated/floor/diona,/area/world/caves/cave)
"v" = (/turf/simulated/floor/diona,/area/world/caves/exterior)
"w" = (/turf/simulated/wall/diona,/area/world/caves/cave)
"x" = (/turf/simulated/floor/colored/dark_grass,/area/world/caves/exterior_unsafe)
"z" = (/obj/structure/scenery/grass,/turf/simulated/floor/colored/grass,/area/world/caves/exterior)
"A" = (/obj/structure/scenery/evergreen,/turf/simulated/floor/colored/grass,/area/world/caves/exterior)
"B" = (/obj/structure/scenery/rocks,/turf/simulated/floor/colored/dirt/cave,/area/world/caves/exterior_unsafe)
"C" = (/obj/structure/scenery/rocks,/turf/simulated/floor/cave_dirt,/area/world/caves/cave)
"D" = (/obj/structure/scenery/rocks,/turf/simulated/floor/cave_dirt,/area/world/caves/exterior)
"E" = (/obj/structure/scenery/rocks,/turf/simulated/floor/cave_dirt,/area/world/jungle/exterior)
"F" = (/obj/structure/scenery/evergreen,/turf/simulated/floor/colored/dark_grass,/area/world/caves/exterior_unsafe)
"G" = (/obj/structure/interactive/wishgranter/normal/caves,/turf/simulated/floor/colored/grass,/area/world/caves/exterior)
"L" = (/turf/simulated/floor/cult,/area/world/caves/exterior_unsafe)
"M" = (/obj/structure/scenery/grass,/turf/simulated/floor/colored/dark_grass,/area/world/caves/exterior_unsafe)
"N" = (/turf/simulated/floor/cult,/area/world/caves/cave)

(1,1,1) = {"
aaaaaaaaaaaaaaaaaaaaaaaaaaaaaaaaaaaaaaooooaaaaaaaaaaaaaaaaaaaaaaaaaaaaaaaaaaaaaaaaaabbbbbaaaaaaaaaaaaaaaaaaaaaaaaaaaaaaaaaaaaaaa
aaaaaaaaaaaaaaaaaaaaaaaaaaaaaaaaaaaaaaooooaaaaaaaaaaaaaaaaaaaaaaaaaaaaaaaaaaaaaaaabbbbbbbCCaaaaaaaaaaaaaaaaaaaaaaaaaaaaaaaaaaaaa
aaaaaaaaaaaaaaaaaaaaaaaaaaaaaaaaaaaaaaoooooaaaaaaaaaaaaaaaaaaaaaaaaaaaaaaaaaaaaaabbbbbbbbbCCaaaaaaaaaaaaaaaaaaaaaaaaaaaaaaaaaaaa
aaaaaaaaaaaaaaaaaaaaaaaaaaaaaaaaaaaaaaoooooaaaaaaaaaaaaaaaaaaaaaaaaaaaaaaaaaaaaaabbbbbbbbbbbCCCaaaaaaaaaaaaaaaaaaaaaaaaaaaaaaaaa
aaaaaaaaaaaaaaaaaaaaaaaaaaaaaaaaaaaaaaooooooaaaaaaaaaaaaaaaaaaaaaaaaaaaaaaaaaaaaabbbbbbbbbbbbbCCCaaaaaaaaaaaaaaaaaaaaaaaaaaaaaaa
aaaaaaaaaaaaaaaaaaaaaaaaaaaaaaaaaaaaaaooooooaaaaaaaaaaaaaaaaaaaaaaaaaaaaaaaaaaaaCbbbbbbbbbbbbbbbbCaaaaaaaaaaaaaaaaaaaaaaaaaaaaaa
aaaaaaaaaaaaaaaaaaaaaaaaaaaaaaaaaaaaaaooooooaaaaaaaaaaaaaaaaaaaaaaaaaaaaaaaaaaaaCbbbbbbbbbbbbbbbbCCaaaaaaaaaaaaaaaaaaaaaaaaaaaaa
aaaaaaaaaaaaaaaaaaaaaaaaaaaaaaaaaaaaaaaoooooaaaaaaaaaaaaaaaaaaaaaaaaaaaaaaaaaaaaCCCbbbbbbbbbbbbbbbCCaaaaaaaaaaaaaaaaaaaaaaaaaaaa
aaaaaaaaaaaaaaaaaaaaaaaaaaaaaaaaaaaaaaaaoooooaaeeeeeeeeeeeeeeeeeeeeeeaaaaaaaaaaaCCCCbbbbbbbbbbbbbbbbaaaaaaaaaaaaaaaaaaaaaaaaaaaa
aaaaaaaaaaaaaaaaaaaaaaaaaaaaaaaaaaaaaaaaoooooomeeeeeeeeeeeeeeeeeeeeeeaaaaaaaaaaaaCCCCbbbbbbbbbbbbbbbaaaaaaaaaaaaaaaaaaaaaaaaaaaa
aaaaaaaaaaaaaaaaaaaaaaaaaaaaaaaaaaaaaaaaoooooomBnneeeeeeeeeeeeeeeeeeeaaaaaaaaaaaaaCCCCCCbbbbbbbbbbbbabaaaaaaaaaaaaaaaaaaaaaaaaaa
aaaaaaaaaaaaaaaaaaaaaaaaaaaaaaaaaaaaaaaaoooommmBxnnneeeeeeeeeeeeeeeeeaaaaaaaaaaaaaaaaCCCCCCCCbbbbbbbbbbaaaaaaaaaaaaaaaaaaaaaaaaa
aaaaaaaaaaaaaaaaaaaaaaaaaaaaaaaaaaaaaaaaaoommmmBMMMnnneeeeeeeeeeeeeeeaaaaaaaaaaaaaaaaaaaaCCCCCCCCCCbbbbbbaaaaaaaaaaaaaaaaaaaaaaa
aaaaaaaaaaaaaaaaaaaaaaaaaaaaaaaaaaaaaaaaammmmmmBxxMMMnnneeeeeeeeeeeeeaaaaaaaaaaaaaaaaaaaaaaaaaaaaaCCabbbbbaaaaaaaaaaaaaaaaaaaaaa
aaaaaaaaaaaaaaaaaaaaaaaaaaaaaaaaaaaaaaaaammmmmmBxxxxMMMnnnneeeeeeeeeeaaaaaaaaaaaaaaaaaaaaaaaaaaaaaaaaabbbbbCaaaaaaaaaaaaaaaaaaaa
aaaaaaaaaaaaaaaaaaaaaaaaaaaaaaaaaaaaaaaeemmmmmmBBxxxxMMMMMnnneeeeeeeeaaaaaaaaaaaaaaaaaaaaaaaaaaaaaaaaaabbbbCCaaaaaaaaaaaaaaaaaaa
aaaaaaaaaaaaaaaaaaaaaaaaaaaaaaaaaaaaaaaeeemmmmmmBxxxxxxxMMMMnnneeeeeeaaaaaaaaaaaaaaaaaaaaaaaaaaaaaaaaaaabbbbCaaaaaaaaaaaaaaaaaaa
aaaaaaaaaaaaaaaaaaaaaaaaaaaaaaaaaaaaaaaeeemmmmmmBxxxxxxxxxMMMMnneeeeeaaaaaaaaaaaaaaaaaaaaaaaaaaaaaaaaaaaabbbCCaaaaaaaaaaaaaaaaaa
aaaaaaaaaaaaaaaaaaaaaaaaaaaaaaaaccccccceeeemmmmmBBxxxxxxxxxMMMMneeeeeaaaaaaaaaaaaaaaaaaaaaaaaaaaaaaaaaaaaabbbCaaaaaaaaaaaaaaaaaa
aaaaaaaaaaaaaaaaaaaaaaaaaaaaaaaacNNNNNceeeemmmmmmBxxFxxxxxxxMMMnneeeeaaaaaaaaaaaaaaaaaaaaaaaaaaaaaaaaaaaaaabbCCaaaaaaaaaaaaaaaaa
cccccccccccccccccccccccccccccccccNNNNNceeeemmmmmmBxxxxxxxxxxxMMMnneeeaaaaaaaaaaaaaaaaaaaaaaaaaaaaaaaaaaaaaabbbCaaaaaaaaaaaaaaaaa
cNNNNNNNNNNNNNNNNNNNNNNNNNNNNNNNNNNNNNceeeemmmmmmBxxxxxxxxxxxxMMMneeeaaaaaaaaaaaaaaaaaaaaaaaaaaaaaaaaaaaaaaCbbCaaaaaaaaaaaaaaaaa
cNcccccccccccccccccccccccccccccccNNNNNceeeemmmmmmBxxxxxxxFxxxxxMMneeeaaaaaaaaaaaaaaaaaaaaaaaaaaaaaaaaaaaaaaCbbCaaaaaaaaaaaaaaaaa
cNcLLLLLLLLLLLLLLLLLLLLLLLLLLLLLcNNNNNceeeMBmmmmmBxxxxxxxxxxxxxMMneeeaaaaaaaaaaaaaaaaaaaaaaaaaaaaaaaaaaaaaabbbCCaaaaaaaaaaaaaaaa
cNcLMMMLMMMMMMMMMMMLLMMMMMMMMMMLcccNccceeeMBmmmmmBxxxxxxxxxxxxxxMneeeaaaaaaaaaaaaaaaaaaaaaaaaaaaaaaaaaaaaabbbbbCaaaaaaaaaaaaaaaa
cNcLMMMLMMMMMMMMMMMLLMMMMMMMMMMLLLcNceeeexMBmmmmmBxxxxxxxxxxxxxxMnneeaaaaaaaaaaaaaaaaaaaaaaaaaaaaaaCCCCCCbbbbbCCaaaaaaaaaaaaaaaa
cNcLMMMLMMMMMMMMMMMLLMMMMMMMMMMMMLcNceeeeMMBmmmmmBxxxxxxxxxxxxxxMMneeaaaaaaaaaaaaaaaaaaaaaaaaaaaaCCCbbbbbbbbbCCaaaaaaaaaaaaaaaaa
cNcLMMMLMMMMMMMMMMMLLMMMMMMMMMMMMLcNceeexMBBmmmmmBxxFxxxxxxxxxxxMMneeaaaaaaaaaaaaaaaaaaaaaaaaaaaCCCCbbbbbbbCCCaaaaaaCCCCCCCaaaaa
cNcLMMMLMMMMMMMMMMMLLMMMMMMMMMMMMLcNceeexMBmmmmmmBxxxxxxxxxxxxxxxMnneaaaaaaaaaaaaaaaaaaaaaaaaaaCCCCbbbbbaaaaaaaaaaaCCCbbbbCCaaaa
cNcLMMMLMMMMMMMMMMMLLMMMMMMMMMMMMLcNceeeMMBmmmmmmBxxxxxxxxxxxxxxMMMneaaaaaaaaaaaaaaaaaaaaaaaaaCCCCbbbbbaaaaaaaaaaCCCbbbbbbbCCaaa
cNcLMMMLMMMMMMMMMMMLLMMMMMMMMMMMLLcNceexMBBmmmmmBBxxxxxxxxFxxxxMMMMnnaaaaaaaaaaaaaaaaaaaaaaaaaCCbbbbbaaaaaaaaaaaaCbbbbbbbbbbCCaa
cNcLMMMLMMMMMMMMMMMLLMMMMMMMMMMMLccNccexMBmmmmmmBxxxxxxxxxxxxxMMMMMMnaaaaaaaaaaaaaaaaaaaaaaaaaaCbbbbaaaaaaaaaaaaCCbbbbbbbbbbbCCa
cNcLLLLLLLLLLLLLLLLLLLLLLLLLLLLLLcNNNcexMBmmmmmBBxxxxxxxxxxxxMMMMMMnnaaaaaaaaaaaaaaCCCCCaaaaaaaCbbbbaaaaaaaaaaaaCbbbbbbbbbbbbbbb
cNcccccLMMMMMMMMMMMLLMMMMMMMMMMMLcNNNcexMBmmmmmBxxxxxxxxxxxxMMMMMMnnCaaaaaaaaaaaaCCCCCCCCCCbbbbbbbbbaaaaaaaaaaaCCbbbbbbbbbbbbbbb
cNcNNNcLMMMMMMMMMMMLLMMMMMMMMMMMLNNNNcexMBmmmmmBxxxxxxxxxxxxMMMnnnnCCCCaaaaaaaaaaCbCCCCbbbbbbbbbbbbbaaaaaaaaaggCbbbbbbbbbbbbbbbb
NNNNNNcLMMMMMMMMMMMLLMMMMMMMMMMMLcNNNcxxMBmmmmmBxxxFxxxxxxxMMMMnnbbbbCCCCCCCCCCCaaCCbbbbbbbbbbbbbbbbbaaaaaagggkkllllbbbbbbbbbbba
NNNNNNcLMMMMMMMMMMMLLMMMMMMMMMMMLcNNNcxMMBmmmmmBxxxxxxxxxxxMMMMnbbbbbbbbbbbbbbbbbbbbbbbbbbbbbbbbbbbbbbaaaaggkkkkkklllbbbbbbbbbaa
NNNNNNcLMMMMMMMMMMMLLMMMMMMMMMMMLccNccMMBBmmmmBBxxxxxxxxxxxxMMMntbbbbbbbbbbbbbbbbbbbbbbbbbaaaaaabbbbbbgggggkkkrrrkkllbbbbbbbbaaa
NNNNNNNLLLLLLLLLLLLLLLLLLLLLLLLLLLLLLLLssssssssxxxxxxxxxxxxxxMMnnbbbbbbbbbbbbbbbbbbbbbbbbaaaaaaaaabbbkkkggkkkrrrrrkkllbbbbbbaaaa
NNNNNNNLLLLLLLLLLLLLLLLLLLLLLLLLLLLLLLLssssssssxxxxxxxxxxxxxxxMMnbbbbbbbbbbbbbbbbbbbbbbbbaaaaaaaaaabkkkgkkkkrrrrrrrkkllbbbbaaaaa
NNNNNNcLMMMMMMMMMMMLLMMMMMMMMMMMLccNccBBmmmmmmBxxxxxxxxxxxxxxxxxntbbbbbbbbbbbbCCaaabbbbbbaaaaaaaaaagkkkkkkrrrrzzzzrrkklbbbaaaaaa
NNNNNNcLMMMMMMMMMMMLLMMMMMMMMMMMLcNNNcBmmmmmmBBxxxxxxxxxxxxxxxxxnnbbbbbbbbbbbbCaaaabbbbbbaaaaaaaaaagkkkkkrrrrAzzzzrrrkkbbaaaaaaa
NNNNNNcLMMMMMMMMMMMLLMMMMMMMMMMMLcNNNcBmmmmmmBMxxFxxxxxxxxxxxxxxxnnbbbCCCbbbbCCaaaaabbbbbbaaaaaaaaggkkkkrrrzzzzzzzrrrrkkgaaaaaaa
cNcNNNcLMMMMMMMMMMMLLMMMMMMMMMMMLNNNNcBmmmmmBBMxxxxxxxxxxxxxxxxxxxnnbaaCCCCCCCaaaaaaabbbbbbaaaaaaagkkkkrrrzzzzzzzzrrrrrkggaaaaaa
cNcccccLMMMMMMMMMMMLLMMMMMMMMMMMLcNNNcBmmmmmBMMxxxxxxxxxxxxFxxxxxxMnnaaaaaaaaaaaaaaaabbbbbbbbbCCaagkkrrrrzzzzzzzzzrrrrrrkgaaaaaa
cNcLLLLLLLLLLLLLLLLLLLLLLLLLLLLLLcNNNcBmmmmmBMMxxxxxxxxxxxxxxxxxxMMnaaaaaaaaaaaaaaaaaabbbbbbbbbCCagkrrrrzzzzzzGzzzrrrrrkkgaaaaaa
cNcLMMMLMMMMMMMMMMMLLMMMMMMMMMMMLccNccBmmmmmBBMxxxxxxxxxxxxxxxxxMMMnaaaaaaaaaaaaaaaaaaabbbbbbbbbCagkrrrrzAzzzzzzzrrrrrkkkgaaaaaa
cNcLMMMLMMMMMMMMMMMLLMMMMMMMMMMMLLcNcBBmmmmmmBMMxxxxxxxxxxxxxxMMMMnnaaaaaaaaaaaaaaaaaaaaabbbbbbbCagkrrrrrzzzzzzrrrrrrrkkggaaaaaa
cNcLMMMLMMMMMMMMMMMLLMMMMMMMMMMMMLcNcBmmmmmmmBBMxxxxxxxxxxxxMMMMMnnaaaaaaaaaaaaaaaaaaaaaabbbbbbbCagkkrrrrzzzzrrrrrrrrrrkggaaaaaa
cNcLMMMLMMMMMMMMMMMLLMMMMMMMMMMMMLcNcBmmmmmmmmBMxxxFxxxxxMMMMMMnnnaaaaaaaaaaaaaaaaaaaaaaabbbbbbbCaggkkrrrrzzrrrrrrrrrrrkggaaaaaa
cNcLMMMLMMMMMMMMMMMLLMMMMMMMMMMMMLcNcBmmmmmmmmBMxxxxxxxMMMMMMnnnaaaaaaaaaaaaaaaaaaaaaaaaaabbbbbbCaagkkkrrrrrrrrrrrrrrrrkgaaaaaaa
cNcLMMMLMMMMMMMMMMMLLMMMMMMMMMMMMLcNcBmmmmmmmmBMxxxxxxMMMMMnnnaaaaaaaaaaaaaaaaaaaaaaaaaaaaabbbbCCaagkkkkrrrrrrrrrrrrrrkkgaaaaaaa
cNcLMMMLMMMMMMMMMMMLLMMMMMMMMMMLLLcNcBmmmmmmmmBMxxMMMMMnnnnnaaaaaaaaaaaaaaaaaaaaaaaaaaaCCCabbbCCaaagkkkkkrrrrrrrrrrrrkkggaaaaaaa
cNcLMMMLMMMMMMMMMMMLLMMMMMMMMMMLcccNcccmmmmmmmBMMMMMMnnnaaaaaaaaaaaaaaaaaaaaaaaaaaaaCCCCbbbbbbaaaaffkkkkkkkrrrrrrrkkkkggaaaaaaaa
cNcLLLLLLLLLLLLLLLLLLLLLLLLLLLLLcNNNNNcmmmmmmmBMMMnnnnaaaaaaaaaaaaaaaaaaaaaaaaaaaaaCCbbbbbbbbbaaaffffkkkkkkrrrrkkkkkgggaaaaaaaaa
cNcccccccccccccccccccccccccccccccNNNNNcmmmmmmmBnnnnaaaaaaaaaaaaaaaaaaaaaaaaaaaaaaaCCbbbbbbbbbbaafffffgggggkkrrkkklDggaaaaaaaaaaa
cNNNNNNNNNNNNNNNNNNNNNNNNNNNNNNNNNNNNNcmmmmmmmaaaaaaaaaaaaaaaaaaaaaaaaaaaaaaaaaaaCCbbbbbbbbbbbbffffaaaaaaaaffkkllbCaaaaaaaaaaaaa
cccccccccccccccccccccccccccccccccNNNNNcmmmmmoaaaaaaaaaaaaaaaaaaaaaaaaaaaaaaaaaaaCCbbbabbbbbbbbbbfaaaaaaaaaaaaabbbbCCaaaaaaaaaaaa
aaaaaaaaaaaaaaaaaaaaaaaaaaaaaaaacNNNNNcmmmoooaaaaaaaaaaaaaaaaaaaaaaaaaaaaaaaaaaaCbbaaaabbbbbbbbbbaaaCCCCaaaaaCbbbbbCCaaaaaCCCaaa
aaaawwwwwwwwwwwwwwwwwwwwwaaaaaaacccccccmmooooaaaaaaaaaaaaaaaaaaaaaaaaaaaaaaaaaaCCbbaaaabbbbbCCCbbbaaCCbCCCCCCCbbbbbbCCCCCCCbCCaa
aaaawuuuuuuuuuuuuuuuuuuuwaaaaaaaaaaaaooooooooaaaaaaaaaaaaaaaaaaaaaaaaaaaaaaaaaCCbbbaaaaaCbbCCaabbbbbbbbbbbbbbbbbbbbbbbbbbbbbbCCa
aaaawuuuuuuuuuuuuuuuuuuuwaaaaaaaaaaaaooooooooaaaaaaaaaaaaaaaaaaaaaaaaaaaaaaaaaCbbbbbaaaCCbCCaaaabbbbbbbbbbbbbbbbbbbbbbbbbbbbbbbb
aaaawuuwwwwuuuuuuuwwwwuuwaaaaaaaaaaaaooooooooaaaaaaaaaaaaaaaaaaaaaaaaaaaaaaaaaCbbbbbaaCCbbCaaaabbbbbbbbbbbbbbbbbbbbbbbbbbbbbbbbb
aaaawuuwaawuuuuuuuwaawuuwwwwwwwaaaaaaooooooooaaaaaaaaaaaaaaaaaaaaaaaaaaaaaaaaabbbbbbbCCbbbCCaabbbCCbbbbbbbbbbbbbbbbbbbbbbbbbbbbb
aaaawuuwaawuuuuuuuwaawuuuuuuuuwaaaaaaooooooooaaaaaaaaaaaaaaaaaaaaaaaaaaaaaaaaabbbbbbbbCCCbbbbbbbCCaahhihhhhhhhhhihhaaaCCbbbbbCCa
aaaawuuwwwwuuuuuuuwwwwuuuuuuuuwaaaaaaoooooooooaaaaaaaaaaaaaaaaaaaaaaaaaaaaaaaabbbbbbbCCaCCbbbbbCCaaahiiiiiiiiiiiiihaaaaCCCCCCCaa
aaaawuuuuuuuuuuuuuuuuuuuwwwwwwwaaaaaaaooooooooaaaaaaaaaCCCCCCCCCaaaaaaaaaaaaaabbbbbbbaaaaCbbbbCCaaaahiiiiiiiiiiiiihaaaaaaaaaaaaa
aaaawuuuuuuuuuuuuuuuuuuuwaaaaaaaaaaaaaoooooooooaaaaaaaaaCCCCCCCCCCaaaaaaaaaaabbbbbbbaaaaaCbbbCCaaaaahiiiiiiiiiiiiihaaaaaaaaaaaaa
aaaawwwwwwwwwwuuwwwwwwuuwaawwwwaaaaaaaoooooooooaaaaaaaaaaCCCCCCbbaaaaaaaaabbbbbbbbbbbaaabbbbbCaaaaaahiiiiiiiiiiiiihaaaaaaaaaaaaa
aawwwwwwwwwwwwuuwaaaawuuwaawuuwaaaaaaaooooooooooaaaaaaaaaCaCbbbbbbbaaaaabbbbbbbbbbbbbbabbbbbCCaaaaaahiiiiiiiiiiiiihaaaaaaaaaaaaa
aawuuuuuuuuuuuuuwaaaawuuwaawuuwaaaaaaaaaooooooooaaaaaaaaaaCCaabbbbbbbbbbbbbbbbbbbbbbbbbbbbbbCaaaaaaahhhhhhhhhhhhhhhaaaaaaaaaaaaa
aawuuuuuuuuuuuuuwaaaawuuwaawuuwaaaaaaaaaooooooooaaaaaaaaaaaCCCbbbbbbbbbbbbbbbbCCaabbbbbbbbbbaaaaaaaaaaaaaaaaaaaaaaaaaaaaaaaaaaaa
aawuuwwwwwwwwwuuwaaaawuuwaawuuwaaawwwwaaaooooooooaaaaaaaaaaaaabbbbbbbbbbbbbbCCCaaaaabbbbbbbbaaaaaaaaaaaaaaaaaaaaaaaaaaaaaaaaaaaa
aawuuwaaaaaaawuuwaaaawuuwaawuuwaaawuuwaaaaoooooooooaaaaaaaaaaaaaCCCobbbbbCCCCaaaaaaaaaCCCbbbaaaaaaaaaaaaaaaaaaaaaaaaaaaaaaaaaaaa
aawuuwaaaaaaawuuwaaaawuuwaawuuwaaawuuwaaaaaooooooooooaaaaaaaaaooooooooddoooaaaaaaaaaaaaaCbbbaaaaaaaaaaCCCaaaaaaaaaaaaaaaaaaaaaaa
aawuuwaawwwwwwuuwwwwwwuuwwwwuuwwwwwuuwaaaaaoooooooooooaaaaaaaoooooooooddooooaaaaaaaaaaaaCbbbaaaaaaaaaCCbCCCaaaaaaaaaaaaaaaaaaaaa
aawuuwaawuuuuuuuuuuuuuuuuuuuuuuuuuuuuwaaaaaaooooooooooooooaaooooooooooddooooaaaaaaaaaaaaCbbbbaaaaaaaCCbbbbCCaaaaaaaaaaaaaaaaaaaa
aawuuwaawuuuuuuuuuuuuuuuuuuuuuuuuuuuuwaaaaaaooooooooooooooooooooooooooddooooaaaaaaaaaaaaCbbbbaaaaaabCbbbbbbbbaaaaaaaaaaaaaaaaaaa
aawwwwaawuuwwwwwwwwwuuwwwwwwwwwwwwwwwwaaaaaaaoooooooooooooooooooooooooddoooooaaaaaaaaaaaabbbbbaaabbbbbCCCCbbbbaaaaaaaaaaaaaaaaaa
aaaaaaaawuuwaaaaaaawuuwaaaaaaaaaaaaaaaaaaaaaaaaaooooooooooooooooooooooddoooooaaaaaaaaaaaabbbbbbbbbbbbCCaaCCbbbbaaaaaaaaaaaaaaaaa
aaaaaaaawuuwaaaaaaawuuwaaaaaaaaaaaaaaaaaaaaaaaaaaaoooooooooooooodddddddddddddoaaaaaaaaaaaabbbbbbbbbbbaaaaaabbbbCaaaaaaaaaaaaaaaa
aaaaaaaawuuwaaaaaaawuuwaaawwwwwwwwwwwwwwwwwaaaaaaaaaoooooooooooodddddddddddddoaaaaaaaaaaaaabbbbbbCCaaaaaaaaabbbCCaaaaaaaaaaaaaaa
aaaaaaaawuuwaaaaaaawuuwaaawuuuuuuuuwwuuuuuwaaaaaaaaaaaaaaoooooooddoooooooooddooaaaaaaaaaaaaaCCCbCCaaaaaaaaaaCCbbCaaaaaaaaaaaaaaa
aaaaaaaawuuwaawwwwwwuuwaaawuuuuuuuuwwuuuuuwaaaaaaaaaaaaaaaooooooddoooooooooddooaaaaaaaaaaaaaaaCCCaaaaaaaaaaaaCbbCaaaaaaaaaaaaaaa
aaaaaaaawuuwaawuuuuuuuwaaawwwwwwwuuwwwwwuuwaaaaaaaaaaaaaaaaoooooddoooooooooddoooaaaaaaaaaCCCCaaaaaaaaaaaaaaaaCbbCCaaaaaaaaaaaaaa
aaaaaaaawuuwaawuuuuuuuwaaaaaaaaawuuwaaawuuwaaaaaaaaaaaaaaaaaooooddoooooooooddoooaaaaaaaaCCbbbbaaaaabbaaaaaaaaCbbbCaaaaaaaaaaaaaa
aaaaaaaawwwwaawuuwwwuuwaaaaaaaaawuuwaaawuuwaaaaaaaaaaaaaaaaaaoooddddddoooooddooooaaaaaaCCbbbbbbbbbbbbbaaaaaCCCbbbCaaaaaaaaaaaaaa
aaaaaaaaaaaaaawuuwawuuwwwwwwwwwwwuuwwwwwuuwaaaaaaaaaaaaaaaaaaoooddddddooooodddddddaaaaaCbbbbbbbbbbbbbbbbabbCCCbbbCaaaaaaaaaaaaaa
aaaaaaaaaaaaaawuuwawuuuuuuuuuuuuuuuuuuuuuuwaaaaaaaaaaaaaaaaaaoooooooddooooodddddddaaaaCCbbbbbbbbbbbbbbbbbbCCCCCbbCaaaaaaaaaaaaaa
aaaaaaaaaaaaaawuuwawuuuuuuuuuuuuuuuuuuuuuuwaajjjjjjjllllaaaaaaooooooddooooooooooddoaaaCbbbbbbbbbaaaaaabbbbCCCCCbbCaaaaaaaaaaaaaa
aaaaaaaawwwwwwwuuwawuuwwwwwwuuwwwwwwuuwwwwwjjjvvvvvllllllaaaaaooooooddooooooooooddooaaCbbbbbbbbaaaaaaaaabbbCCCCbbCaaaaaaaaaaaaaa
aaaaaaaawuuuuuuuuwawuuwaaaawuuwaaaawuuwaaajjvvvvvvllllllllaaaaaoooooddddddddddddddoooaabbbbbbaaaaaaaaaaaaCbbCCbbbCaaaaaaaaaaaaaa
aaaaaaaawuuuuuuuuwawuuwaaaawwwwaaaawuuwaaajvvvvvvllllllllllaaaaoooooddddddddddddddoooaabbbbbbaaaaaaaaaaaaCbbbbbbbCaaaaaaaaaaaaaa
aaaaaaaawwwwwwwuuwawuuwaaaaaaaawwwwwuuwaawjvvvvvvlllllllllllaaooooooddoooooddoooddooooaabbbbbaaaaaaaaaaaaCCbbbbbbCaaaaaaaaaaaaaa
aaaaaaaaaaaaaawuuwawuuwaaaaaaaawuuuuuuwaajvvvvvvllllllllllllllooooooddoooooddoooddoooooaaabbbbbbaaaaaaaaaCCbbbbbbCaaaaaaaaaaaaaa
aaaawwwwwwwwwwwuuwawuuwaaaaaaaawuuuuuuwajjvvvvvvllllllllllllllldddddddoooooddooooooooooaaaaCCbbbbbaaaaaaaCCCbbbbbCaaaaaaaaaaaaaa
aaaawuuuuuuuuuuuuwawuuwwwwwwwwwwuuwwwwwajvvvvvvlllllllllllllllldddddddoooooddooooooooooaaaaaCCCbbbbbaaaaaCCCbbbbbaaaaaaaaaaaaaaa
aaaawuuuuuuuuuuuuwawuuuuwwuuuuuuuuwaaaaajvvvvvvvlllllllllllllllddooooooooooddddddddddoooaaaaaaCbbbbbbaaaaCCbbbbbbaaaaaaaaaaaaaaa
aaaawuuwwwwuuwwwwwawuuuuwwuuuuuuuuwaaaajjvvvvvvvlllllllllllllllddooooooooooddddddddddoooaaaaaaaCCbbbbbbaaCbbbbbbaaaaaaaaaaaaaaaa
aaaawuuwaawuuwaaaaawuuwwwwuuwwwwuuwwwwwjvvvvvvvvlllllllllllllllddooooooooooddooooooooooooaaaaaaaabbbbbbbbbbbbbbaaaaaaaaaaaaaaaaa
aaaawuuwaawuuwaaaaawuuwaawuuwaawuuuuuuuvvvvvvvvvlllllllllllllllddooooodddddddooooooooooooaaaaaaaaaabbbbbbbbbbbaaaaaaaaaaaaaaaaaa
aaaawuuwaawuuwwwwwwwuuwaawuuwaawuuuuuuuvvvvvvvvvlllllllllllllaaaaooooodddddddooooooooooooaaaaaaaaaabbbbbbbbbbaaaaaaaaaaaaaaaaaaa
aaaawuuwaawuuuuuuuuuuuwaawuuwaawwwwwwwwjjvvvvvvvllllllllllllaaaaaaooooddoooooooooooooooooaaaaaaaaaabbbbbbbbaaaaaaaaaaaaaaaaaaaaa
aaaawuuwaawuuuuuuuuuuuwaawuuwwwwwwwwwwwajjvvvvvvvllllllllllaaaaaaaooooddoooooooooooooooooaaaaaaaaCCbbbbbaaaaaaaaaaaaaaaaaaaaaaaa
aaaawuuwaawwwwwwwwwwwwwaawuuuuuuuuuuuuwaajjvvvvvvllllllllaaaaaaaaaoodddddddddddddddddddooaaaaaaCCCbbbbaaaaaaaaaaaaaaaaaaaaaaaaaa
aaaawuuwaaaaaaaaaaaaaaaaawuuuuuuuuuuuuwaaajjjvvvvllllllaaaaaaaaaaooodddddddddddddddddddooaaaaaCCbbbbbbaaaaaaaaaaaaaaaaaaaaaaaaaa
aaaawuuwwwwwwwaaaaaaaaaaawuuwwwwwwwwuuwaaaaajjjvvvlllllaaaaaaaaaooooddooooooooooddoooooooaaaaCCbbbbbbaaaaaaaaaaaaaaaaaaaaaaaaaaa
aaaawuuuuuuuuwaaawwwwwwwwwuuwwwwwaawuuwaaaaaaajjjjjlaaaaaaaaaaaaooooddooooooooooddoooooooaaaaCbbbbbaaaaaaaaaaaaaaaaaaaaaaaaaaaaa
aaaawuuuuuuuuwaaawuuuuuuuuuuuuuuwaawuuwaaaaaaaaaaaaaaaaaaaaaaaaaooooddooooooooooddooooooaaaaaCbbbbbbaaaaaaaaaaaaaaabbaaaaaaaaaaa
aaaawwwwuuwwwwaaawuuuuuuuuuuuuuuwaawuuwaaaaaaaaaaaaaaaaaaaaaaaaaoooooooodddddddddddddddoaaaaaCbbbbbbbaaaaaaaaaaaabbbbbbbbbbaaaaa
aaaaaaawuuwaawwwwwuuwwwwwwwwwwuuwaawuuwwwwwwwwwwwaaaaaaaaaaaaaaaoooooooodddddddddddddddaaaaaCCbbbbbbbaaaaaaaabbbbbbbbbbbbbbbaaaa
aaaaaaawuuwaawuuuuuuwaaaaaaaawuuwaawuuuuuuuuuuuuwaaaaawwwwwwwwwwaoooooooddooooooddoooddaaaaCCbbbbbbbbbaaabbbbbbbbbbbbaaabbbbbaaa
aaaaaaawuuwaawuuuuuuwaaaaaaaawuuwaawuuuuuuuuuuuuwaaaaawuuuuuuuuwaoooddooddooooooddoooddaaaaCbbbbbbbbbbbbbbbbbbbbbbbbbaaaaabbbbaa
aaaaaaawuuwwwwwwwwwwwwwwaaaaawuuwaawwwwwwwwwwwwwwaaaaawuuuuuuuuwaaooddooddooooooddoooddaaaCCbbbbbbbbbbbbbbbbbbbbbbbbbbaaaaabbbba
aaaaaaawuuuuuuuuuuuuuuuwaaaaawuuwaaaaaaaaaaaaaaaaawwwwwuuuuuuuuwaaooddooddooooooddoooddoaCCbbbbbbbbbbbbbbaaaaabbbbbbbbbaaabbbbba
aaaaaaawuuuuuuuuuuuuuuuwaaaaawuuwaaaaaaaaaaaaaaaaawuuuuuuuuuuuuwaaaoddddddooooooddddddddbbbbbbbbbbbbbbCaaaaaaabbbbbbbbbbbbbbbbba
aaaaaaawwwwwwwwwwwwwwuuwawwwwwuuwwwwwwwwwwwwaaaaaawuuuuuuuuuuuuwaaaoddddddooooooddddddddbbbbbbbbbbbbbbCaaaaabbbbaabbbbbbbbbbbbaa
aaaaaaaaaaaaaaaaaaaawuuwawuuuuuuuuuuuuuuuuuwaaaaaawuuwwuuuuuuuuwaaaaoooooooooooooooooooobbbbbbbbbbbbbbCaaaabbbbbaaaabbbbbbbbbaaa
aaaaaaaaaaaaaaaaaaaawuuwawuuuuuuuuuuuuuuuuuwaaaaaawuuwwuuuuuuuuwaaaaoooooooooooooooooooobbbbbbbbbbbbbbCaaaabbbbbaaaaabbbbbbbaaaa
aaaaaaawwwwwwwwwwwwwwuuwawwwwwwwwwwuuwwwwuuwaaaaaawuuwwuuuuuuuuwaaaaaooooooooooooooooooobbbbbbbbbbbbbCCaaaaabbbbbbaaabbbbbbaaaaa
aaaaaaawuuuuuuuuuuuuuuuwaaaaaaaaaawuuwaawuuwaaaaaawuuwwwwwwwwwwwaaaaaoooooooooooooooooooobbbbbbbbbbbbCaaaaaabbbbbbbbbbbbbaaaaaaa
aaaaaaawuuuuuuuuuuuuuuuwaaaaaaaaaawuuwaawuuwwwwwwwwuuwaaaaaaaaaaaaaaaaooooooooooooooooooobbbbbbppbbbCCaaaaabbbbbbbbbbbbbaaaaaaaa
aaaaaaawwwwwwwuuwwwwwwwwaaaaaaaaaawuuwaawuuuuuuuuuuuuwaaaaaaaaaaaaaaaaaooooooooooooooooooobbbbppppbbCaaaaabbbbbbbbbbbbbaaaaaaaaa
aaaaaaaaaaaaawuuwaaaaaaaaaaaaaaaaawuuwaawuuuuuuuuuuuuwaaaaaaaaaaaaaaaaaaoooooooooooooooooobbbppppppCCaaaaabbbbbbbbbbbaaaaaaaaaaa
aaaaaaaaaaaaawuuwaaaaaaaaaaaaaaaaawwwwaawwwwwwwwwwwwwwaaaaaaaaaaaaaaaaaaaooooooooooqqqqqqqqppppppppEaaaaaaabbbbaaaaaaaaaaaaaaaaa
aaaaaaaaaaaaawwwwaaaaaaaaaaaaaaaaaaaaaaaaaaaaaaaaaaaaaaaaaaaaaaaaaaaaaaaaaoooooqqqqqqqqqqqqqpppppppaaaaaaaaabbaaaaaaaaaaaaaaaaaa
aaaaaaaaaaaaaaaaaaaaaaaaaaaaaaaaaaaaaaaaaaaaaaaaaaaaaaaaaaaaaaaaaaaaaaaaaaaooqqqqqqqqqqqqqqqqppppppaaaaaaaaaaaaaaaaaaaaaaaaaaaaa
aaaaaaaaaaaaaaaaaaaaaaaaaaaaaaaaaaaaaaaaaaaaaaaaaaaaaaaaaaaaaaaaaaaaaaaaaaaaqqqqqqqqqqqqqqqqqqpppppaaaaaaaaaaaaaaaaaaaaaaaaaaaaa
"}
