"a" = (/turf/simulated/floor/chasm,/area/world/lava/exterior)
"b" = (/turf/simulated/wall/rock/basalt,/area/world/lava/exterior)
"c" = (/turf/simulated/floor/basalt,/area/world/lava/exterior)
"d" = (/turf/simulated/floor/lava,/area/world/lava/exterior)
"e" = (/turf/simulated/floor/colored/ash/dark,/area/world/lava/exterior)
"f" = (/turf/simulated/wall/shuttle,/area/world/lava/lab)
"g" = (/turf/simulated/floor/tile,/area/world/lava/lab)
"h" = (/obj/structure/interactive/lighting/tube{icon_state = "tube"; dir = 1},/turf/simulated/floor/tile,/area/world/lava/lab)
"i" = (/mob/living/simple/npc/turret/laser,/turf/simulated/floor/tile,/area/world/lava/lab)
"j" = (/turf/simulated/floor/basalt,/area/world/lava/lab)
"k" = (/obj/structure/interactive/lighting/tube,/turf/simulated/floor/basalt,/area/world/lava/exterior)
"l" = (/obj/structure/interactive/door/airlock,/turf/simulated/floor/tile,/area/world/lava/lab)
"m" = (/obj/structure/interactive/lighting/tube,/turf/simulated/floor/tile,/area/world/lava/lab)
"n" = (/obj/structure/interactive/lighting/tube{icon_state = "tube"; dir = 8},/turf/simulated/floor/tile,/area/world/lava/lab)
"o" = (/obj/structure/interactive/lighting/tube{icon_state = "tube"; dir = 4},/turf/simulated/floor/tile,/area/world/lava/lab)
"p" = (/turf/simulated/floor/plating,/area/world/lava/lab)
"q" = (/turf/simulated/floor/colored/ash/dark,/area/world/lava/lab)
"r" = (/turf/simulated/floor/tile/dark,/area/world/lava/lab)
"s" = (/obj/structure/interactive/lighting/tube{icon_state = "tube"; dir = 4},/turf/simulated/floor/tile/dark,/area/world/lava/lab)
"t" = (/obj/structure/interactive/door/airlock,/turf/simulated/floor/tile/dark,/area/world/lava/lab)
"u" = (/turf/simulated/floor/tile/grey,/area/world/lava/lab)
"v" = (/obj/structure/interactive/door/airlock,/turf/simulated/floor/tile/grey,/area/world/lava/lab)
"w" = (/obj/structure/interactive/lighting/tube{icon_state = "tube"; dir = 8},/turf/simulated/floor/tile/dark,/area/world/lava/lab)
"x" = (/turf/simulated/floor/tile/grey,/area/world/lava/exterior)
"y" = (/turf/simulated/floor/basalt,/area/world/lava/safezone)
"z" = (/turf/simulated/wall/rock/basalt,/area/world/lava/safezone)
"B" = (/obj/structure/interactive/grille,/obj/structure/smooth/window/reinforced,/turf/simulated/floor/plating,/area/world/lava/lab)
"C" = (/turf/simulated/floor/colored/ash/dark,/area/world/lava/safezone)

(1,1,1) = {"
bbbbbbbbbbbbbbbbbbbbbbbbbbbbbbbbbbbbbbbbbbbbbbbbbbbbbbbbbbbbbbbbbbbbbbbbbbbbbbbbbbbbbbbbbbbbbbbbbbbbbbbbbbbbbbbbbbbbbbbbbbbbbbbb
bbbbbbbbbbbbbbbbbbbbbbbbbbbbbbbbbbbbbbbbbbbbbbbbbccbbbbbbbbbbbbbbbbbbbbbbbbbbbbbbbbbbbbbbbbbbbbbbbbbbbbbbbbbbbbbbbbbbbbbbbbbbbbb
bbbbbbbbbbbbbbbbbbbbbbcccccccccbbbbbbbbbbbbbbbbccccccbbbccccccccccbbbbbbbbbbbbbbbbbbbbbbbbbbbbbbbbbbbbbbbbbbbbbbbbbbbbbbbbbbbbbb
bbbbbbbcccccccccbbcccccccccccccccccbbccbccccccccccccccbcccccccccccbbbbbbbbbbbbaaaaaaaaaaaaaaaaaaaaaaaaaabbbbbbbbbbbbbbbbbbbbbbbb
bbbbbccccccccccccccccccccccccccccccccccccccccccccccccccccccccccccccbbbbcccbbccccccccccaaaaaaaaaaaaaaaaabbbbbbbbbbbbbbbbbbbbbbbbb
bbbbcccccccccccccccccccccbbbbbbbbccccccccccccccccccccccccccccccccccccccccccccccccccccccaaccaaaaaaaaaabbbbbbbbbbbbbbbbbbbbddeeeeb
bbbcccccccccccccccccccccbbbbbbbbcccccccccccbbbbbbbcccccccccccccccccccbbbbbbcccccccccccccccccaaaaaaaabbbbbbbbbbbbbbbbbbddddccccee
bbcccccccccccccccccccccbbbbbbbcccccccccccccbbbbcccccccccccccccccccbbbbbcddcdcccccccccccccccaaaaaaccccbbbbbbbbbbbbbbddddccccccccc
bbccccccccccccccccccccbbbbbbcccccccccccccccbbbbccccccccccccccccbbbbbbddddddddddddddddcccccccccccccccccbbbbbbbbbbdddddccccccccccc
bbcccccccccbbccccccccbbbbbccccccccbcccccccbbbbcccccccccccccccbbbbbccdddddddddddddddddcccccccccccccccccdddbbbbbdddddccccccccccccc
bccccccccbbbbccccccccbbbbccccccccbbbbccccbbbbcccccccccbbbbbbbbbbbcdddddddddddddddddddcccccccccccccccccccddddddddcccccccccccccccc
bccccccccbbbbcccccccbbbbccccccccbbbbbccccbbbccccccccbbbbbbbbbcdddddddddddddddddddddddccccccccccccccccccccccccccccccccccccccccccb
bccccccccbbbbcccccccbbbbcccccccbbbbbbcccccbbbcccccbbbbbbdddddddddddddddddddddddddddddccccccccccccccccccccccccccccccccccccbbbbbbb
bbcccccccccbbcccccccbbbccccccbbbbbbbcccccccbbccccbbbbbddddddddddddddddddddddddddddddcccccccccccccccccccccccccccccccccccbbbbbbbbb
bbccccccccccbccccccbbbbccccccbbbbbbbcccccccbbbbbbbbbdddddddddddddddddddddddddddddddccccccccccccccccccccccccccccccccccbbbbbbbbbbb
bbbbcccccccccccccccbbbbbccccbbbbbccccccccccbbbbbbbddddddddddddddddddddddddddddddccccccccccccccccccccccccccccccccccccbbbbbbbbbbbb
bbbbbbcccccccccccccbbbbbbbbbbbbccccccccccccbbbbbdddddddddddddddddddddddddddcccccccccccccccccdddddccccccccccccccccccbbbbbbbbbbbbb
bbbbbbbcccccccccccbbbbbbbbbbbbcccccccccccccbdddddddddddddddddddddddddddccccccccccccccccccdddddddddcccccccccccccccbbbbbbbbbbbbbbb
bbbbbbbbbccccccccbbbbbbbbbbbcccccccccccccccdddddddddddddddddddddddddccccccccccccccccccccdddddddddddccccccccccccbbbbbbbbbbbbbbbbb
bbbbbbbbccccccccbbbbbbbccbbccccccccccccccccddddddddddddddddddddddccccccccccccccccccccccddddddccddddccccccccccceebbbbbbbbbbbbbbbb
bbbbbbbbccccccccbbbccccccccccccccccccccccdddddddddddddddddddddccccccccccccccccccccccccddddddccccddddddccccccccceeebbbbbbbbbbbbbb
bbbbbbbccccccccbbbbcccccccccccccccccccccddddddddddddddddddddccccccccccccccccccccccccccdddddccccccddddddcccccccceeeeebbbbbbbbbbbb
bbbbbccccccccccbbbccccccccccccccbccccdddddddddddddddddddddccccccccccccccccccccccccccccdddddcccccccddddddcccccccceeeeeebbbbbbbbbb
bbbbbcccccccccbbbccccccccccccbbbccdddddddddddddddddddddddccccccccccccccccccccccccccccccddddccccccccddddddcccccccceeeeeeebbbbbbbb
bbbbbcccccccbbbbcccccccccbbbbbbcccddddddddddddddddddddddcccccccccccdddcccccccccccccccccdcddccccccccccddddccccccccceeeeeeeebbbbbb
bbbbcccccbbbbbbbccccccccccccccccddddddddddddddddddddddddcccccccccddddddddccccccccccccccccdddcccccccccddddcccccccccceeeeeeebbbbbb
bbbccccccccbbddddccccccccccccccddddddddddddddddddddddddcccccccccdddddddddcccccccccccccccccddccccccccccdddddccccccccceeeeeeebbbbb
bbccccccccdddddddcccccccddddddddddddddddddddddddddddddcccccccccddddddddddcccccccccccccccccccccccccccccdddddccccccccccaaaaeebbbbb
bcccccccddddddddddcccccdddddddddddddddddddddddddddddddcccccccdddddddddddccccccccddccccccccccccccccccccccdddcccccccccaaaaaaaabbbb
cccccccdddddddddddddddddddddddddddddddddddddddddddddddcccccccdddddddddddccccccccdddddccccccccccccccccccdddcccccccccccaaaaaaabbbb
ccccccdddddddddddddddddddddddddddddddddddddddddddddddddccccccdddddddddddcccccccccddddddcccccccccccccccddddcccccccccaaaaaaaaabbbb
ccccddddddddddddddddddddddddddddddddddddddddddddddddddcccccccdddddddddddccccccccccddddddccccccccccccccdddcccccccccaaaaaaaaaabbbb
cccdddddddddddddddddddddddddddddddddddddddddddddddddcccccccccddddddddddcccccccccccdddddddccccccccccccdddcccccccccaaaaaaaaaaabbbb
ddddddddddddddddddddddddddddddddddddddddddddddddddddccccccccccdddddddddccccccccccccddddddcccccccccccddddccccccccaaaaaaaaaaaaabbb
dddddddddddddddddddddddddddddddddddddddddddddddddddddcccccccccccddddddccccccccccccccdddddccccccccccdddddccccccaaaaaaaaaacaaaabbb
dddddddddddddddddddddddddddddddddddddddddddddddddddddcccccccccccccccccccccccccccccccccccccccccccccdddddcccccaaaaaaaaaaacccaaaabb
ddddddddddddddddddddddddddddddddddddddddddddddddddddddcccccccccccccccccccccccccccccccccccccccccccdddddcccccaaaaaaaaaaaccccaaaabb
dddddddddddddddddddddddddddddddddddddddddddddddddddddddccccccccccccccccccccccccccccccccccccccccccddddcccccaaaaaaaaaccccccccaaabb
dddddddddddddddddddddddddddddddddddddddddddddddddddddddcccccccccccccccccccccccccccccccccccccccccddddcccccaaaaaaaaacccccccccaaabb
ddddddddddddddddddddddddddddddddddddddddddddddddddddcdccccccccccccccccccccccccccccccccccccccccccccdcccccaaaaaaaaaccccccccccccabb
bdddddddddddddddddddddddddddddddddddddddddddddddcccccccccccccccccccccccccddddccccccccccccccccccccddcccccaaaaaaaacccccccccccccaab
bbdddddddddddddddddddddddddddddddddddddddddddccccccccccccccdddccccccccccddddddccccccccccccccccccddccccccaaaaaaacccccccccddcccaab
bbbdddddddddddddddddddddddddddddddddddddddddccccccccccccccccdddcccccccddddddddcccccccccccccccccccccccccaaaaaaacccccccccdddcccaab
bbbbbddddddddddddddddddddddddddddddddddddddcccccccccccccccccdddddccccddddddddddcccccdddccccccccccccccccaaaaaaccccccccccdddcccaab
bbbbbbbdddddddddddddddddddddddddddddddddddcccccccccccccccccccddddcccddddddddddddcccddddddccccccccccccccaaaaaccccccccccddddcccaab
bbbbbbbbbbdddddddddddddddddddddddddddddddccccccccccccccccccccddddcccddddddddddddcccdddddddcccccccccccccaacaaaccccccccdddddcccaab
bbbbbbbbbbbddddddddddddddcccccccccccccccdccccccccccccccccccccddddcccddddddddddddcccddddddddcccccccccccccccaaaccccccccddddcccaaab
bbbbbbbbbbbbdddddddddddcccccccccccccccccccccccccccccccccccccccdddccdddddddddddddccccddddddddccccccccccccccaaacccccccdddddcccaabb
bbbbbbbbbbbbbdddddddddccccccccccccccccccccccccccccccccddddccccddcccddddddddddddcccccddddddddccccccccccccccaaacccccccddddcccaaabb
bbbbbbbbbbbbbbdddddddccccccccccddddcccccccccccccccccddddddcccdddcccdddddddddddccccccdddddddddccccccccccccccccccccccdddddcccaaabb
bbbbbbbbbbbbbbbddddddcccccccccddddddcccccccccccccccddddddbeccdddccddddddddddddcccccccdddddddddcccccccccccccccccccccdddccccaaaabb
bbbbbbbbbbbbbbbbddddccccccccccdddddddcccccccccccccddddddbeeccdddccddddddddddddcccccccddddddddddccccccccccccccccccccdccccccaaaabb
bfffffffffffffbbccdcccccccccdddddddddccccccccccccddddddbbeecdddcccdddddddddddcccccccccdddddddddcccccddddccccccccccccccccccaaaabb
bfggggghgggggfbbccccccccccccddddddddcccccccccccccdddddbbbeeeddcccccdddddddddcccccccccccddddddddcccccdddddccccccccccccccccaaaabbb
bfgggggggggggfbbccccccccccccbdddddddddccbcccccccdddddbbbbeeedcccccccdddddddccccccccccccddddddddcccccddddddcccccccccccccccaaaabbb
bfgggggggggggfbbccccccccccccbbcdddddcccbbbccccccddddbbbbbbeeccccccccddddddccccccccccccccdddddddcccccdddddddcccccccccccccaaaaabbb
bfgggggggggggfbcccbkccccccckbcccccccccbbbbbcccccdbbbbbbbbbcecccccccccddddccccccccccccccccdddddccccccdddddddccccccccccccaaaaabbbb
bfgggggggggggfbccbfflllflllffccccccccbbbbbbbccccbbbbbbbbbbbeccccccccccccccccccccccccccccccdddcccccccddddddddccccccccccaaaaaabbbb
bfgmgggggggmgfbccbfigggggggifbccccccbbbbbbbbcccccbbbbbbdddddcccccccccccccccccccdddccccccccccccccccccddddddddcccccccccaaaaabbbbbb
bfffffgggfffffbccbfgggggggggfbbcccbbbbbbbbcddcccccbbbddddddddcccccccccccccccccdddddccccccccccccccccccddddddddcccccccaaaaabbbbbbb
bfgggfgggfgggfbcccfngggggggofbcccbbbbbbbbbddddcccccbddddddddddcccccddddcccccccdddddddccccccccccccccccddddddddcccccccaaaaabbbbbbb
bfngglggglggofbbcefgggggggggfccccbbbbbbbbdddddcccccdddddddddddccccddddddccccddddddddddcccccccccccccccddddddddcccccccaaaaabbbbbbb
bfgggfgmgfgggfbbbefigggggggifcccbbbbbbbbddddddcccccddddddddddccccdddddddcccddddddddddccccccccccccccccdddddddddccccccaaaaabbbbbbb
bfflffffffflffffjqfflllffflffcccbbbbbbbbddddddccccddddddddccccccddddddddccccddddddddccccccccccccccccccddddddddcccccccaaaabbbbbbb
bfggggggggggggggqqggggggfgggfccbbbbbbbbdddddddccccdddddcccccccccddddddddcccccdddddccccccccccccccccccccddddddddcccccccaaaabbbbbbb
bfngggggggggggggqggggggglgggfccbbbbbbbbdddddddccccdddccccccccccdddddddddcccccccccccccccccccccccccccccccddddddddcccccaaaaabbbbbbb
bfgggggmggggggmggggggmggfgmgfcbbbbbbbbbddddddccccccccccccccccccdddddddddccccccccccccccccccccccccccccccccdddddddcccccaaaaabbbbbbb
bflllfffffflfffffffffffffffffbbbbbbbbbdddddddccccccccccccccccccddddddddccccccccccccccccccddddccccccccccccddddddcccccaaaaaabbbbbb
bfgggfggggggggfbbbbbbbbbbbbbbbbbbbbbbbdddddddccccccddccdccccccddddddddccccccccccccccccccddddddcccccccccccccccccccccccaaaaaabbbbb
bfgggfggggggggfbbbbbbbbbbbbbbbbbbbbbbbbddddddcccccdddddddcccccdddddddccccccccddcddccccccdddddddccccccccccccccccccccccccaaaabbbbb
bfggofnggggggofbbbbbbbbbbbbbbbbbbbbbbbbdddddccccccdddddddccccddddddcccccccccddddddccccccddddddddcccccccccccccccccccccccaaaabbbbb
bfgggfggggggggfbbbbbbbbbbbbbbbbbbbbbbbbbddddccccccdddddddcccccddddcccccccddddddddcccccccddddddddccccccccccccccccccccccccaaaabbbb
bfgggfggggggggfbbbffffffffbbbbbbbbbbbbbbdddcccccccdddddddccccccccccccccccddddddddcccccccdddddddddccccccccdccccccccccccccaaaabbbb
bfgggffffffffffbbbfggggggfbbbbbbbbbbbbbbbcccccccccddddddddccccccccccccccdddddddddccccccccddddddddcccccdddddddccccccccccccaaaabbb
bfgggfbbbbbbbbbbbbfnggggofbbbbbbbbbbbbbbbbcccccccdddddddddccccccccccccccdddddddddccccccccccddddddccccccdddddddcccccccccccaaaabbb
bfgggfbbbbbbbbbbbbfggggggfbbbbbbbbbbbbbbbbbccccccddddddddddddcccccccccccddddddddcccccccccccccddddccccccdddddddddccccccccccaaabbb
bfnggffffffffffffffflfffffffffffffffffffffbccccccdddddddddddddccccccccddddddddddccccccccccccccccccccccccdddddddddccccccccccaabbb
bfggglgggggggggggggggggghggghggggggggggggfbbcccccddddddddddddddccccccddddddddddcccccdddccccccccccccccccccdddddddddcccccccccaabbb
bfggglgggggggggggggggggggggggggggggggggggfbbcccccddddddddddddddccccccddddddddddcccccddddcccccccccccccccccddddddddddccccccccaaabb
bfggglggggggmggggggggggggggggggggggggggggfbbbccccdddddddddddddddccccccddddddccccccccddddccccccccccccccccccdddddddddccccccccaaabb
bfnggfflffffffffffffffffflllfffflfffffgggfbbbcccccddddddddddddddcccccccdddddccccccccddddddccccccccccccccccddddddddddccccccaaaabb
bfgggfggggggfgggggggggggfgggfbfggggggfgggfbbbcccccdddddddddddddddcccccccdddcccccccccddddddccccccccccccccccddddddddddccccccaaaabb
bfgggfgggggglgggggggggggfgggfbfggggggfgggfbbbbbccdddddddddddddddddccccccccccccccccccddddddcccccccccccccccccddddddddddcccccaaaabb
bfgggfggggggfgggggggggggfgggfbfggggggfgggfbbbbcccddddddddddddddddddcccccccccccccccccddddddcccccccccccccccccddddddddddcccccaaabbb
bfgggfnggggofgggggggggggfgggfbffffffffgggfbbbbbcddddddddddddddddddddccccccccccccccccddddddcccccccccccccccccddddddddddcccccaaabbb
bfgggfgggggglgggggggggggfgggfbbbbbbbbfgggfbbbbbcddddddddddddddddddddcccccccccccccccccdddddcccccccccccccccccddddddddddccccaaaabbb
bfggofgggggglgggggggggggfgggfbbbbbbbbfgggfbbbbbcddddddddddddddddddddcccccccccccccccccddddcccccccccccccccccccdddddddddccccaaaabbb
bfgggfggggggfgggggggggggfgggfbbbbbbbbfgggfbbbbbbddddddddddddddddddddcccccddddccccccccbbbbbbcccccdddcccccccccddddddddccccccaaabbb
bfgggffffffffgggggggggggfgggfbbbbbbbbfgggfcbbbbbdddddddddddddddddddcccccddddddcccccccbbbbbbcccccddddccccccccdddddddcccccccaaabbb
bfgggfggggggfgggggggggggfgggfbbbbbbbbfgggfcbbbbbdddddddddddddddddddcccccddddddddcccccccbbcecbbcddddddcccccccddddddccccccccaaabbb
bfgggfnggggglgggggggggggfgggfbbbbbbbbfflffcccbbbbdddddddddddddddddcccccccddddddddbbbbccceeebbbdddddddcccccccdddddcccccccccaaabbb
bfgggfggggggfgggggggggggfgggfbbbbbbbbeccccccccbbbdddddddddddddddddccccccdddddddddbbbbbbeecbbbbdddddddcccccccddddcccccccccccaabbb
bfgggffffffffffffffffffffgggfbbbbbbbeecccccccccbddddddddddddddddddcccccccccdddddbbbbbbbeccbbbbdddddddccccccccddccccccccccccaabbb
bfggplgggggghggggggggggghgggfbbbbbbeeeccccccccccdddddddddddddddddcccccccccccdddbbbbbbbeeccbbbbddddddccccccccccccccccccccccaaabbb
bfggglggggggggggggggggggggggfbbbbbbeeccccccccccddddddddddddddddddcccccccccccccbbbbbceeeeccbbbbbdddddccccccccccccccccccccccaaaabb
bfqqglmgggggggggggmgggggggggfbbbbbeeccccccccccdddddddddddddddddddccccccccccccccceeeeececcccbbbbddddccccccccccccccccccccccccaabbb
bfqqgfffffffffffffffffffflllfbbbbeecccccccccccddddddddddddddddddccccccccccccccceecccccccccccbbbbbdcccccccccccccccccccccccccaabbb
bfqqgfbbbbbbbbbbbbbbbbbbfgggfbbbbecccccccccccddddddddddddddddddccccccddccccccccccccccccccccccccbbecccccccccccccccccccccccccaabbb
bbqqqfbbbbffffffbffffffbfgggfbbbeecccccccccccddddddddddddddddccccccddddddccccccccbbbbbbbbccccccccecccccccccccccccccccccccccaabbb
beeqqbbbbbfrrrrfbfrrrrfbfgggfbbbbeecccccccccdddddddddddddddddccccddddddddccccccccdbbbbbbbbcceeeeeeeccccccccccccccccccccccccaabbb
eeeeqbbbbbfrrrsfbfrrrsfbfgggfbbbbbeecccccccddddddddddddddddddccccdddddddcccccccccdddbbbbbbbeeccbbbeccccccccccccccccccccccccaaabb
eeeeebbbbbfrrrrfbfrrrrfbfgggfbffffjqjcccccdddddddddddddddddddccccddddddccccccccccddddbbbbbbeebbbbbdddccccccccccccccccccccccaaabb
eeeebfffffffftfffffftffffgggfffuujqqjccbbddddddddddccccdddddddccccddddcccccccccccdddddbbbbbbbbbbdddddddcccccccccccccccccccccaabb
eeeebfuuuuuuuuuuuuuuuuuufgggvuuppqqjfbbbddddddddddccccccdddddddcccccccccccccccccccdddddbbbbbbbbdddddddccccccccccccccccccccccaabb
eeebbfuuuuuuuuuuuuuuuuuufgggvuuupjjufbbbddddddddddcccccccdddddddcccccccccccccccccccddddbbbbbbbddddddddccccccccccccccccccccccaabb
eebbbfuufffftfffffftffffffgffffupjppfbbbbdddddddddcccccccdddddddccccccccccccccccccccddddbbbbbcddddddddcccccccccccccccccccccccabb
ebbbbfuufbfrrrrfbfrrrrfbfigifxfpuuuufbbbbbddddddddccccccccddddddcccccccccccccccccccccdddccccccdddddddccccccccddcccccccccccccaabb
bbbbbfuufbfwrrrfbfwrrrfbfgggBxfffufffbbbbbbddddddddccccccccdddddccccccccddddccccccccccccccccccccddddccccccccddddccccccccccccaabb
bbbbbfuufbfrrrrfbfrrrrfbfgggBxuuuuuufbbbbbbbdddddddcccccccccdddddcccccddddddddccccccccccccccccccccccccccccddddddcccccccccccccabb
bbbbbfuufbffffffbffffffbfgggBxuuuquufbbbbbbbddddddddccccccccccdddccccdddddddddcccccccccccccccccccccccccccdddddddcccccccccccccabb
bbbbbfuufbbbbbbbbbbbbbbbfgggBxuuuuuufbbbbbbbbddddddddcccccccccccccccddddddddddcccccccccccccccccccccccccccdddddddcccccccccccccabb
bbbbbfuufbffffffbffffffbfgggBxuuuuuufbbbbbbbbdddddddddcccccccccccccddddddddddcccccccccccbbbbbbbcccccccccddddddddcccccccccccccbbb
bbbbbfuufbfrrrrfbfrrrrfbfgggBxuuuuuufbbbbbbbbbddddddddcccccccccccccddddddddcccccccccccbbbbbbbbbccccccccdddddddddccccccccccccbbbb
bbbbbfuufbfrrrsfbfrrrsfbfgggBxfffufffbbbbbbbbbbddddddddccccccccccccdddcccccccccccccbbbbbbbbbbbbbcccccccddddddddccccccccccccbbbbb
bbbbbfuufbfrrrrfbfrrrrfbfigifxfuuuuufbbbbbbbbbbbbdddddddcccccccccccccccccccbbbccccbbbbbbCbbbbbbbccccccccddddddcccccccccccccbbbbb
bbbbbfuuffffftfffffftfffffgffffuuuuufbbbbbbbbbbbbddddddddcccccccccccbbbbbbbbbbbccbbbbCCCCCCCbbbbcccccccccddddccccccccccccccbbbbb
bbbbbfuuuuuuuuuuuuuuuuuuvgggvuuuuuuufbbbbbbbbbbbbbddddddddccccccbbbbbbbbbbbbbbbbbbbCCCCCCCCCCbbbcccccccccddcccccccccccccccccbbbb
bbbbbpuuuuuuuuuuuuuuuuuuvgggvuuuuuuufbbbbbbbbbbbbbbdddddddddcccbbbbbbbbbbCCCCbbbbbCCCCCCCCCCCbbbbccccccccccccccccccccccccccccbbb
bbbbcjpffffftfffffftfffffgggfffuuuuufbbbbbbbbbbbbbbbbdddddddddbbbbbbbbbbCCCCCCCbbCCCCCCCCCCCCCCCCeccccccccccccccccccccccccccabbb
bccbccbbbbfrrrrfbfrrrrfbfgggfbfffffffbbbbbbbbbbbbbbbbbbddddddbbbbbbbbbbCCCCCCCCCCCCCCCCCCCCCCCCCCcccccccccccccccccccccccccccbbbb
bccccccbbbfwrrrfbfwrrrfbfgggbbbbbbbbbbbbbbbbbbbbbbbbbbbbbdbdbbbbbbbbbbbCCCCCCCCCyCCCCCCCCCCCCCCCCcccccccccccccccccccccccccaabbbb
bccccccbbbfrrrrfbfrrrrfbfggbbbbbbbbbbbbbbbbbbbbbbbbbbbbbbbbbbbbbbbbbbbCCCCCCCCyyyCCCCCCCCCCCCbbbbcccccccccccccccccccccccaaaabbbb
bbbcccccbbffffffbffffffbfgbbbbbbbbbbbbbbbbbbbbbbbbbbbbbbbbbbbbbbbbbbyyyCCCCCyyyyyyyyCCCCCbbbbbbbbcccccccccccccccbcccaaaaaaaabbbb
bbccccccbbbbbbbbbbbbbbbbfbbbbbbbbbbbbbbbbbbbbbbbbbbbbbbbbbbbbbbbbyyyyyyyyyyyyyyyyyyyyyyyybbbbbbbcccccccccccccbbbbbaaaaaaaaabbbbb
bccccccccbcccccccccccbbbbbbbbbbbbbbbbbbbbbbbbbbbbbbbbbbbbbbbbbbbbyyyyyyyyyyyyyyyyyyyyyyyyybbbbcbcccccccccccbbbbbbaaaaaaaaaabbbbb
bccccccbcccccccccbccccbbbbbbbbbbbbbbbbbbbbbbbbbbbbbbbbbbbbbbbbbbyyzyyyyyyyyyyyyyyyyyyyyyyyybbbbccccccccccbbbbbbaaaaaaaaaaaabbbbb
bbccbcbbbbbcccccccccccbbbbbbbbbbbbbbbbbbbbbbbbbbbbbbbbbbbbbbbbbbbyyybbbbzyyyyyyyyyyyyyyyyyyybbbbcbbbbbbbbbbbbbbaaaaaaaaaaaaaabbb
bbbbbbbbbbbbbbbbbbbbbbbbbbbbbbbbbbbbbbbbbbbbbbbbbbbbbbbbbbbbbbbbbbbbbbbbbbbbbbbbbbbbyyyyyzbbbbbbbbbbbbbbbbbbaaaaaaaaaaaaaaaaaaab
"}
