"a" = (/obj/structure/scenery/pinetrees,/turf/simulated/floor/colored/snow,/area/world/mountain/exterior)
"b" = (/turf/simulated/wall/rock/basalt,/area/world/lava/exterior)
"c" = (/turf/simulated/floor/basalt,/area/world/lava/exterior)
"d" = (/turf/simulated/floor/lava,/area/world/lava/exterior)
"e" = (/turf/simulated/floor/colored/ash/dark,/area/world/lava/exterior)
"f" = (/turf/simulated/wall/shuttle,/area/world/lava/lab)
"g" = (/turf/simulated/floor/tile,/area/world/lava/lab)
"h" = (/obj/structure/interactive/lighting/tube{icon_state = "tube"; dir = 1},/turf/simulated/floor/tile,/area/world/lava/lab)
"i" = (/mob/living/simple/npc/turret/laser,/turf/simulated/floor/tile,/area/world/lava/lab)
"j" = (/turf/simulated/floor/basalt,/area/world/lava/lab)
"k" = (/obj/structure/interactive/lighting/tube,/turf/simulated/floor/colored/ash/dark,/area/world/lava/exterior)
"l" = (/obj/structure/interactive/door/airlock,/turf/simulated/floor/tile,/area/world/lava/lab)
"m" = (/obj/structure/interactive/lighting/tube,/turf/simulated/floor/tile,/area/world/lava/lab)
"n" = (/obj/structure/interactive/lighting/tube{icon_state = "tube"; dir = 8},/turf/simulated/floor/tile,/area/world/lava/lab)
"o" = (/obj/structure/interactive/lighting/tube{icon_state = "tube"; dir = 4},/turf/simulated/floor/tile,/area/world/lava/lab)
"p" = (/turf/simulated/floor/plating,/area/world/lava/lab)
"q" = (/turf/simulated/floor/colored/ash/dark,/area/world/lava/lab)
"r" = (/turf/simulated/floor/tile/dark,/area/world/lava/lab)
"s" = (/obj/structure/interactive/lighting/tube{icon_state = "tube"; dir = 4},/turf/simulated/floor/tile/dark,/area/world/lava/lab)
"t" = (/obj/structure/interactive/door/airlock,/turf/simulated/floor/tile/dark,/area/world/lava/lab)
"u" = (/turf/simulated/floor/tile/grey,/area/world/lava/lab)
"v" = (/obj/structure/interactive/door/airlock,/turf/simulated/floor/tile/grey,/area/world/lava/lab)
"w" = (/obj/structure/interactive/lighting/tube{icon_state = "tube"; dir = 8},/turf/simulated/floor/tile/dark,/area/world/lava/lab)
"x" = (/turf/simulated/floor/tile/grey,/area/world/lava/exterior)
"y" = (/turf/simulated/wall/ice,/area/world/mountain/exterior)
"z" = (/turf/simulated/floor/chasm,/area/world/lava/exterior)
"A" = (/turf/simulated/wall/rock/snow,/area/world/mountain/exterior)
"B" = (/obj/structure/interactive/grille,/obj/structure/smooth/window/reinforced,/turf/simulated/floor/plating,/area/world/lava/lab)
"C" = (/turf/simulated/wall/rock/snow,/area/world/mountain/interior/temple)
"D" = (/turf/simulated/wall/rock,/area/world/mountain/exterior)
"E" = (/turf/simulated/floor/ice,/area/world/mountain/exterior)
"F" = (/turf/simulated/wall/ice,/area/world/mountain/interior/temple)
"G" = (/turf/simulated/floor/colored/snow,/area/world/mountain/exterior)
"H" = (/turf/simulated/floor/ice,/area/world/mountain/interior/temple)
"I" = (/turf/simulated/wall/rock/basalt,/area/world/mountain/exterior)
"J" = (/turf/simulated/wall/rock/basalt,/area/world/mountain/interior/temple)
"K" = (/turf/simulated/floor/chasm,/area/world/mountain/interior/temple)
"L" = (/turf/simulated/floor/colored/snow,/area/world/mountain/interior/temple)
"M" = (/turf/simulated/floor/basalt,/area/world/mountain/interior/temple)
"N" = (/obj/structure/scenery/snow_grass,/turf/simulated/floor/colored/snow,/area/world/mountain/exterior)
"O" = (/obj/structure/scenery/snow_bush,/turf/simulated/floor/colored/snow,/area/world/mountain/exterior)
"P" = (/turf/simulated/floor/colored/ash/dark,/area/world/mountain/interior/temple)
"Q" = (/turf/simulated/wall/rock,/area/world/mountain/interior/temple)
"R" = (/turf/simulated/wall/rock,/area/world/lava/exterior)

(1,1,1) = {"
bbbbbbbbbbbbbbbbbbbbbbbbbbbbbbbbbbbbbbbbbbbbbbbbbbbbbbbbQQFFFFFFFFFFFFFFFFFCCCCCCCCCCCCCCCCCCCCCCCCCCCCCCCCCCCCCCCCCCCCCCCCCCCCC
bbbbbbbbbbbbbbbbbbbbbbbbbbbbbbbbbbbbbbbbbbbbbbbbbcbbbbbbQQFHHHHHHHHHHHHHHHFCCCCCCCCCCCCCCCCCCCCCCCCCCCCCCCCCCCCCCCCCCCCCCCCCCCCC
bbbbbbbbbbbbbbbbbbbbbbcccccccccbbbbbbbbbbbbbbbbcccczzbbbJQFHHHHHHHHHHHHHHHFFFFFFFFFFFFFFFFFCCCCCCCCCCCCCCCCCCCCCCCCCCCCCCCCCCCAA
bbbbbbeeeeeeeeecbbcccccccccccccccccbbccbccccccccccczzzbbJJFHHHHHHHHHHHHHHHHHHHHHHHHHHHHHHHFCCCCCCCCCCCCCCCCCCCCCCCCCCCCCCCCAAAAG
bbbbbeeeeeeeeecccccccccccccccccccccccccccccccccccczzzzzbJJFHHHHHHHHHHHHHHHHHHHHHHHHHHHHHHHFFFFFFFFFFFFFFFFFFFFFFFCCCCCCCCCAAGGGG
bbbbeeeeeeeecccccccccccccbbbbbbbbccccccccccccccccczzzzzzJJFHHHHHHHHHHHHHHHHHHHHHHHHHHHHHHHHHHHHHHHHHHHHHHHHHHHHHFCCCCCCCCAAGGGGG
bbbeeeeeeeccccccccccccccbbbbbbbeeccccccccccbbbbbbbzzzzzzJJFHHHHHHHHHHHHHHHHHHHHHHHHHHHHHHHHHHHHHHHHHHHHHHHHHHHHHFCCCCCCCCAGGGGaG
bbeeeeeecccccccccccccccbbbbbbeeeeccccccccccbbbbeccczzzzbJJFHHHHHHHHHHHHHHHHHHHHHHHHHHHHHHHHHHHHHHHHHHHHHHHHHHHHHFCCCCCCCCAGGNNGG
bbeeeeecccccccccccccccbbbbbbeeeecccccccccccbbbeeccczzzzbJKFHHHHHHHHHHHHHHHHHHHHHHHHHHHHHHHFFFFFFFFFHHHFFFFHHHHHHFCCCCCCCAAGGGNGG
beeeeeeccccbbccccccccbbbbbeeeeecccbcccccccbbbeecccczzzzbKKFHHHHHHHHHHHHHHHFFFFFFFFFFFFFHHHFCCCCCCCFHHHFCCFHHHHHHFCCCCCCAAGGGGNGN
beeeeecccbbbbccccccccbbbbeeeeccccbbbbccccbbbeeecccczzzbbKKFHHHHHHHHHHHHHHHFCCCCCCCCCCCFHHHFCCCCCCCFHHHFCCFHHHHHHFCCCCCAAGGGaGGNN
beeeeecccbbbbcccccccbbbbeeeeccccbbbbbccccbbbeeeeccezzzbbJKFFFFFFFFFFFFFFFFFCCCCCCCCCCCFHHHFCCCCCCCFHHHFCCFFFFFFFFCCCCCAGNNGGGGNN
bceeeecccbbbbcccccccbbbbeeeccccbbbbbbcccccbbeeeeeeezzzbbJQQCCCCCCCCCCCCCCCCCCCCCCCCCCCFHHHFCCCCCCCFHHHFCCCCCCCCCCCCCCAAGGNNGGGNN
bbeeeecccccbbcccccccbbbeeecccbbbbbbbcccccccbbeeeebbzzzbbKQQQCCCCCCCCCCCCCCCCCCFFFFFFFFFHHHFCCCCCCCFHHHFCFFFFFFFFFCCCAAGGGGNNGGNN
bbeeeeecccccbccccccbbbbeeeeccbbbbbbbcccccccbbbbbbbbzzzbbKQQQCCCCCCCCCCCCCCCCCCFHHHHHHHHHHHFCCCCCCCFHHHFCFHHHHHHHFCCAAGGGGGGNNNNN
bbbeeeeccccccccccccbbbbbeeeebbbbbccccccccccbbbbbbzzzzzbbKKQQCCCCCCCCCCCCCCCCCCFHHHHHHHHHHHFCCCCCCCFHHHFFFHHHHHHHFCCAGGGGGGGGNNNN
bbbbbeeecccccccccccbbbbbbbbbbbbccccccccccccbbbbbdzzzzbbbKQQQCCFFFFFFFFFFFFFFFFFHHHHHHHHHHHFCCCCCCCFHHHHHHHHHHHHHFCAAGGGGaGGGNNNN
bbbbbbbeecccccccccbbbbbbbbbbbbcccccccccccccbdddddzzzbbbbKQQQCCFHHHHHHHHHHHHHHHHHHHFFFFFFFFFCCCCCCCFHHHHHHHHHHHHHFCAGGGGGGGGGNNNN
bbbbbbbbbccccccccbbbbbbbbbbbcccccccccccccccdddddddzbbbbbKQQCCCFHHHHHHHHHHHHHHHHHHHFCCCCCCCCCCCCCCCFHHHHHHHHHHHHHFAAGGNGGGGGNNNNN
bbbbbbbbccccccccbbbbbbbccbbccccccccccccccccdddddddzbbbbzKQQCCCFHHHHHHHHHHHHHHHHHHHFCCCCCCCCCCCCCCCFHHHFFFHHHHHHHFAGGGNNGGGGNNNNN
bbbbbbbbccccccccbbbccccccccccccccccccccccdddddddddzbbbbzQQQCCCFHHHFFFFFFFFFFFFFHHHFCCCCCCCCCCCCCCCFHHHFCFHHHHHHHFAGGGGNNGGNNNNNN
bbbbbbbccccccccbbbbcccccccccccccccccccccddddddddddzbbbzzQQQCCCFHHHFCCCCCCCCCCCFHHHFCCCCFFFFFFFFFFFFHHHFCFFFFFFFFFAGGGGGNNGNNNNNN
bbbbbccccccccccbbbccccccccccccccbccccdddddddddddddzbbbzzQQQCCCFHHHFCFFFFFFFFFCFHHHFCCCCFHHHHHHHHHHHHHHFCCCCCCCAAAAGGGGGGGNNNNNNN
bbbbbcccccccccbbbccccccccccccbbbccddddddddddddddddzzbbbzQQQCCCFHHHFCFHHHHHHHFCFHHHFCCCCFHHHHHHHHHHHHHHFCCCCCCCAGGGGGaGGGGNNNNNNN
bbbbbcccccccbbbbcccccccccbbbbbbcccdddddddddddddddzzzbbbzKQQCCCFHHHFCFHHHHHHHFFFHHHFFFFFFHHHHHHHHHHHHHHFCCCCCCAAEGGGGGGGGGNNNNNNN
bbbbcccccbbbbbbbccccccccccccccccdddddddddddddddddzzzbbbzKQQCCCFHHHFCFHHHHHHHHHHHHHHHHHHHHHHFFFFFFFFFFFFCCCCCAAEEGGGGGGGGNNNNNNNN
bbbccccccccbbddddccccccccccccccdddddddddddddddddddbzbbbzQQQCCCFHHHFCFHHHHHHHHHHHHHHHHHHHHHHFCCCCCCCCCCCCCCAAEEEGGGGGGNNNNNNNNNNN
bbccccccccdddddddcccccccddddddddddddddddddddddddddbbbbbzQQQCCCFHHHFCFHHHHHHHHHHHHHHHHHHHHHHFCCCCCCCCCCCAAAAEEEGGGGNNNNGGNNNNNNNN
bcccccccdddddddddccccccdddddddddddddddddddddddddddzbbbbzQQCCCCFHHHFCFHHHHHHHFFFFFFFFFFFFHHHFCCCCCCCCCAAEEEEEEGGGNNNGGGGGGNNNNNNN
cccccccddddddddddcccccddddddddddddddddddddddddddddzbbbbzQQCCCCFFFFFCFHHHHHHHFCCCCCCCCCCFHHHFCCCCCCAAEEEEEEEGGGNNNGGGGGGGGNNNNNNN
ccccccdddddddddddcccccdddddddddddddddddddddddddddzzbbbzzQQCCCFFFFFFFFFFFFFFFFFFFFFFFFFFFHHHFCCCCAAEEEEEEEGGGGGNGGGGGGGGGGGNNNNNN
ccccddddddddddddcccccdddddddddddddddddddddddddddddzzbzzRQQCCCFHHHHHHHHHHHHHHHHHHHHHHHHHHHHHFCCCCAEEEEEEEGGGGGGGGGGGGGGGGGGGNNNNN
cccdddddddddddddcccccdddddddddddddddddddddddddddddzzbzzRQQCCCFHHHHHHHHHHHHHHHHHHHHHHHHHHHHHFCCCAEEEEEEEGGGGGGGGGGGGGaGGGGNNNNNNN
dddddddddddddddddccccdddddddddddddddddddddddddddddzzzzzRQQCCCFHHHHHHHHHHHHHHHHHHHHHHHHHHHHHFCCCAEEEEEEGGGGGGGNNGGGGGGGGNNNGGNNNN
dddddddddddddddddccccdddddddddddddddddddddddddddddzzzzzbQQCCCFHHHFFFFFFFFFFFFFFFHHHFFFFFHHHFCCCAEEEEEGGGGGGGGGNNNGGGGGGNGGGGGNNN
ddddddddddddddddcccccdddddddddddddddddddddddddddddzbzzzbQQCCCFHHHFCCCCCCCCCCCCCFHHHFCCCFHHHFCCCAEEEEGGGGGaGGGNNNNNNGGGGGGGGGGNNN
ddddddddddddddddccccddddddddddddddddddddddddddddddbbzzzbQQCCCFHHHFCCCCCCCCCCCCCFHHHFCCCFHHHFCCCAEEEGGGGGGGGGNNNNNGNGGGGGGGGGGGNN
ddddddddddddddddccccddddddddddddddddddddddddddddddbbzzzbQQFFFFHHHFFFFFFFFFFFFFFFHHHFCCCFHHHFCCCAEEGGGGGGGGGNNNGNNGGGGGGGGGGGGGGN
dddddddddddddddcccccddddddddddddddddddddddddddddddbbzzzbJQFHHHHHHHHFHHHHHHHHHHHHHHHFCCCFHHHFCCCAEGGGGGGGGGNNNNNNNNGGGGGGGGGGGGGG
ddddddddddddddcccccddddddddddddddddddddddddddddddzbzzzzbJQFHHHHHHHHFHHHHHHHHHHHHHHHFCCCFHHHFCCCAGGGGGGGGGGNNNNNNNNGGGGaGGGGGGGGG
bdddddddddddddcccccdddddddddddddddddddddddddddddcbbzzzzbQQFHHHHHHHHFHHHHHHHHHHHHHHHFCCCFHHHFCCAAGGGGGGGGGNNNNNNNNNGGGGGGGGGGGGGE
bbdddddddddddcccccdddddddddddddddddddddddddddcccbbczzzzbJQFHHHHHHHHFHHHFFFFFFFFFFFFFCCCFHHHFCCAGGGGGGGGGNNGGNNNNNGGGGGGGGGGGGGEE
bbbddddddddddcccccddddddddddddddddddddddddddcccbbcczzzzbJQFHHHHHHHHFHHHFCCCCCCCCCCCCCCCFHHHFCCAGGGGGaGGGGGGGNNGNNGGGGGGGGGGGGEEE
bbbbbddddddddccccddddddddddddddddddddddddddcccccccczzzzbJQFHHHHHHHHFHHHFFFFFFFFFCCCCCCCFHHHFCCAGGGGGGGGGGNGGGNNNGGGGGGGGGGGGEEEE
bbbbbbbdddddcccdddddddddddddddddddddddddddccccccccczzzbbJQFHHHHHHHHFHHHFHHHHHHHFCCCCCCCFHHHFCCAGGGGGGGGGGNGGGGGGNNGGGGGGGGGEEEEE
bbbbbbbbbbcccccddddddddddddddddddddddddddcccccceccczzzbbJQFFFFFFFFFFHHHFHHHHHHHFFFFFFFFFHHHFCCAGGGGGGGGGGNGGGGGNNGaGGGGGGGEEEEEE
bbbbbbbbbbccccdddddddddddcccccccccccccccdccccceeccczzzbbJQQCFHHHHHHHHHHFHHHHHHHFHHHHHHHHHHHFCCAGGGGGGGGGGNGGaGNNGGGGGGGGGEEEEEEE
bbbbbbbbbccccddddddddddcccccccccccccccccccccceeeccczzzbbJQQCFHHHHHHHHHHFHHHHHHHHHHHHHHHHHHHFCCAGGGGGGGGGGNGGGNNGGGGGGGGGEEEEEEEE
bbbbbbbbccccbdddddddddcccccccccccccccccccccceeeeccczzzzbJQQCFHHHHHHHHHHFHHHHHHHFHHHHHHHHHHHFCCAGGGGGGaGGGNGGNNNGGGGGGGGGEEEEEEEE
bbbbbbbbccbbbbdddddddccccccccccddddcccccccceeeeecczzzzzbJQQCFHHHHHHHHHHFHHHHHHHFHHHHFFFFFFFFCCAGGGGGGGGGGNNNNGNNGGGGGGGEEEEEEEEG
bbbbbbcccbbbbbbddddddcccccccccddddddccccccceeeeccczzzzzbQQQCFHHHHHHHHHHFHHHHHHHFHHHHFCCCCCCCCCAGGGGGGGGGGNNNGGGNNGGGGGGEEEEEEGGG
bbbbbcccbbbbbbbbddddccccccccccdddddddcccccceeeccczzzzbzbQQQCFHHHHHHHHHHFFFFFFFFFFHHHFCCCCCCCCCAGGaGGGGGGNNNGGGGGNGGaGGGEEEEEGGGG
bffffjjfffffffbbccdcccccccccdddddddddccccceeeeccczzzzbbbQQCCFHHHHHHHHHHFCCCCCCCCFHHHFCCCCCCCCCAGGGGGGGGGNGGGGGGGNNGGGGGGEEEGGGGG
bfggjjghgggggfbbccccccccceecddddddddccccccceecccczzzzzbbQQQCFFFFFFFFHHHFCFFFFFFFFHHHFCCCCCCCCCAAGGGGGGGGNGGGGGaGGGGGGGGGGGGGGNNN
bfggjggggggggfbbccccccceeeeebdddddddddccbccccccczzzzzzbbQQQCCCCCCCCFHHHFCFHHHHHHHHHHFCCCCCCCCCCAGGGGGGGNNGGGNNGGGGNNNNGGGGGGNNNN
bfggjggggggggfbbcccccceeeeeebbcdddddcccbbbcccccczzzzzzbbJQQCFFFFFFFFHHHFCFHHHHHHHHHHFCCCCCCCCCCAAGGGGaGNGGaGGNNNNNNGGGGGNNNNNNNN
bfgggggggggggfbcccbkeeeeeeekbcccccccccbbbbbccccczbbzzzbbJQQCFHHHHHHHHHHFCFHHHHHHHHHHFCCCCCCCCCCCAAGGGGGNNGGGGNNGGGGGGGGGGNNNNNGG
bfgggggggggggfbccbfflllflllffccccccccbbbbbbbccccbbbzzzbbJQQCFHHHHHHHHHHFCFHHHFFFFFFFFCCCCCCCCCCCCAGGGGGGNNGGGGNNGGGNGaGGNNNNGGGG
bfgmgggggggmgfbccbfigggggggifbccccccbbbbbbbbcccccbbzzzzbJQQCFHHHHHHHHHHFCFHHHFCCCCCCCCCCCCCCCCCCCAAAAGGGGNNGGGGNGGGNNGGNNGNGGGGG
bfffffgggfffffbccbfgggggggggfbbcccbbbbbbbbcddcccccbzzzzbJQQCFHHHFFFFFFFFCFHHHFCCCCCCCFFFFFFFFFCCCCAAAAGGGGNNGaGNGaGGNGNNGGNGGGGG
bfgggfgggfgggfbcccfngggggggofbcccbbbbbbbbbddddcccczzzzbbQQQCFHHHFCCCCCCCCFHHHFCCCCCCCFHHHHHHHFCCCCAAAAAGGGGNNGGNGGGGNNNGGGNGGGGG
bfngglggglggofbbcefgggggggggfccccbbbbbbbbdddddcccczzzzbbQQQCFHHHFFFFFFFFFFHHHFFFFFFFFFHHHHHHHFCCCHEAAAAGGGGGGGNNGGGGGNGGaGNGaGGG
bfgggfgmgfgggfbbbefigggggggifcccbbbbbbbbddddddcccczzzzbbFFFFFHHHFHHHHHHHHHHHHHHHHHHHHHHHHHHHHFCCCHEEAAAAGGaGGGNGGGGGGNGGGGNGGGGG
bfflffffffflffffjqfflllffflffcccbbbbbbbbddddddcccczzzzbbFHHHFHHHFHHHHHHHHHHHHHHHHHHHHHHHHHHHHFCCHHEEEAAAGGGGGNNGGGGGGNNNNNNNNGGG
bfggggggggggggggqqggggggfgggfccbbbbbbbbdddddddcccczzzzbbFHHHFHHHFHHHHHHHHHHHHHHHHHHHHHHHHHHHHFCCHEEEEEEAGGGGGNGGGGGaGNGGGGGGNNGG
bfngggggggggggggqggggggglgggfccbbbbbbbbdddddddcccczzzbbRFHHHFHHHFFHHHFFFFFFFFFFFHHHFFFHHHHHHHFCCEEEEEEEEEEEGGGGaGGGGGNGGGGGGGNGG
bfgggggmggggggmggggggmggfgmgfcbbbbbbbbbddddddccccczzbbRRFHHHFHHHFHHHHHFCCCCCCCCFHHHFCFHHHHHHHFCAEEEEEEEEEEEEGGGGGGGGGNNNGaGGGGGG
bflllfffffflfffffffffffffffffbbbbbbbbbdddddddccccczzzbRRFHHHFHHHFHHHHHFCCCCCCCCFHHHFCFFFFFFFFFAAEEEEEEEEEEEEEGGGGNNNNNGNNGGGGGGG
bfgggfggggggggfbbbbbbbbbbbbbbbbbbbbbbbdddddddccccczzbbRRFHHHFHHHFHHHHHFCFFFFFFFFHHHFFFFFFCCCCAAAEEEEEEEEEEEEEGNGGGGGGGGGNNGGGGGG
bfgggfggggggggfbbbbbbbbbbbbbbbbbbbbbbbbddddddccccczzbbRRFHHHFHHHFHHHHHFCFHHHHHHHHHHHHHHHFCCCAAAEEEEEEEEEEEEEENNGGGGGGGGGGNNGGGGG
bfggofnggggggofbbbbbbbbbbbbbbbbbbbbbbbbdddddcceccczzbbbbFHHHFHHHFHHHHHFCFHHLLLLLLHLHHHHHFCCCAEEEEEEEEEEEEEEEENNGGGGGEEEAAGNNGGGG
bfgggfggggggggfbbbbbbbbbbbbbbbbbbbbbbbbbddddcceccczbbbbbFHHHFHHHFFFFFFFCFHLLHHHHHHHHHHHHFCCAAEEEEEEEEEEEEEEEENNGGaGGEEEAAAGGGGGG
bfgggfggggggggfbbbffffffffbbbbbbbbbbbbbbdddcccecczzbbbbbFHHHHHHHFCCCCCCCFHLHFFFFFFFFFHHHFFFAAEEEEEEEEEEEEEEEGNNGGGGEEEEAAAGGGaGG
bfgggffffffffffbbbfggggggfbbbbbbbbbbbbbbbcccccecczzzbbbbFHHHHHHHFCCCCFFFFHLHFFFFCCFHHHHHHHFAAEEEEEEEEEEEEEEEGNGGGGGEEEEAAAGGGGGG
bfgggfbbbbbbbbbbbbfnggggofbbbbbbbbbbbbbbbbccccecczzzbbbbFHHHHHHHFCCCCFHHHHLLHHHFCCFHHHHHHHFAAEEEEEEEEEEEEEEGNNGGGGEEEEAAAAGGNGGG
bfgggfbbbbbbbbbbbbfggggggfbbbbbbbbbbbbbbbbbccceeczzzbbJQFHHHFFFFFCCCCFHHHHLLLLHFCCFHHHHHHHFAAAAEEEEEEEEEEEGNNGGNGGEEEEAAAAGGNNGG
bfnggffffffffffffffflfffffffffffffffffffffbcceeeczzbbbJQFHHHFCCCCCCCCFHHHHLLLHHFCCFHHHHHHHFAAAAEEEEEEEEEEGNNNGNNGEEEEEAAAAGGGNNG
bfggglgggggggggggggggggghggghggggggggggggfbbceeeczzzbbJQFHHHFCCCCCCCCFHHHLLLLHHFCCFHHHHHHHFAAAAEEEEEEEEEENNNONNGGEEEEAAAAGGGGGNG
bfggglgggggggggggggggggggggggggggggggggggfbbcceeczzzbbJFFHHHFFCCCCCCFyyyGGLGGyyFFCFHHHHHHHFAAAAEEEEEEEEENNNNGNGGEEEEEAAAAGGGGGNN
bfggglggggggmggggggggggggggggggggggggggggfbbbceeezzzbRQFHHHHHFCCCAAAyyGGGGGGGGAyFCFHHHHHHHFAAAEEEEEEEEEENNNGNNGEEEEEAAAAAGGGaGGN
bfnggfflffffffffffffffffflllfffflfffffgggfbbbcceezzzbRQFHHHHHFAAAAGGGGGGGGGNNGAACCFFFFFFFFFAAAEEEEEEEEEGNNONNGEEEEEEAAAAAGGGGGGG
bfgggfggggggfgggggggggggfgggfbfggggggfgggfbbbcceeeeeeRFFFHHHFyAGGGGGGGNGNNNGNGGAACCCCCCCCCCAEEEEEEEEEGGOGNNNGEEEEEEAAAAAAGGGGGGG
bfgggfgggggglgggggggggggfgggfbfggggggfgggfbbbbbceeeeeeMMPHPHyAGGGGGGaGNNNNNNNGGGACCCCCCCCCCAEEEEEEEEEGGGNNNNEEEEEEAAAAAAGGGGGGGG
bfgggfggggggfgggggggggggfgggfbfggggggfgggfbbbbccceeeeePPPPPPyGGGNNNGGNNNNNGNNGGGAACCCCCCAAAAEEEEEEEGGGGNNNGEEEEEEAAAAAAAGGGaGGNG
bfgggfnggggofgggggggggggfgggfbffffffffgggfbbbbceeeeeeeMPHPPMyGGGGGNGGGNNNNGNNaGGGACACCCCAGGGEEEEEEGGGGNNNGGEEEEEAAAAAAAGGGGGGNGG
bfgggfgggggglgggggggggggfgggfbbbbbbbbfgggfbbbcceeceeeRFyyyyyyGGGaNNNaNNNNNGGNGGGGAAACCAAAGGEEEEEGGGGGNNNNNGGEEEAAAAAAAGGGGGNNNGG
bfggofgggggglgggggggggggfgggfbbbbbbbbfgggfbbcceeeceebRDAGGGGGGGGNNGNNNNNNNNNNGGGGGGAAAAGGGGEEEEGGGGGNNNNNNNGGEAAAAAAAGGGGGNNGGGG
bfgggfggggggfgggggggggggfgggfbbbbbbbbfgggfbbceeeeczbbRDAGGGNGGGGNGGGNNNNNNGNGaGGGGGGGGGGGGGGGGGGGGGNNNNNNNNNGGAAAAAAGGGGGGNGGGGG
bfgggffffffffgggggggggggfgggfbbbbbbbbfgggfccceeecczzbRDAGGGNGaGNNNaGNNNNGNNNGGGGGGGGGGGGGGGGGGGGGGGNGNNNNNONGGGGAAAGGGGGGGGNaGGG
bfgggfggggggfgggggggggggfgggfbbbbbbbbfgggfcbceeecczzbRDAAGGNNGGNGNGGNNNGGGGNGGGGaGGGGGGGGGGGNGGGGGGGGNGGNNONGGGGAGGGGGGGGGGNGGGG
bfgggfnggggglgggggggggggfgggfbbbbbbbbfflffccceecczzzbRDAAGaNNGNNGNNNNGGGaGGNNGGGGGGGGGGGGGGNNGGGaGGGGGGGGNNNNGGGGGGGGGGGGGGNGGGG
bfgggfggggggfgggggggggggfgggfbbbbbbbbececccceeccczzzzRDAAGGNNGNGaGNNGGGGGGGGNNaGGGGaGGGGGGGNGGGGGGGGGGGGGGNNNGGGGGGGGGGaGGGNGGGG
bfgggffffffffffffffffffffgggfbbbbbbbeeceecceeecczzzzzRDAAAGGNNNNNGGNGAAAAGGGGNGGGGGGGGGGGGNNGGGGAAGAAAAGGGGNNGGGGGGGGGGGGGGNNGGG
bfggplgggggghggggggggggghgggfbbbbbbeeecceeeeeccczzzzzRDAAAGGGNNGNNNAAAAAAAGGGNGGGGGGGGGGaGNGGGAAAAAAAAAGGGGGGGGGGGGGaGGGGNNNNGGG
bfggglggggggggggggggggggggggfbbbbbbeeccceeeeccczzzzzzRDAAAGaGNGGNNGAAAAAAAGGGNGGGGGaGGGGGNNGGAAAAAAAAAAAAGGGGGGGGGGGGNGNNNGGGGGG
bfqqglmgggggggggggmgggggggggfbbbbbeeccceeeeecczzzzzzbRDDAGGGGNNaNGGAAAAAAAGaGNNaGGGGGGGGGNGGGAAAAAAAAAAAAAAGGGaGGGGGNNNNGGGGGGGG
bfqqgfffffffffffffffffffflllfbbbbeeccceeeeeccczzzzzzbRDDAGGGGGNNNGAAAAAAAAGGGGNGGGGGGGGGGNGGAAAAAAAAAAAAAAAGGGGGGGNNNNGGGGGGGGGG
bfqqgfbbbbbbbbbbbbbbbbbbfgggfbbbbecccceeeeccczzzzzzzRRDAAGGaGGNNGGAAAAAAAAGGGGNGaGNGGGGNNNGGAAAAAAAAAAAAAAAGGGGGGGGGGNGGGGaGGGGG
bbqqqfbbbbffffffbffffffbfgggfbbbeeccceeeecccczzzzbbbRRDAAGGGGNNGGGAAAAAAAAGGGGNGNNNGaGNNGGGAAAAAAAAAAAAAAAAGGGGGGGGGNNGGGGGGGGGG
beeqqbbbbbfrrrrfbfrrrrfbfgggfbbbbeeceeeeeccczzzzzbbbbzDAAGNNNNGGGGAAAAAAAGGGaGNNNGGGGNNGGGGAAAAAAAAAAAAAAAAGGGGGNGaGNGaGGGGGGGGG
eeeeqbbbbbfrrrsfbfrrrsfbfgggfbbbbbeeeeeeccczzzzzbbbbbzDAAGGGNNGaGGAAAAAAGGGGGNNNGGGGNNGGGGAAAAAAAAAAAAAAAAAGGGGGNGGGNGGGGGGGGGGG
eeeeebbbbbfrrrrfbfrrrrfbfgggfbffffjqqecccczzzzzbbbzbbzDAAGGGNNNNGAAAAAAGGGNNNNNNGGGGNGGaGAAAAAAAAAAAAAAAAAAGGGaGGNGGNGGGGGGGGGGG
eeeebfffffffftfffffftffffgggfffuujqqqccbbzzzzzzbbzzzzRDAAGaGNNGNNGAAAAGGGGNNGGGNGaGGGGGAAAAAAAAAAAAAAAAAAAAGGGGGGNNGNGGGGGGGGGGG
eeeebfuuuuuuuuuuuuuuuuuufgggvuuppqqjfbbbzzzzzzbbzzzzRRAAAGNNNNNGNGGAAGGGGGNGGGNNGGGGGGAAAAAAAAAAAAAAAAAAAAAGGGGGGGNNNGGGGGGGGGGG
eeebbfuuuuuuuuuuuuuuuuuufgggvuuupjjufbbbzzzzzbbbzzzzRRAAANNNNNNaNNGGGGGGaGNNaNNGGGGGAAAAAAAAAAAAAAAAAAAAAAGGGGNNGGGGNNGGGaGGGGGG
eebbbfuufffftfffffftffffffgffffupjppfbbbbzzzzbbbzzzzRRAAANNONNGGGGGGGGGGGGNNNNGGGGGAAAAAAAAAAAAAAAAAAAAAAAGGGGGNNaGGGNNNGGGGGGGG
ebbbbfuufbfrrrrfbfrrrrfbfigifxfpuuuufbbbbbzzbbbbbzzzRRAAANNNNNGGGGGGGGGGGNNGNGGGGGGAAAAAAAAAAAAAAAAAAAAAAAGGGNNGNNGGGGGNGGGGGGGG
bbbbbfuufbfwrrrfbfwrrrfbfgggBxfffufffbbbbbbzbbbbbzzzRRAAANNNNNGGGGGGGGGGNNGNNGGGGGAAAAAAAAAAAAAAAAAAAAAAAGGGGGNNGNGGGGGGGGGGGGGG
bbbbbfuufbfrrrrfbfrrrrfbfgggBxuuuuuufbbbbbbbbbbbbzzzRRAAANONNNGGGGGGGGaGNGaNGGaGGGAAAAAAAAAAAAAAAAAAAAAAGGGGaGGNNNGaGNGGGGGGGGGG
bbbbbfuufbffffffbffffffbfgggBxuuuquufbbbbbbbbbbbbzzzRRAAANNNNNNGGaGGGNNNNGGNGGGGGGAAAAAAAAAAAAAAAAAAAAAAGGGGGGGNNNGGNNGGGGGGGGGG
bbbbbfuufbbbbbbbbbbbbbbbfgggBxuuuuuufbbbbbbbbbbbbzzzzRDAANNNNGNNGGNNNNGGNNNNGGGGGGAAAAAAAAAAAAAAAAAAAAAGGGGGGGNNGNGNNGGGaGGGaGGG
bbbbbfuufbffffffbffffffbfgggBxuuuuuufbbbbbbbbbbbbzzzzRDAANNNNGGNNNNGGGGGGNNGGGGGGGGAAAAAAAAAAAAAAAAAAAGGGGGGGGNGGGGNGGGGGGGGGGGG
bbbbbfuufbfrrrrfbfrrrrfbfgggBxuuuuuufbbbbbbbbbbbbzzzzRDAAGNGGNaGNNNGGGaGGNNGaGGGGGAAAAAAAAAAAAAAAAAAAGGGGGGGGNNGGGGGGGGNNNNNGGGG
bbbbbfuufbfrrrsfbfrrrsfbfgggBxfffufffbbbbbbbbbbbbzzzRRAAAGGGGNNGNGGGGGNNNGNGGGGGGGAAAAAAAAAAAAAAAAAAGGGGGGGGGNGGGGGGaGNNGGGNGGGG
bbbbbfuufbfrrrrfbfrrrrfbfigifxfuuuuufbbbbbbbbbbbbzzzRRAAAGGGGGNGNGGGGGNGGGNNNGGGGGAAAAAAAAAAAAAAAAGGGGGGGaGGGNGGaGGGGGNGGGGGGGGG
bbbbbfuuffffftfffffftfffffgffffuuuuufbbbbbbbbbbbbzzzRRAAAAGGaGNNNGGGGNNNGGGNNNGGNNNNNOGAAAAAAAAAGGGNNNNNNGNNNNGGGGGNNNNGaGGGGGGG
bbbbbfuuuuuuuuuuuuuuuuuuvgggvuuuuuuufbbbbbbbbbbbbzzzRRAAAAGGGGGNNGaGNNNNaGNNNNGGGGNNNNNNGGGAAAGGGGNNGGNNNNNGGNNGGNNNGNNGGGGGGGGG
bbbbbpuuuuuuuuuuuuuuuuuuvgggvuuuuuuufbbbbbbbbbbbbbzzzRDAAAGGGGGGNGGNNNNNNNNGNNNGaGGNNNNNNGGGGGGGGGNGGNNGGGGGNNNNNNGGGGNNGGGGGGGG
bbbbcjpffffftfffffftfffffgggfffuuuuufbbbbbbbbbbbbbbzzRDAAAAGGaGNNGNNNNNGGGGGNNNGGGGGGNNNNNGGGGGGGNNGGNGGGGaGNNNNNGGGGGGNGGGGGGGG
bccbccbbbbfrrrrfbfrrrrfbfgggfbfffffffbbbbbbbbbbbbbbbzRDAAAAAGGGNNGNNNGGGGAAGONNNGGNNNNNGNGGGGGGGNNGaGNGGGGGGNNGGNNGGaGGGGGGaGGGG
becccccbbbfwrrrfbfwrrrfbfgggbbbbbbbbbbbbbbbbbbbbbbbbbRDAAAAAAGGGNNNGGGAAAAAAGNNNNNNNNNNNNNGGGGGGNGGGGGGGGGGGNGGGGGGGGGGGGGGGGGGG
beeccccbbbfrrrrfbfrrrrfbfggbbbbbbbbbbbbbbbbbbbbbbbbbbbDDDAAAAAAGGGGGGAAAAAAAAGNNNNNNGGGNNNGGGGGNNNGGGGGaGGGNNGGaGGGGGGGGGGGGGGGG
beecccccbbffffffbffffffbfgbbbbbbbbbbbbbbbbbbbbbbbbbbbbIDDAAAAAAAAAAAAAAAAAAAAGNNNNGGGGGGNNNGGaGGNNGGGGGGGGNNGGGGGGGGGGGGGGGGGGGG
beeeccccbbbbbbbbbbbbbbbbfbbbbbbbbbbbbbbbbbbbbbbbbbbbbbIIIIIAAAAAAAAAAAAAAAAAAANNNNGGGaGGGNNNGGGNNGGGGGGGGGGGGGGGGGGGGGGGGGGGGGGG
beeeeecccbcccccccccccbbbbbbbbbbbbbbbbbbbbbbbbbbbbbbbbbIIIIIIIAAAAAAAAAAAAAAAAAGNNNNGGGGGGGNNNNNNGGGGGGGGGGGAAAAAAAAAAAAAAGGGGGGA
beeeeeeeeccccccccbccccbbbbbbbbbbbbbbbbbbbbbbbbbbbbbbbbIIIIIIIIIIIIIAAAAAAAAAAAAGGNNGGGGGGGGGGGGGGGGAAAAAAAAAAAAAAAAAAAAAAAAAAAAA
bbeeeeeebbbcccccccccccbbbbbbbbbbbbbbbbbbbbbbbbbbbbbbbbIIIIIIIIIIIIIIIIIIIAAAAAAAAGGGGGGGGGGGGAAAAAAAAAAAAAAAAAAAAAAAAAAAAAAAAAAA
bbbbbbbbbbbbbbbbbbbbbbbbbbbbbbbbbbbbbbbbbbbbbbbbbbbbbbIIIIIIIIIIIIIIIIIIIIIAAAAAAAAAGGGGGAAAAAAAAAAAAAAAAAAAAAAAAAAAAAAAAAAAAAAA
"}
