"a" = (/turf/simulated/floor/chasm,/area/world/lava)
"b" = (/turf/simulated/wall/rock/basalt,/area/world/lava)
"c" = (/turf/simulated/floor/basalt,/area/world/lava)
"d" = (/turf/simulated/floor/lava,/area/world/lava)
"e" = (/turf/simulated/floor/boss,/area/world/lava)
"f" = (/turf/simulated/wall/shuttle,/area/world/lava/lab)
"g" = (/turf/simulated/floor/tile,/area/world/lava/lab)
"h" = (/obj/structure/interactive/lighting/tube{icon_state = "tube"; dir = 1},/turf/simulated/floor/tile,/area/world/lava/lab)
"i" = (/turf/simulated/floor/ash,/area/world/lava)
"j" = (/obj/structure/interactive/lighting/tube,/turf/simulated/floor/ash,/area/world/lava)
"k" = (/obj/structure/interactive/lighting/tube,/turf/simulated/floor/basalt,/area/world/lava)
"l" = (/obj/structure/interactive/door/airlock,/turf/simulated/floor/tile,/area/world/lava/lab)
"m" = (/obj/structure/interactive/lighting/tube,/turf/simulated/floor/tile,/area/world/lava/lab)
"n" = (/obj/structure/interactive/lighting/tube{icon_state = "tube"; dir = 8},/turf/simulated/floor/tile,/area/world/lava/lab)
"o" = (/obj/structure/interactive/lighting/tube{icon_state = "tube"; dir = 4},/turf/simulated/floor/tile,/area/world/lava/lab)
"p" = (/turf/simulated/floor/plating,/area/world/lava/lab)
"q" = (/turf/simulated/floor/ash,/area/world/lava/lab)
"r" = (/turf/simulated/floor/tile/dark,/area/world/lava/lab)
"s" = (/obj/structure/interactive/lighting/tube{icon_state = "tube"; dir = 4},/turf/simulated/floor/tile/dark,/area/world/lava/lab)
"t" = (/obj/structure/interactive/door/airlock,/turf/simulated/floor/tile/dark,/area/world/lava/lab)
"u" = (/turf/simulated/floor/tile/grey,/area/world/lava/lab)
"v" = (/obj/structure/interactive/door/airlock,/turf/simulated/floor/tile/grey,/area/world/lava/lab)
"w" = (/obj/structure/interactive/lighting/tube{icon_state = "tube"; dir = 8},/turf/simulated/floor/tile/dark,/area/world/lava/lab)
"x" = (/turf/simulated/floor/ash,/area/world/lava/safezone)
"y" = (/turf/simulated/floor/basalt,/area/world/lava/safezone)
"z" = (/turf/simulated/wall/rock/basalt,/area/world/lava/safezone)

(1,1,1) = {"
aaaaaaaaaaaaaaaaaaaaaaaaaaaaaaaaaaaaaaaaaaaaaaaaaaaaaaaaaaaaaaaaaaaaaaaaaaaaaaaaaaaaaaaaaaaaaaaaaaaaaaaaaaaaaaaaaaaaaaaaaaaaaaaa
aaaaaaaaaaaaaaaaaaaaaaaaaaaaaaaaaaaaaaaaaaaaaaaaaaaaaaaaaaaaaaaaaaaaaaaaaaaaaaaaaaaaaaaaaaaaaaaaaaaaaaaaaaaaaaaaaaaaaaaaaaaaaaaa
aaaaaaaaaaaaaaaaaaaaaaaaaaaaaaaaaaaaaaaaaaaaaaaaaaaaaaaaaaaaaaaaaaaaaaaaaaaaaaaaaaaaaaaaaaaaaaaaaaaaaaaaaaaaaaaaaaaaaaaaaaaaaaaa
bbbbbbbbbbbbbbbbbbbbbbbbbbbbbbbbbbbbbbbbbbbbbbbbbbbbbbbbbbbbbbbbbbbbbbbbbbbbbbaaaaaaaaaaaaaaaaaaaaaaaaaaaaaaaaaaaaaaaaaaaaaaaaaa
bbbbbbbbbbbbbbbbbbbbbbbbbbbbbbbbbbbbbbbbbbbbbbbbbbbbbbbbbbbbbbbbbbbbbbbbbbbbbcaaacaaaaaaaaaaaaaaaaaaaaaaaaaaaaaaaaaaaaaaaaaaaaaa
bbbbbbbbbbbbbbbbbbbbbbbbbbbbbbbbbbbbbbbbbbbbbbbbbbbbbbbbbbbbbbbbbbbbbbbbbbbbbccaaaaaaaaaaccaaaaaaaaaaaaaaaaaaaaaaaaaaaaaaaaaaaaa
bbbbbbbbbbbbbbbbbbbbbbbbbbbbbbbbbbbbbbbbbbbbbbbbbbbbbbbbbbbbbbbbbbbbbbbbbbbcccccccccccccccccaaaaaaaaaaaaaaaaaaaaaaaaaaaaaaaaaaaa
bbbbbbbbbbbbbbbbbbbbbbbbbbbbbbbbbbbbbbbbbbbbbbbbbbbbbbbbbbbbbbbbbbbbbbbcddcdcccccccccccccccaaaaaacccccaaaaaaaaaaaaaaaaaaaaaaaaaa
bbbbbbbbbbbbbbbbbbbbbbbbbbbbbbbbbbbbbbbbbbbbbbbbbbbbbbbbbbbbbbbbbbbbbddddddddddddddddccccccccccccccccccaaaaaaaaaaaaaaaaaaaaaaaaa
bbbbbbbbbbbbbbbbbbbbbbbbbbbbbbbbbbbbbbbbbbbbbbbbbbbbbbbbbbbbbbbbbbccdddddddddddddddddccccccccccccccccccccaaaaaaaaaaaaaaaaaaaaaaa
bbbbbbbbbbbbbbbbbbbbbbbbbbbbbbbbbbbbbbbbbbbbbbbbbbbbbbbbbbbbbbbbbcdddddddddddddddddddcccccccccccccccccccccaaaaaaaaaaaaaaaaaaaaaa
bbbbbbbbbbbbbbbbbbbbbbbbbbbbbbbbbbbbbbbbbbbbbbbbbbbbbbbbbbbbbcdddddddddddddddddddddddccccccccccccccccccccccaaaaaaaaaaaaaaaaaaaaa
bbbbbbbbbbbbbbbbbbbbbbbbbbbbbbbbbbbbbbbbbbbbbbbbbbbbbbbbdddddddddddddddddddddddddddddcccccccccccccccccccccccaaaaaaaaaaaaaaaaaaaa
bbbbbbbbbbbbbbbbbbbbbbbbbbbbbbbbbbbbbbbbbbbbbbbbbbbbbbddddddddddddddddddddddddddddddccccccccccccccccccccccccaaaaaaaaaaaaaaaaaaaa
bbbbbbbbbbbbbbbbbbbbbbbbbbbbbbbbbbbbbbbbbbbbbbbbbbbbdddddddddddddddddddddddddddddddccccccccccccccccccccccccccaaaaaaaaaaaaaaaaaaa
bbbbbbbbbbbbbbbbbbbbbbbbbbbbbbbbbbbbbbbbbbbbbbbbbbddddddddddddddddddddddddddddddcccccccccccccccccccccccccccccaaaaaaaaaaaaaaaaaaa
bbbbbbbbbbbbbbbbbbbbbbbbbbbbbbbbbbbbbbbbbbbbbbbbdddddddddddddddddddddddddddcccccccccccccccccdddddcccccccccccccaaaaaaaaaaaaaaaaaa
bbbbbbbbbbbbbbbbbbbbbbbbbbbbbbbbbbbbbbbbbbbbdddddddddddddddddddddddddddccccccccccccccccccdddddddddcccccccccccccaaaaaaaaaaaaaaaaa
bbbbbbbbbbbbbbbbbbbbbbbbbbbbbbbbbbbbbbbbbbbdddddddddddddddddddddddddccccccccccccccccccccdddddddddddccccccccccccaaaaaaaaaaaaaaaaa
bbbbbbbbbbbbbbbbbbbbbbbbbbbbbbbbbbbbbbbbbddddddddddddddddddddddddccccccccccccccccccccccddddddccddddcccccccccccccaaaaaaaaaaaaaaaa
bbbbbbbbbbbbbbbbbbbbbbbbbbbbbbbbbbbbbbddddddddddddddddddddddddccccccccccccccccccccccccddddddccccddddddcccccccccccaaaaaaaaaaaaaaa
bbbbbbbbbbbbbbbbbbbbbbbbbbbbbbbbbbbbddddddddddddddddddddddddccccccccccccccccccccccccccdddddccccccddddddccccccccccaaaaaaaaaaaaaaa
bbbbbbbbbbbbbbbbbbbbbbbbbbbbbbbbbbddddddddddddddddddddddddccccccccccccccccccccccccccccdddddcccccccddddddccccccccccaaaaaaaaaaaaaa
bbbbbbbbbbbbbbbbbbbbbbbbbbbbbbbbdddddddddddddddddddddddddccccccccccccccccccccccccccccccddddccccccccddddddcccccccccaaaaaaaaaaaaaa
bbbbbbbbbbbbbbbbbbbbbbbbbbbbbbbbddddddddddddddddddddddddcccccccccccdddcccccccccccccccccdcddccccccccccddddcccccccccaaaaaaaaaaaaaa
bbbbbbbbbbbbbbbbbbbbbdddddddddddddddddddddddddddddddddddcccccccccddddddddccccccccccccccccdddcccccccccddddccccccccccaaaaaaaaaaaaa
bbbbbbbbbbbbbddddddddddddddddddddddddddddddddddddddddddcccccccccdddddddddcccccccccccccccccddccccccccccdddddcccccccccaaaaaaaaaaaa
bbbbbbddddddddddddddddddddddddddddddddddddddddddddddddcccccccccddddddddddcccccccccccccccccccccccccccccdddddccccccccccaaaaaaaaaaa
bbbdddddddddddddddddddddddddddddddddddddddddddddddddddcccccccdddddddddddccccccccddccccccccccccccccccccccdddcccccccccaaaaaaaaaaaa
ddddddddddddddddddddddddddddddddddddddddddddddddddddddcccccccdddddddddddccccccccdddddccccccccccccccccccdddcccccccccccaaaaaaaaaaa
dddddddddddddddddddddddddddddddddddddddddddddddddddddddccccccdddddddddddcccccccccddddddcccccccccccccccddddcccccccccaaaaaaaaaaaaa
eeeeeeeeeeeeeeeeeeeeeeeeeeeeeeeeeeeeeeeeeeeeeeeeeeeeeeeccccccdddddddddddccccccccccddddddccccccccccccccdddcccccccccaaaaaaaaaaaaaa
eeeeeeeeeeeeeeeeeeeeeeeeeeeeeeeeeeeeeeeeeeeeeeeeeeeeeeeccccccddddddddddcccccccccccdddddddccccccccccccdddcccccccccaaaaaaaaaaaaaaa
eeeeeeeeeeeeeeeeeeeeeeeeeeeeeeeeeeeeeeeeeeeeeeeeeeeeeeecccccccdddddddddccccccccccccddddddcccccccccccddddccccccccaaaaaaaaaaaaaaaa
eeeeeeeeeeeeeeeeeeeeeeeeeeeeeeeeeeeeeeeeeeeeeeeeeeeeeeecccccccccddddddccccccccccccccdddddccccccccccdddddccccccaaaaaaaaaacaaaaaaa
eeeeeeeeeeeeeeeeeeeeeeeeeeeeeeeeeeeeeeeeeeeeeeeeeeeeeeecccccccccccccccccccccccccccccccccccccccccccdddddcccccaaaaaaaaaaacccaaaaaa
eeeeeeeeeeeeeeeeeeeeeeeeeeeeeeeeeeeeeeeeeeeeeeeeeeeeeeeccccccccccccccccccccccccccccccccccccccccccdddddcccccaaaaaaaaaaaccccaaaaaa
eeeeeeeeeeeeeeeeeeeeeeeeeeeeeeeeeeeeeeeeeeeeeeeeeeeeeeeccccccccccccccccccccccccccccccccccccccccccddddcccccaaaaaaaaaccccccccaaaaa
dddddddddddddddddddddddddddddddddddddddddddddddddddddddcccccccccccccccccccccccccccccccccccccccccddddcccccaaaaaaaaacccccccccaaaaa
ddddddddddddddddddddddddddddddddddddddddddddddddddddcdccccccccccccccccccccccccccccccccccccccccccccdcccccaaaaaaaaaccccccccccccaaa
bdddddddddddddddddddddddddddddddddddddddddddddddddddcccccccccccccccccccccddddccccccccccccccccccccddcccccaaaaaaaacccccccccccccaaa
bbdddddddddddddddddddddddddddddddddddddddddddccccccccccccccdddccccccccccddddddccccccccccccccccccddccccccaaaaaaacccccccccddcccaaa
bbbdddddddddddddddddddddddddddddddddddddddddccccccccccccccccdddcccccccddddddddcccccccccccccccccccccccccaaaaaaacccccccccdddcccaaa
bbbbbddddddddddddddddddddddddddddddddddddddcccccccccccccccccdddddccccddddddddddcccccdddccccccccccccccccaaaaaaccccccccccdddcccaaa
bbbbbbbdddddddddddddddddddddddddddddddddddcccccccccccccccccccddddcccddddddddddddcccddddddccccccccccccccaaaaaccccccccccddddcccaaa
bbbbbbbbbbdddddddddddddddddddddddddddddddccccccccccccccccccccddddcccddddddddddddcccdddddddcccccccccccccaacaaaccccccccdddddcccaaa
bbbbbbbbbbbddddddddddddddcccccccccccccccdccccccccccccccccccccddddcccddddddddddddcccddddddddcccccccccccccccaaaccccccccddddcccaaaa
bbbbbbbbbbbbdddddddddddcccccccccccccccccccccccccccccccccccccccdddccdddddddddddddccccddddddddccccccccccccccaaacccccccdddddcccaaaa
bbbbbbbbbbbbbdddddddddccccccccccccccccccccccccccccccccddddccccddcccddddddddddddcccccddddddddccccccccccccccaaacccccccddddcccaaaaa
bbbbbbbbbbbbbbdddddddccccccccccddddcccccccccccccccccddddddcccdddcccdddddddddddccccccdddddddddccccccccccccccccccccccdddddcccaaaaa
bbbbbbbbbbbbbbbddddddcccccccccddddddcccccccccccccccddddddbcccdddccddddddddddddcccccccdddddddddcccccccccccccccccccccdddccccaaaaaa
bbbbbbbbbbbbbbbbddddccccccccccdddddddcccccccccccccddddddbbcccdddccddddddddddddcccccccddddddddddccccccccccccccccccccdccccccaaaaaa
bfffffffffffffbbbbdcccccccccdddddddddccccccccccccddddddbbcccdddcccdddddddddddcccccccccdddddddddcccccddddccccccccccccccccccaaaaaa
bfggggghgggggfbbbbdcccccccccddddddddcccccccccccccdddddbbbcccddcccccdddddddddcccccccccccddddddddcccccdddddccccccccccccccccaaaaaaa
bfgggggggggggfbbbbbbccccccccbdddddddddccbcccccccdddddbbbbcccdcccccccdddddddccccccccccccddddddddcccccddddddcccccccccccccccaaaaaaa
bfgggggggggggfbbbbbiicccccccbbcdddddcccbbbccccccddddbbbbbbccccccccccddddddccccccccccccccdddddddcccccdddddddcccccccccccccaaaaaaaa
bfgggggggggggfbbbbbjiiccccckbcccccccccbbbbbcccccdbbbbbbbbbcccccccccccddddccccccccccccccccdddddccccccdddddddccccccccccccaaaaaaaaa
bfgggggggggggfbbbbfflllflllffccccccccbbbbbbbccccbbbbbbbbbbbcccccccccccccccccccccccccccccccdddcccccccddddddddccccccccccaaaaaaaaaa
bfgmgggggggmgfbbbbfgggggggggfbccccccbbbbbbbbcccccbbbbbbdddddcccccccccccccccccccdddccccccccccccccccccddddddddcccccccccaaaaaaaaaaa
bfffffgggfffffbbbbfgggggggggfbbcccbbbbbbbbcddcccccbbbddddddddcccccccccccccccccdddddccccccccccccccccccddddddddcccccccaaaaaaacaaaa
bfgggfgggfgggfbbbbfngggggggofbcccbbbbbbbbbddddcccccbddddddddddcccccddddcccccccdddddddccccccccccccccccddddddddcccccccaaaaaaaaaaaa
bfngglggglggofbbbbfgggggggggfccccbbbbbbbbdddddcccccdddddddddddccccddddddccccddddddddddcccccccccccccccddddddddcccccccaaaaaaaaaaaa
bfgggfgmgfgggfbbbbfgggggggggfcccbbbbbbbbddddddcccccddddddddddccccdddddddcccddddddddddccccccccccccccccdddddddddccccccaaaaaaaaaaaa
bfflffffffflfffffffflllffflffcccbbbbbbbbddddddccccddddddddccccccddddddddccccddddddddccccccccccccccccccddddddddcccccccaaaaaaaaaaa
bfggggggggggggggggggggggfgggfccbbbbbbbbdddddddccccdddddcccccccccddddddddcccccdddddccccccccccccccccccccddddddddcccccccaaaaaaaaaaa
bfnggggggggggggggggggggglgggfccbbbbbbbbdddddddccccdddccccccccccdddddddddcccccccccccccccccccccccccccccccddddddddcccccaaaaaaaaaaaa
bfgggggmggggggmggggggmggfgmgfcbbbbbbbbbddddddccccccccccccccccccdddddddddccccccccccccccccccccccccccccccccdddddddcccccaaaaaaaaaaaa
bflllfffffflfffffffffffffffffbbbbbbbbbdddddddccccccccccccccccccddddddddccccccccccccccccccddddccccccccccccddddddcccccaaaaaaaaaaaa
bfgggfggggggggfbbbbbbbbbbbbbbbbbbbbbbbdddddddccccccddccdccccccddddddddccccccccccccccccccddddddcccccccccccccccccccccccaaaaaaaaaaa
bfgggfggggggggfbbbbbbbbbbbbbbbbbbbbbbbbddddddcccccdddddddcccccdddddddccccccccddcddccccccdddddddccccccccccccccccccccccccaaaaaaaaa
bfggofnggggggofbbbbbbbbbbbbbbbbbbbbbbbbdddddccccccdddddddccccddddddcccccccccddddddccccccddddddddcccccccccccccccccccccccaaaaaaaaa
bfgggfggggggggfbbbbbbbbbbbbbbbbbbbbbbbbbddddccccccdddddddcccccddddcccccccddddddddcccccccddddddddccccccccccccccccccccccccaaaaaaaa
bfgggfggggggggfbbbffffffffbbbbbbbbbbbbbbdddcccccccdddddddccccccccccccccccddddddddcccccccdddddddddccccccccdccccccccccccccaaaaaaaa
bfgggffffffffffbbbfggggggfbbbbbbbbbbbbbbbcccccccccddddddddccccccccccccccdddddddddccccccccddddddddcccccdddddddccccccccccccaaaaaaa
bfgggfbbbbbbbbbbbbfnggggofbbbbbbbbbbbbbbbbcccccccdddddddddccccccccccccccdddddddddccccccccccddddddccccccdddddddcccccccccccaaaaaaa
bfgggfbbbbbbbbbbbbfggggggfbbbbbbbbbbbbbbbbbccccccddddddddddddcccccccccccddddddddcccccccccccccddddccccccdddddddddccccccccccaaaaac
bfnggffffffffffffffflfffffffffffffffffffffbccccccdddddddddddddccccccccddddddddddccccccccccccccccccccccccdddddddddccccccccccaaaac
bfggglgggggggggggggggggghggghggggggggggggfbbcccccddddddddddddddccccccddddddddddcccccdddccccccccccccccccccdddddddddcccccccccaaaaa
bfggglgggggggggggggggggggggggggggggggggggfbbcccccddddddddddddddccccccddddddddddcccccddddcccccccccccccccccddddddddddccccccccaaaaa
bfggglggggggmggggggggggggggggggggggggggggfbbbccccdddddddddddddddccccccddddddccccccccddddccccccccccccccccccdddddddddccccccccaaaaa
bfnggfflffffffffffffffffflllfffflfffffgggfbbbcccccddddddddddddddcccccccdddddccccccccddddddccccccccccccccccddddddddddccccccaaaaaa
bfgggfggggggfgggggggggggfgggfbfggggggfgggfbbbcccccdddddddddddddddcccccccdddcccccccccddddddccccccccccccccccddddddddddccccccaaaaaa
bfgggfgggggglgggggggggggfgggfbfggggggfgggfbbbbbccdddddddddddddddddccccccccccccccccccddddddcccccccccccccccccddddddddddcccccaaaaaa
bfgggfggggggfgggggggggggfgggfbfggggggfgggfbbbbcccddddddddddddddddddcccccccccccccccccddddddcccccccccccccccccddddddddddcccccaaaaaa
bfgggfnggggofgggggggggggfgggfbffffffffgggfbbbbbcddddddddddddddddddddccccccccccccccccddddddcccccccccccccccccddddddddddcccccaaaaaa
bfgggfgggggglgggggggggggfgggfbbbbbbbbfgggfbbbbbcddddddddddddddddddddcccccccccccccccccdddddcccccccccccccccccddddddddddccccaaaaaaa
bfggofgggggglgggggggggggfgggfbbbbbbbbfgggfbbbbbcddddddddddddddddddddcccccccccccccccccddddcccccccccccccccccccdddddddddccccaaaaaaa
bfgggfggggggfgggggggggggfgggfbbbbbbbbfgggfbbbbbbddddddddddddddddddddcccccddddccccccccbbbbbbcccccdddcccccccccddddddddccccccaaaaaa
bfgggffffffffgggggggggggfgggfbbbbbbbbfgggfcbbbbbdddddddddddddddddddcccccddddddcccccccbbbbbbcccccddddccccccccdddddddcccccccaaaaaa
bfgggfggggggfgggggggggggfgggfbbbbbbbbfgggfcbbbbbdddddddddddddddddddcccccddddddddcccccccbbcccbbcddddddcccccccddddddccccccccaaaaaa
bfgggfnggggglgggggggggggfgggfbbbbbbbbfflffcccbbbbdddddddddddddddddcccccccddddddddbbbbccccccbbbdddddddcccccccdddddcccccccccaaaaaa
bfgggfggggggfgggggggggggfgggfbbbbbbbbcccccccccbbbdddddddddddddddddccccccdddddddddbbbbbbcccbbbbdddddddcccccccddddcccccccccccaaaaa
bfgggffffffffffffffffffffgggfbbbbbbbcccccccccccbddddddddddddddddddcccccccccdddddbbbbbbbcccbbbbdddddddccccccccddccccccccccccaaaaa
bfggplgggggghggggggggggghgggfbbbbbbbccccccccccccdddddddddddddddddcccccccccccdddbbbbbbbccccbbbbddddddccccccccccccccccccccccaaaaaa
bfggglggggggggggggggggggggggfbbbbbbccccccccccccddddddddddddddddddcccccccccccccbbbbbcccccccbbbbbdddddccccccccccccccccccccccaaaaaa
bfpgglmgggggggggggmgggggggggfbbbbbccccccccccccdddddddddddddddddddccccccccccccccccccccccccccbbbbddddccccccccccccccccccccccccaaaaa
bfgqgfffffffffffffffffffflllfbbbbbccccccccccccddddddddddddddddddccccccccccccccccccccccccccccbbbbbdcccccccccccccccccccccccccaaaaa
bfppgfbbbbbbbbbbbbbbbbbbfgggfbbbbccccccccccccddddddddddddddddddccccccddccccccccccccccccccccccccbbccccccccccccccccccccccccccaaaaa
bbqppfbbbbffffffbffffffbfgggfbbbcccccccccccccddddddddddddddddccccccddddddccccccccbbbbbbbbccccccccccccccccccccccccccccccccccaaaaa
bbbqpbbbbbfrrrrfbfrrrrfbfgggfbbbbcccccccccccdddddddddddddddddccccddddddddccccccccdbbbbbbbbcccccccccccccccccccccccccccccccccaaaaa
bbbbqbbbbbfrrrsfbfrrrsfbfgggfbbbbbcccccccccddddddddddddddddddccccdddddddcccccccccdddbbbbbbbccccbbbcccccccccccccccccccccccccaaaaa
bbbbbbbbbbfrrrrfbfrrrrfbfgggfbfffffffcccccdddddddddddddddddddccccddddddccccccccccddddbbbbbbccbbbbbdddccccccccccccccccccccccaaaaa
bbbbbfffffffftfffffftffffgggfffuuuuufccbbddddddddddccccdddddddccccddddcccccccccccdddddbbbbbbbbbbdddddddcccccccccccccccccccccaaaa
bbbbbfuuuuuuuuuuuuuuuuuuvgggvuuuuuuufbbbddddddddddccccccdddddddcccccccccccccccccccdddddbbbbbbbbdddddddccccccccccccccccccccccaaaa
bbbbbfuuuuuuuuuuuuuuuuuuvgggvuuuuuuufbbbddddddddddcccccccdddddddcccccccccccccccccccddddbbbbbbbddddddddccccccccccccccccccccccaaaa
bbbbbfuufffftfffffftfffffgggfffuuuuufbbbbdddddddddcccccccdddddddccccccccccccccccccccddddbbbbbcddddddddcccccccccccccccccccccccaaa
bbbbbfuufbfrrrrfbfrrrrfbfgggfbfuuuuufbbbbbddddddddccccccccddddddcccccccccccccccccccccdddccccccdddddddccccccccddcccccccccccccaaaa
bbbbbfuufbfwrrrfbfwrrrfbfgggfbfuuuuufbbbbbbddddddddccccccccdddddccccccccddddccccccccccccccccccccddddccccccccddddccccccccccccaaaa
bbbbbfuufbfrrrrfbfrrrrfbfgggfbfuuuuufbbbbbbbdddddddcccccccccdddddcccccddddddddccccccccccccccccccccccccccccddddddcccccccccccccaaa
bbbbbfuufbffffffbffffffbfgggfbfuuuuufbbbbbbbddddddddccccccccccdddccccdddddddddcccccccccccccccccccccccccccdddddddcccccccccccccaaa
bbbbbfuufbbbbbbbbbbbbbbbfgggfbfuuuuufbbbbbbbbddddddddcccccccccccccccddddddddddcccccccccccccccccccccccccccdddddddcccccccccccccaaa
bbbbbfuufbffffffbffffffbfgggfbfuuuuufbbbbbbbbdddddddddcccccccccccccddddddddddcccccccccccbbbbbbbcccccccccddddddddcccccccccccccaaa
bbbbbfuufbfrrrrfbfrrrrfbfgggfbfuuuuufbbbbbbbbbddddddddcccccccccccccddddddddcccccccccccbbbbbbbbbccccccccdddddddddcccccccccccccaaa
bbbbbfuufbfrrrsfbfrrrsfbfgggfbfuuuuufbbbbbbbbbbddddddddccccccccccccdddcccccccccccccbbbbbbbbbbbbbcccccccddddddddcccccccccccccccaa
bbbbbfuufbfrrrrfbfrrrrfbfgggfbfuuuuufbbbbbbbbbbbbdddddddcccccccccccccccccccbbbccccbbbbbbbbbbbbbbccccccccddddddccccccccccccccccaa
bbbbbfuuffffftfffffftffffgggfffuuuuufbbbbbbbbbbbbddddddddcccccccccccbbbbbbbbbbbccbbbbxxxxxxxbbbbcccccccccddddcccccccccccccccccaa
bbbbbfuuuuuuuuuuuuuuuuuuvgggvuuuuuuufbbbbbbbbbbbbbddddddddccccccbbbbbbbbbbbbbbbbbbbxxxxxxxxxxbbbcccccccccddccccccccccccccccccaaa
bbbbbfuuuuuuuuuuuuuuuuuuvgggvuuuuuuufbbbbbbbbbbbbbbdddddddddcccbbbbbbbbbbxxxxbbbbbxxxxxxxxxxxbbbbccccccccccccccccccccccccccccaaa
bbbbbffffffftfffffftfffffgggfffuuuuufbbbbbbbbbbbbbbbbdddddddddbbbbbbbbbbxxxxxxxbbxxxxxxxxxxxxxxxxcccccccccccccccccccccccccccaaaa
bbbbbbbbbbfrrrrfbfrrrrfbfgggfbfffffffbbbbbbbbbbbbbbbbbbddddddbbbbbbbbbbbxxxxxxxxxxxxxxxxxxxxxxxxxcccccccccccccccccccccccccccaaaa
bbbbbbbbbbfwrrrfbfwrrrfbfgggbbbbbbbbbbbbbbbbbbbbbbbbbbbbbdbdbbbbbbbbbbbxxxxxxxxxyxxxxxxxxxxxxxxxxcccccccccccccccccccccccccaaaaaa
bbbbbbbbbbfrrrrfbfrrrrfbfggbbbbbbbbbbbbbbbbbbbbbbbbbbbbbbbbbbbbbbbbbbbxxxxxxxxyyyxxxxxxxxxxxxbbbbcccccccccccccccccccccccaaaaaaaa
bbbbbbbbbbffffffbffffffbfgbbbbbbbbbbbbbbbbbbbbbbbbbbbbbbbbbbbbbbbbbbyyyxxxxxyyyyyyyyxxxxxbbbbbbbbcccccccccccccccbcccaaaaaaaaaaaa
bbbbbbbbbbbbbbbbbbbbbbbbfbbbbbbbbbbbbbbbbbbbbbbbbbbbbbbbbbbbbbbbbyyyyyyyyyyyyyyyyyyyyyyyybbbbbbbcccccccccccccbbbbbaaaaaaaaaaaaaa
bbbbbbbbbbbbbbbbbbbbbbbbbbbbbbbbbbbbbbbbbbbbbbbbbbbbbbbbbbbbbbbbbyyyyyyyyyyyyyyyyyyyyyyyyybbbbcbcccccccccccbbbbbbaaaaaaaaaaaaaaa
bbbbbbbbbbbbbbbbbbbbbbbbbbbbbbbbbbbbbbbbbbbbbbbbbbbbbbbbbbbbbbbbyyzyyyyyyyyyyyyyyyyyyyyyyyybbbbccccccccccbbbbbbaaaaaaaaaaaaaaaaa
bbbbbbbbbbbbbbbbbbbbbbbbbbbbbbbbbbbbbbbbbbbbbbbbbbbbbbbbbbbbbbbbbyyybbbbzyyyyyyyyyyyyyyyyyyybbbbcbbbbbbbbbbbbbbaaaaaaaaaaaaaaaaa
bbbbbbbbbbbbbbbbbbbbbbbbbbbbbbbbbbbbbbbbbbbbbbbbbbbbbbbbbbbbbbbbbbbbbbbbbbbbbbbbbbbbyyyyyzbbbbbbbbbbbbbbbbbbaaaaaaaaaaaaaaaaaaaa
"}
