"a" = (/turf/simulated/wall/boss,/area/world/clown_planet/exterior)
"b" = (/turf/simulated/floor/colored/mint_grass,/area/world/clown_planet/exterior)
"c" = (/turf/simulated/floor/candy,/area/world/clown_planet/exterior)
"d" = (/turf/simulated/floor/colored/dirt/cake,/area/world/clown_planet/exterior)
"e" = (/turf/simulated/floor/river/chocolate,/area/world/clown_planet/exterior)
"f" = (/obj/structure/scenery/lolipops,/turf/simulated/floor/colored/dirt/cake,/area/world/clown_planet/exterior)
"g" = (/turf/simulated/floor/icing,/area/world/clown_planet/exterior)
"h" = (/obj/structure/interactive/lighting/gumdrop{icon_state = "gumdrop"; dir = 4},/turf/simulated/floor/colored/mint_grass,/area/world/clown_planet/exterior)
"i" = (/obj/structure/interactive/lighting/gumdrop{icon_state = "gumdrop"; dir = 8},/turf/simulated/floor/colored/mint_grass,/area/world/clown_planet/exterior)
"j" = (/obj/structure/scenery/lolipops,/turf/simulated/floor/colored/mint_grass,/area/world/clown_planet/exterior)
"k" = (/turf/simulated/floor/colored/ash/necro,/area/world/clown_planet/exterior)
"l" = (/obj/marker/lobby,/turf/simulated/floor/colored/ash/necro,/area/world/clown_planet/exterior)
"m" = (/mob/living/simple/npc/slime/blue/pure,/turf/simulated/floor/colored/mint_grass,/area/world/clown_planet/exterior)
"n" = (/mob/living/simple/npc/slime/red/pure,/turf/simulated/floor/colored/mint_grass,/area/world/clown_planet/exterior)
"o" = (/mob/living/simple/npc/slime/green/pure,/turf/simulated/floor/colored/mint_grass,/area/world/clown_planet/exterior)
"p" = (/mob/living/simple/npc/slime/cyan/pure,/turf/simulated/floor/colored/mint_grass,/area/world/clown_planet/exterior)
"q" = (/obj/structure/interactive/lighting/gumdrop{icon_state = "gumdrop"; dir = 4},/turf/simulated/floor/colored/dirt/cake,/area/world/clown_planet/exterior)
"r" = (/turf/simulated/floor/candy_cane,/area/world/clown_planet/exterior)
"s" = (/turf/simulated/floor/tile/bananium,/area/world/clown_planet/exterior)
"t" = (/obj/structure/scenery/lolipop_tree,/turf/simulated/floor/colored/mint_grass,/area/world/clown_planet/exterior)
"u" = (/obj/structure/scenery/peppermint,/turf/simulated/floor/candy,/area/world/clown_planet/exterior)
"v" = (/obj/structure/scenery/lolipop_tree,/turf/simulated/floor/colored/dirt/cake,/area/world/clown_planet/exterior)
"w" = (/turf/simulated/wall/bananium,/area/world/clown_planet/exterior)
"x" = (/turf/simulated/floor/carpet,/area/world/clown_planet/exterior)

(1,1,1) = {"
aaaaaaaaaaaaaaaaaaaaaaaaaaaaaawwwwwwwwwwwwwwwwwwwwwwwwwwwwwwwwwwwwwwwwwwwwwwwwwwwwwwwwwwwwaaaaaaaaaaaaaaaaaaaaaaaaaaaaaaaaaaaaaa
aaaaaaaaaaaaaaaaaaaaaaaaaaaaaawswssssssssssssssssswsssswsssssssswsssswssssssssssssssssswswaaaaaaaaaaaaaaaaaaaaaaaaaaaaaaaaaaaaaa
aadddddddddddddddddddddddceeeewsssssssssssssssssssssxxswsxxxxxxswsxxsssssssssssssssssssssweeeecbbbbbbbbbbbbbbbbbbbbbbbbbbbbbbbaa
aaddddddddddddddddddddddcceeeewswssssssssssssssssswsxxswsxxxxxxswsxxswssssssssssssssssswsweeeecbbbbbbbbbbbbbbbbbbbbbbbbbbbbbbbaa
aaddddddddddddddddddddddceeeeewswwwswwwwwswwwwwswwwsxxsssxxxxxxsssxxswwwswwwwwswwwwwswwwsweeeecbbbbbbbbbbbbbbbbbbbbbbbbbbbbbbbaa
aaddddddddddddddddddddddceeeeewswsssswssssssswsssswsxxsssxxxxxxsssxxswsssswssssssswsssswsweeeecbbbbbbbbbbbbbbbbbbbbbbbbbbbbbbbaa
aaddddddddddddddddddddddceeeeewswsxxswsxxxxxswsxxswsxxswsxxxxxxswsxxswsxxswsxxxxxswsxxswsweeeecbbbbbbbbbbbbbbbbbbbbbbbbbbbbbbbaa
aaddddddddddddddddddddddceeeeewswsxxswsxxxxxswsxxswsxxswsxxxxxxswsxxswsxxswsxxxxxswsxxswsweeeecbbbbbbbbbbbbbbbbbbbbbbbbbbbbbbbaa
aaddddddddddddddddddddddceeeeewswsssswssssssswsssswsssswsssssssswsssswsssswssssssswsssswsweeeecbbbbbbbbbbbbbbbbbbbbbbbbbbbbbbbaa
aaddddddddddddddddddddddceeeeewswwwwwwwwwwwwwwwwwwwwwwwwwwwsswwwwwwwwwwwwwwwwwwwwwwwwwwwsweeeecbbbbbbbbbbbbbbbbbbbbbbbbbbbbbbbaa
aaddddddddddddddddddddddceeeeewswssssssssssssssssswjjjjwsssssssswjjjjwssssssssssssssssswsweeeecbbbbbbbbbbbbbbbbbbbbbbbbbbbbbbbaa
aaddddddddddddddddddddddceeeeewswsxxxxxxxxxxxxxxxswjjjjwsxxxxxxswjjjjwsxxxxxxxxxxxxxxxswsweeeecbbbbbbbbbbbbbbbbbbbbbbbbbbbbbbbaa
aaddddddddddddddddddddddceeeeewsssxxxxxxxxxxxxxxxswbbbbwsxxxxxxswbbbbwsxxxxxxxxxxxxxxxsssweeeecbbbbbbbbbbbbbbbbbbbbbbbbbbbbbbbaa
aaddddddddddddddddddddddceeeeewswsxxxxxxxxxxxxxxxswbbbbssxxxxxxssbbbbwsxxxxxxxxxxxxxxxswsweeeecbbbbbbbbbbbbbbbbbbbbbbbbbbbbbbbaa
aaddddddddddddddddddddddcceeeewswssssssssssssssssswbbbbssxxxxxxssbbbbwssssssssssssssssswsweeeecbbbbbbbbbbbbbbbbbbbbbbbbbbbbbbbaa
aadddddddddddddddddddddddceeeewswwwwssswwwwwwwwwwwwbbbbwsxxxxxxswbbbbwwwwwwwwwwwwssswwwwsweeeecbbbbbbbbbbbbbbbbbbbbbbbbbbbbbbbaa
aadddddddddddddddddddddddceeeewswssssssssswjjceecjjbbbbwsxxxxxxswbbbbjjceecjjwssssssssswsweeeecbbbbbbbbbbbbbbbbbbbbbbbbbbbbbbbaa
aadddddddddddddddddddddddceeeewswsxxxxxxxswjjceecjjbbbbwsssssssswbbbbjjceecjjwsxxxxxxxswsweeeecbbbbbbbbbbbbbbbbbbbbbbbbbbbbbbbaa
aaddddddddddddddddddddddcceeeewswsxxxxxxxswjjceecjjbbbbwwwwbbwwwwbbbbjjceecjjwsxxxxxxxswsweeeecbbbbbbbbbbbbbbbbbbbbbbbbbbbbbbbaa
aaddddddddddddddddddddddceeeeewswsxxxxxxxswbbueeubbbbbbttttbbttttbbbbbbueeubbwsxxxxxxxswsweeeecbbbbbbbbbbbbbbbbbbbbbbbbbbbbbbbaa
aaddddddddddddddddddddddceeeeewswsxxxxxxxsbbbrrrrbbbbbbbbbbbbbbbbbbbbbbrrrrbbssxxxxxxxswsweeeecbbbbbbbbbbbbbbbbbbbbbbbbbbbbbbbaa
aaddddddddddddddddddddddceeeeewswsxxxxxxxsbbbrrrrbbbbbbbbbbbbbbbbbbbbbbrrrrbbssxxxxxxxswsweeeecbbbbbbbbbbbbbbbbbbbbbbbbbbbbbbbaa
aaddddddddfffdddddddddddceeeeewswsxxxxxxxswbbueeubbbbbbbbbbbbbbbbbbbbbbueeubbwsxxxxxxxswsweeeecbbbbbbbbbbbbbbbbbbbbbbbbbbbbbbbaa
aaddddddfffffdddddddddddceeeeewswsxxxxxxxswjjceecjjbbbbbbbbbbbbbbbbbbjjceecjjwsxxxxxxxswsweeeecbbbbbbbbbbbbbbbbbbbbbbbbbbbbbbbaa
aadddddfffffdddddddggdddceeeeewswssssssssswjjceecjjbbbbbbbbbbbbbbbbbbjjceecjjwssssssssswsweeeeccbbbbbbbbbbbbbbbbbbbbbbbbbbbbbbaa
aaddddffffffddddgggggdddceeeewwswwsssssssswjjceecjjwwswwwbbwwbbwwwswwjjceecjjwsssssssswwswweeeecbbbbbbbbbbbbbbbbbbbbbbbbbbbbbbaa
aadddffffffddddgggggddddceeeewssswwwwwwwwwwwwwwwwwwwssswjbbbbbbjwssswwwwwwwwwwwwwwwwwwwsssweeeecbbbbbbbbbbbbbbbbbbbbbbbbbbbbbbaa
aaddffffffdvddgggggdddddcceeewssssssssssssssssssssssssswjbbbbbbjwsssssssssssssssssssssssssweeeecbbbbbbbbbbbbbbbbbbbbbbbbbbbbbbaa
aaddfffffddddggggddddddddceeewssswwwwwwwwwwwwwwwwwwwssswjbbbbbbjwssswwwwwwwwwwwwwwwwwwwsssweeeecbbbbbbbbbbbbbbbbbbbbbbbbbbbbbbaa
aaddddddddddgggggdvddddddceeewwwwweeeeeeeeeeeeeeeeewwwwwcurrrrucwwwwweeeeeeeeeeeeeeeeewwwwweeeecbbbbbbbbbbbbbbbbbbbbbbbbbbbbbbaa
aadddddddddggggggddddddddceeeeeeeeeeeeeeeeeeeeeeeeeeeeeeeerrrreeeeeeeeeeeeeeeeeeeeeeeeeeeeeeeeecbbbbbbbbbbbbbbbbbbbbbbbbbbbbbbaa
aaddddddddggggggdddddddddceeeeeeeeeeeeeeeeeeeeeeeeeeeeeeeerrrreeeeeeeeeeeeeeeeeeeeeeeeeeeeeeeeecbbbbbbbbbbbbbbbbbbbbbbbbbbbbbbaa
aaddddddddgggggddddddddddccccccccccccccccccceeeeeeeeeeeeeerrrreeeeeeeeeeeeeeeeeccccccceeeeeeeeccbbbbbbbbbbbbbbbbbbbbbbbbbbbbbbaa
aaddddddddggggdddddddddddddffffffddddddddddcceeeeeeeeeeeeerrrreeecccccccccccccccbbbbbccccccccccbbbbbbbbbbbbbbbbbbbbbbbbbbbbbbbaa
aadddddvdggggdddddddddfffffffffffffdddddddddceeeeeeeeccccurrrrucccbbbbbbbbbbbbbbbbbbbbbbbbbbbbbbbbbbbbbbbbbbbbbbbbbbbbbbbbbbbbaa
aaddddddgggggddddddffffffffffffffffdddddddddceeeeeeeccbbtbbbbbbbbbjjjjjbbbbbbbbbbbbbbbbbbbbbbbbbbbbbbbbbbbbbbbbbbbbbbbbbbbbbbbaa
aaddddddgggggdvdddffffffffffffffffffddddddddcceeeeeccbbjjjbbbbbbjjjjjjjjbbbbbbbbbbbbbbbbbbbbbbbbbbbbbbbbbbbbbbbbbbbbbbbbbbbbbbaa
aaddddddgggggddddfffffffffffffffffffdddddddddceeeeccbjjjjjbbbbbtjjjjjjjjjbbbbbbbbbbbbbbbbbbbbbbbbbbbbbbbbbbbbbbbbbbbbbbbbbbbbbaa
aadddddgggggdddfffffffffffffffffffffdddddddddceeeecbbjjjjjbbbbbbbjjjjjjjjjbbbbbbbbbbbbbbbbbbbbbbbbbbbbbbbbbbbbbbbbbbbbbbbbbbbbaa
aadddddgggggdddfffffffffffffffffffffdddddddddceeeecbbjjjjbbbbbbbbbbjjjjjjjbbmbbbbbbbbbbbbbbbbbbbbbbbbbbbbbbbbbbbbbbbbbbbbbbbbbaa
aaddddddgggdddddffffffffffffffffffffdddddddddceeeecccbjbbbbbbbbbbbbbjjjjjjjbbbbbbbbbbbbbbbbbbbbbbbbbbbbbbbbbbbbbbbbbbbbbbbbbbbaa
aadddddggggdddddffffffffffffffffffffdddddddddcceeeeecbbbbbbbbbbbbbbbbbjjjjbbbbbbbbbbbbbbbbbbbbbbbbbbbbbbbbbbbbbbbbbbbbbbbbbbbbaa
aaddddvdgggdddddddfffffffffffffffffdddddddddddceeeeecbtbbbbbbbbbbbbbbtbjjbbbbbbbbbbbbbbbbbbbbbbbbbbbbbbbbbbbbbbbbbbbbbbbbbbbbbaa
aaddddddggggdddddddddfffffffffffffddddddddddddceeeeeccbbbbbbbbbbbbbbbbbbbbbbbbbbbbbbnbbbbbbbbbbbbbbbbbbbbbbbbbbbbbbbbbbbbbbbbbaa
aadddddddggggdddddddddddfffffffffdddddddddddddcceeeeecbbbbbbbbbbbbbbbbbbbbbbbbbbbbbbbbbbbbbbbbbbbbbbbbbbbbbbbbbbbbbbbbbbbbbbbbaa
aaddddddddgggggdvddddddddddddddddddddddddddddddceeeeecbbbbbbbbbbbbbbbbbbbbbbbbbbbbbbbbbbbbbbbbbbbbbbbbbbbbbbbbbbbbbbbbbbbbbbbbaa
aadddddddddgggggdddddddddddddddddddddddddddddddcceeeecbbbbbbbbbbbbbbbbbbbbbbbbbbbbbbbbbbbbbbbbbbbbbbbbbbbbbbbbbbbbbbbbbbbbbbbbaa
aaddddddddddggggggggggggggggggggddddddddddddddddceeeecbbbbbbbobbbbbbbbbbtbbbbbbbbbbbbbbbbbbbbbbbbbbbbbbbbbbbbbbbbbbbbbbbbbbbbbaa
aadddddddddvdgggggggggggggggggggggdddvdddfffffddceeeecbbbtbbbbbbbbbbbbbbbbbbbbbbbbbbbbbbbbbbbbbbbbbbbbbbbbbbbbbbbbbbbbbbbbbbbbaa
aadddddddddddddggggggggggggggggggggdddddfffffffdceeeecbbbbbbbbbbbbbbbbbbbbbbbbbbbbbbbbbbbbbbbbbbbbbbbbbbbbbbbbbbbbbbbbbbbbbbbbaa
aadddddddddddddddddddddddddddddgggggddddfffffffdceeeecbbbbbbbbbbbbbbbbbbbbbbbbbbbbbbbbbbbbbbbbbbpbbbbbbbbbbbbbbbbbbbbbbbbbbbbbaa
aaddddddddddddddddddvddddddddvvdgggggdddfffffffdceeeecbbbbbbbbbbbbbbbbbbbbbobbbbbbbbbbbbbbbbbbbbbbbbbbbbbbbbbbbbbbbbbbbbbbbbbbaa
aadddddddddddddddddddddddddddddddggggddddffffffdceeeecbbbbbbtbbbbbbbbbbbbbbbbbbbbbbbbbbbbbbbbbbbbbbbbbbbbbbbbbbbbbbbbbbbbbbbbbaa
aaddddddddddddddddddddddddddffddddgggddddffffffdceeeeccbbbbbbbbbbbbbbbbbbbbbbbbbbbbbbbbbbbbbbbbbbbbbbbbbbbbbbbbbbbbbbbbbbbbbbbaa
aaddddddddddddddddddddddfffffffdddgggggddffffffdceeeeeccbbbbbbbbbbbnbbbbbbbbbbbbbbbbbbbbbbbbbbbbbbbbbbbbbbbbbbbbbbbbbbbbbbbbbbaa
aaddddddddddddddddddddffffffffffdddggggddffffffdcceeeeecbbbbbbbbbbbbbbbbbtbbbbbbbbbbbbbbbbbbbbbbbbbbbbbbbbbbbbbbbbbbbbbbbbbbbbaa
aaddddddddddddddddddfffffffffffffdddggggddffffdddceeeeecbbbbbbbbbbbbbbbbbbbbbbbbbbbbbbbbbbbbbbbbbbbbbbbbbbbbbbbbbbbbbbbbbbbbbbaa
aaddddddddddddddddddffffffffffffffdddgggdddddddddceeeeecbbbbbobbbbbbbbbbbbbbbbbbbbbbbbbbbbbbbbbbbbbbbbbbbbbbbbbbbbbbbbbbbbbbbbaa
aadddddddddddddddddfffffffffffffffdddggggdddddvddceeeecctbbbbbbbbbbbbbbbbbbbbbbbbbbbbbbbpbbbbbbbbbbbbbbbbbbbbbbbbbbbbbbbbbbbbbaa
aadddddddddddddddddffffffffffffffddvddgggddddddddceeeecbbbbbbbbbbbbbbbbbbbbbbbbbbbbbbbbbbbbbbbbbbbbbbbbbbbbbbbbbbbbbbbbbbbbbbbaa
aaddddddddddddddddddffffffffffffdddddggggggggggdqueeeeuibbbbbbbbbbbbbbbbbbbbbpbbbbbbbbbbbbbbbbbbbbbbbbbbbbbbbbbbbbbbbbbbbbbbbbaa
aaddddddddddddddddddddfffffffffddggggggggggggggggrrrrrrbbbbbbbbbbbbbbbbbbbbbbbbbbbbbbbbbbbbbbbbbbbbbbbbbbbbbbbbbbbbbbbbbbbbbbbaa
aadddddddddddddddddddddddffdddddgggggggggggggggggrrrrrrbbbbbbbbbbbbbbbbbbbbbbbbbbbbbbbbbbbbbbbbbbbbbbbbbbbbbbbbbbbbbbbbbbbbbbbaa
aadddddddddddddddddddddddddddggggggggdddddddddddqueeeeuibbbbbbbbbbbbbbbbbbbbbbbbbbbbbbbbbbbbbbbbbbbbbbbbbbbbbbbbbbbbbbbbbbbbbbaa
aaddddddddddddddddddddddddddgggggggdddvddddddddddceeeecbbbbbbbbbbbbbbbbbbbbbbbbbbbbbbbbbbbbbbbbbbbbbbbbbbbbbbbbbbbbbbbbbbbbbbbaa
aadddddddddddddddddddddddddggggggddddddffffddddvdceeeecbbbbbbbpbbbbbbbbbbbbbbbbbbbbbbbbbbbbbbbbbbbbbbbbbbbbbbbbbbbbbbbbbbbbbbbaa
aaddddddddddddddddddddddddvgggggddddddffffffddddcceeeecbbbjjjbbbbbbbbbbbbbbbbbbbbbbbbbbbbbbbbbbbbbbbbbbbbbbbbbbbbbbbbbbbbbbbbbaa
aadddddddddddddddddddddddddgggggdddddffffffffdddceeeeecbbjjjjbbbbbbbbbbbbbbbbbbbbbbbbbbbbbbbbbbbbbbbbbbbbbbbbbbbbbbbbbbbbbbbbbaa
aadddddddddddddddddddddddddggggdddddfffffffffddcceeeeccbbjjjjjbbbbbbbbbbbbbbbbbbbbbbbbbbbbbbbbbbbbbbbbbbbbbbbbbbbbbbbbbbbbbbbbaa
aadddddddddddddddddddddddddggggddvdffffffffffddceeeeecbbbjjjjjbbbbbbbbbbbbbbbbbobbbbbbbbbbbbbbbbbbbbbbbbbbbbbbbbbbbbbbbbbbbbbbaa
aadddddddddddddddddddddddddgggggdddfffffffffddcceeeeecbbjjjjjjbbbbbbbbbbbbbbbbbbbbbbbbbbbbbbbbbbbbbbbbbbbbbbbbbbbbbbbbbbbbbbbbaa
aadddddddddddddddddddddddddgggggdddfffffffffdcceeeeeccbbjjjjjbbbbbbbbbbbbbbbbbbbbbbbbbbbbbbbbbbbbbbbbbbbbbbbbbbbbbbbbbbbbbbbbbaa
aaddddddddddddddddddddddddddgggggdddffffffffdceeeeeecbbbjjjjbbbbbbbbbbbbbbbbbbbbbbbbbbbbbbbbbbbbbbbbbbbbbbbbbbbbbbbbbbbbbbbbbbaa
aadddddddddddddddddddddddddddggggdddfffffffddceeeeeecbbbbjbbbbbbbbbbbbbbbbbbbbbbbbbbbbbbbbbbbbbbbbbbbbbbbbbbbbbbbbbbbbbbbbbbbbaa
aadddddddddddddddddddddddddvddggggdddfffffdddceeeeeecbbbbbbbpbbbbbbbbbbbbbbbbbbbbbbbbbbbbbbbbbbbbbbbbbbbbbbbbbbbbbbbbbbbbbbbbbaa
aaddddddddddddddddddddddddddddggggdvddfffddddceeeeeccbbbbbbbbbbbbbbbbbbbbbbbbbbbbbbbbbbbbbbbbbbbbbbbbbbbbbbbbbbbbbbbbbbbbbbbbbaa
aadddddddddddddddddddddddddddddgggddddddddddcceeeeecbbbbbbbbbbbbbbbbbbbbbbbbbbbbbbbbbbbbbbbbbbbbbbbbbbbbbbbbbbbbbbbbbbbbbbbbbbaa
aaddddddddddddddddddddddddddddddgggdddddddddceeeeeccbbbbbbbbbbbbbbbbbbbbbbbbbbbpbbbbbbbbbbbbbbbbbbbbbbbbbbbbbbbbbbbbbbbbbbbbbbaa
aaddddddddddddddddddddddddddddddgggggdddddddceeeeecbbbbbbbbbbbbbbbbbbbbbbbbbbbbbbbbbbbbbbbbbbbbbbbbbbbbbbbbbbbbbbbbbbbbbbbbbbbaa
aaddddddddddddddddddddddddddddddgggggdddddddceeeeecbbbbbbbbbbbbbbtbbbbbbbbbbbbbbbbbbbbbbbbbbbbbbbbbbbbbbbbbbbbbbbbbbbbbbbbbbbbaa
aaddddddddddddddddddddddddddffddgggggddddddcceeeeecbbbbbbbbbbbbbbbbbbbbbbbbbbbbbbbbbbbbbbbbbbbbbbbbbbbbbbbbbbbbbbbbbbbbbbbbbbbaa
aaddddddddddddddddddddddddffffdvdgggdddddccceeeeeccbbtbbbbbbbbbbbbbbbbbbbbbbbbbbbbbbbbbbbbbbbbbbbbbbbbbbbbbbbbbbbbbbbbbbbbbbbbaa
aadddddddddddddddddddddddfffffdddgggdddddceeeeeeecbbbbbbbbtbbbbbbbbbbbbbbbbbbbbbbbbbbbbbbbbbbbbbbbbbbbbbbbbbbbbbbbbbbbbbbbbbbbaa
aaddddddddddddddddddddddffffffddgggdddddcceeeeeeecbbbbbbbbbbbbbbbmbbbbbbbbbbbbbbbbbbbbbbbbbbbbbbbbbbbbbbbbbbbbbbbbbbbbbbbbbbbbaa
aadddddddddddddddddddddffffffdddgggddvdcceeeeeeeccbbbbbbbbbbbbbbbbbbbbbbbbtbbbbbbbbbbbbbbbbbnbbbbbbbbbbbbbbbbbbbbbbbbbbbbbbbbbaa
aaddddddddddddddddddddffffdfddddggdddddceeeeeeeecbbbbbbbbbbbbbbbbbbbbbbbbbbbbbbbbbbbbbbbbbbbbbbbbbbbbbbbbbbbbbbbbbbbbbbbbbbbbbaa
aadddddddddddddddddddfffffffdddgggddddcceeeeeeeccbbbtbbbbbbbbbbbbbbbbbbbbbbbbbbbbbbbbbbbbbbbbbbbbbbbbbbbbbbbbbbbbbbbbbbbbbbbbbaa
aaddddddddddddddddddffffffddddggggddddceeeeeeeecbbbbbbbbbtbbbbbbbbbbbbtbbbbbbbbbbbbbbbbbbbbbbbbbbbbbbbbbbbbbbbbbbbbbbbbbbbbbbbaa
aadddddddddddddddddfffffddddvdgggdddddceeeeeeeccbbbbbbbbbbbbbbtbbbbbbbbbbbbbbbbbbbbbbbbbbbbbbbbbbbbbbbbbbbbbbbbbbbbbbbbbbbbbbbaa
aadddddddddddddddffffffddddddggggdddddceeeeeeccbbtbmbbbbbbbbbbbbbbbbbbbbbbbtbbbbmbbbbbbbbbbbbbbbbbbbbbbbbbbbbbbbbbbbbbbbbbbbbbaa
aaddddddddddddddffffddddddddggggddddddceeeeeecbbbbbbbbbbbbbbbbbbbbbbbbbbbbbbbbbbbbbbbbbbbbbbbbbbbbbbbbbbbbbbbbbbbbbbbbbbbbbbbbaa
aadddddddddddddddffddvddgggggggdddddddceeeeeecbbbbbbbbbtbbbbbbbbbbtbbbbbbbbbbbbbbbbbbbbbbbbbbbbbbbbbbbbbbbbbbbbbbbbbbbbbbbbbbbaa
aaddddddddddddddddddddggggggggddddddddceeeeeecbbbbbbbbbbbbbbbbbnbbbbbbbbbbbbbbbbbbbbbbbbbbbbbbbbbbbbbbbbbbbbbbbbbbbbbbbbbbbbbbaa
aadddddddddddddddddggggggggdddddvfffddcceeeeecbbbbbbbbbbbbbbbbbbmbbbbbbbbbbbbbbbbbbbbbbbbbbbbbbbbbbbbbbbbbbbbbbbbbbbbbbbbbbbbbaa
aadddddddddddddddggggggdddddddddffffdddceeeeecbbbbtbbbbbbbbbbbbbbbbbbbbbbtbbbbbbbbbbbbbbbbbbbbbbbbbbbbbbbbbbbbbbbbbbbbbbbbbbbbaa
aaddddddddddddddgggggddddddddddffffffddceeeeecbbtbbbbbbbbbbbbbbbbbbbbbbbbbbbbbtbbbbbbbbbbbbbbbbbbbbbbbbbbbbbbbbbbbbbbbbbbbbbbbaa
aadddddddddddddggggdddddvdddddfffffffddceeeeecbbbbbtbbbbbbbbbbbbbbbbbbbbbbbbbbbbbbbbbbbbbbbbbbbbbbbbbbbbbbbbbbbbbbbbbbbbbbbbbbaa
aadddddddddddddgggdddddddddddffffffffddcceeeecbbbbbjjjbbtbbbbbbbbbbbbtbbbbbbbbbbbbbbbbbbbbbbbbbbbbbbbbbbbbbbbbbbbbbbbbbbbbbbbbaa
aaddddddddddddgggdddddffddddffffffffddddceeeecbbbbjjjjjbbbbbbtbbbbbbbbbbbbbbbbbbbbbbbbbbbbbbbbbbbbbbbbbbbbbbbbbbbbbbbbbbbbbbbbaa
aaddddddddddddggdddddffffddffffffffdddddceeeecbbtbjjjjjjbbbbbbbbbbbbbbbbbbtbbbbbbbbbbbbbbbbbbbbbbbbbbbbbbbbbbbbbbbbbbbbbbbbbbbaa
aaddddddddddvdggggddfffffdddfffffddddddcceeeecbbbbbjjjjjjbbbbbbbbbbbbbjjbbbbbbbbbbbbbbbbbbbbbbbbbbbbbbbbbbbbbbbbbbbbbbbbbbbbbbaa
aaddddddddddddggggddfffffddddddddddddddceeeeecbbbbmjjjjjjbbtbbbbbbtbbjjjjbbbbbbtbbbbbbbbbbbbbbbbbbbbbbbbbbbbbbbbbbbbbbbbbbbbbbaa
aadddddddddddggggddfffffdddddddddddddccceeeeecbbbbbjjjjjjbbbbbbbbbbbbjjjjjbbbbbbbbbbbbbbbbbbbbbbbbbbbbbbbbbbbbbbbbbbbbbbbbbbbbaa
aadddddddddddggggddfffffddddddddddcccceeeeeeecbbbbbjjjjjjbbbbbbbtbbbbjjjjjbbtbbbbbbbbbbbbbbbbbbbbbbbbbbbbbbbbbbbbbbbbbbbbbbbbbaa
aadddddddddddggggddfffddddddddddccceeeeeeeeeecbbbbbjjjjjbbtbbbbbbbbbbbjjjjjbbbbbbbbbbbbbbbbbbbbbbbbbbbbbbbbbbbbbbbbbbbbbbbbbbbaa
aadddddddddddggggdvdddddddddddccceeeeeeeeeeeeccbbbbjjjjjbbcddgddgddbbbjjjjjbbbbbtbbbbbbbbbbbbbbbbbbbbbbbbbbbbbbbbbbbbbbbbbbbbbaa
aadddddddddddggggdddddddddddccceeeeeeeeeeeeeeeccbbbjjjjbbhcddgddgddibbbjjjjbbbbbbbbbbbbbbbbbbbbbbbbbbbbbbbbbbbbbbbbbbbbbbbbbbbaa
aadddddddddddggggddddddddddcceeeeeeeeeeeeeeeeeeccbbbbbbbbbcddgddgddbbbtbjjjbbbbbbbbbbbbbbbbbbbbbbbbbbbbbbbbbbbbbbbbbbbbbbbbbbbaa
aaddddccccccurrrrucccccccccceeeeeeeeeeeeeeeeeeeeccbbbbbtbbcddgddgddbbbbbbbbbbbbbbbbbbbbbbbbbbbbbbbbbbbbbbbbbbbbbbbbbbbbbbbbbbbaa
aadcccceeeeeerrrreeeeeeeeeeeeeeeeeeeeeeeeeeeeeeeeccbbbbbbbcddgddgddbbtbbbbbbbbbtbbbbbbbbbbbbbbbbbbbbbbbbbbbbbbbbbbbbbbbbbbbbbbaa
aacceeeeeeeeerrrreeeeeeeeeeeeeeeeeeeeeeeeeeeeeeeeectbbbbbhcddgddgddibbbbbbbbbbbbbbbbbbbbbbbbbbbbbbbbbbbbbbbbbbbbbbbbbbbbbbbbbbaa
aaeeeeeeeeeeerrrreeeeeeeeeeeeeeeeeeeeeeeeeeeeeeeeecbbbbbbbcddgddgddbbbbbtbbbbbbbbbbbbbbbbbbbbbbbbbbbbbbbbbbbbbbbbbbbbbbbbbbbbbaa
aaeeeeeeeeeeerrrreeeeeeeeeeeeeeeeeeeeeeeeeeeeeeeeecbbbbtbbcddgddgddbbtbbbbbbbbbbbbbbbbbbbbbbbbbbbbbbbbbbbbbbbbbbbbbbbbbbbbbbbbaa
aaeeeeeeeeeeerrrreeeeeeeeeeeeeeeeeeeeeeeeeeeeeeeeecbbbbbbbcddgddgddbbbbbbbbbbbbbbbbbbbbmbbbbbbbbbbbbbbbbbbbbbbbbbbbbbbbbbbbbbbaa
aaeeeeeeeeeeurrrrucccccccceeeeeeeeeeeeeeeeeeeeeeeeccjjjjjhcddgddgddijjjjjjbbbbbbbbbbbbbbbbbbbbbbbbbbbbbbbbbbbbbbbbbbbbbbbbbbbbaa
aaeeeeeeeeeccbbbbbbbbbbbbcceeeeeeeeeeeeeeeeeeeeeeeecjjjjjjcddgddgddjjjjjjjjbbbbbbbbbbbbbbbbbbbbbbbbbbbbbbbbbbbbbbbbbbbbbbbbbbbaa
aaeeeeeeeeecbbbbbbbbbbbbbbcceeeeeeeeeeeeeeeeeeeeeeecjjjjjjbbbbbbbbbjjjjjjjjbbbbbbbbbbbbbbbbbbbbbbbbbbbbbbbbbbbbbbbbbbbbbbbbbbbaa
aaeeeeeeeeccbbbbbbbbbbbbbbbccceeeeeeeeeeeeeeeeeeeeeaaaaaaaakkkkkkkkaaaaaaaabbbbbbbbbbbbbbbbbbbbbbbbbbbbbbbbbbbbbbbbbbbbbbbbbbbaa
aaeeeeeeeccbbbbbbbbbbbbbbbbbbceeeeeeeeeeeeeeeeeeeeeaaaaaaaakkkkkkkkaaaaaaaabbbbbbbbbbbbbbbbbbbbbbbbbbbbbbbbbbbbbbbbbbbbbbbbbbbaa
aaeeeeeeeccbbbbbbbbbbbbbbbbbbceeeeeeeeeeeeeeeeeeeeeaakkkkkkkkkkkkkkkkkkkkaabbbbbbbbbbbbbbbbbbbbbbbbbbbbbbbbbbbbbbbbbbbbbbbbbbbaa
aaeeeeeeeeccbbbbbbbbbbbbbbbbbceeeeeeeeeeeeeeeeeeeeeaakkkkkkkkkkkkkkkkkkkkaabbbbbbbbbbbbbbbbbbbbbbbbbbbbbbbbbbbbbbbbbbbbbbbbbbbaa
aaeeeeeeeeeccbbbbbbbbbbbbbbbcceeeeeeeeeeeeeeeeeeeeeaakkkkkkkkkkkkkkkkkkkkaabbbbbbbbbbbbbbbbbbbbbbbbbbbbbbbbbbbbbbbbbbbbbbbbbbbaa
aaeeeeeeeeeeccbbbbbbbbbbbbbcceeeeeeeeeeeeeeeeeeeeeeaakkkkkkkkklkkkkkkkkkkaabbbbbbbbbbbbbbbbbbbbbbbbbbbbbbbbbbbbbbbbbbbbbbbbbbbaa
aaeeeeeeeeeeeccbbbbbbbbbbccceeeeeeeeeeeeeeeeeeeeeeeaakkkkkkkkkkkkkkkkkkkkaabbbbbbbbbbbbbbbbbbbbbbbbbbbbbbbbbbbbbbbbbbbbbbbbbbbaa
aaeeeeeeeeeeeecccccccccccceeeeeeeeeeeeeeeeeeeeeeeeeaakkkkkkkkkkkkkkkkkkkkaabbbbbbbbbbbbbbbbbbbbbbbbbbbbbbbbbbbbbbbbbbbbbbbbbbbaa
aaeeeeeeeeeeeeeeeeeeeeeeeeeeeeeeeeeeeeeeeeeeeeeeeeeaakkkkkkkkkkkkkkkkkkkkaabbbbbbbbbbbbbbbbbbbbbbbbbbbbbbbbbbbbbbbbbbbbbbbbbbbaa
aaaaaaaaaaaaaaaaaaaaaaaaaaaaaaaaaaaaaaaaaaaaaaaaaaaaaaaaakkkkkkkkkkkkaaaaaaaaaaaaaaaaaaaaaaaaaaaaaaaaaaaaaaaaaaaaaaaaaaaaaaaaaaa
aaaaaaaaaaaaaaaaaaaaaaaaaaaaaaaaaaaaaaaaaaaaaaaaaaaaaaaaakkkkkkkkkkkkaaaaaaaaaaaaaaaaaaaaaaaaaaaaaaaaaaaaaaaaaaaaaaaaaaaaaaaaaaa
"}
