"a" = (/turf/simulated/wall/rock,/area/world/desert/exterior)
"b" = (/obj/effect/fake_lighting/solid/black,/turf/simulated/floor/asteroid,/area/world/desert/exterior)
"c" = (/turf/simulated/wall/river,/area/world/desert/exterior)
"d" = (/turf/simulated/floor/asteroid,/area/world/desert/exterior)
"e" = (/obj/effect/fake_lighting/gradient/black,/turf/simulated/floor/asteroid,/area/world/desert/exterior)
"f" = (/turf/simulated/floor/colored/sand/desert,/area/world/desert/exterior)
"g" = (/turf/simulated/wall/brick/sand,/area/world/desert/exterior)
"h" = (/obj/effect/fake_lighting/gradient/black{icon_state = "gradient"; dir = 1},/turf/simulated/floor/colored/sand/desert,/area/world/desert/exterior)
"i" = (/obj/effect/fake_lighting/solid/black,/turf/simulated/floor/colored/sand/desert,/area/world/desert/exterior)
"j" = (/turf/simulated/wall/rock,/area/world/desert/cave)
"k" = (/turf/simulated/floor/asteroid,/area/world/desert/cave)

(1,1,1) = {"
aaaaaaaaaaaaaaaaaaaaaaaaaaaaaaaaaaaaaaaaaaaaaaaaaaaaaaaaaaaaaaaaaaaaaaaaaaaaaaaaaaaaaaaaaaaaaabbbaaaaaaaaaaaaaaaaccccccccccccccc
aaaaaaddaaaaaaaadddaddaaaaddaaaaaaaaaaaaaaaaaaaaaaaaaaaaaaaaaaaaaaaaaaaaaaaaaaaaaaaaaaaaadddaaeeeaadddddaaaaaaaaaccccccccccccccc
adddddddaaaaddddddddddaaaddddaaaaaaddddddaaaaaaaaaaaaaaaaaaaaaaaaaaaaaaaaaaaddddaaaaddaadddddddddddddddddaaaaaaaaccccccccccccccc
aaddddddaaadddddddddddaaaddddaaaadddffffdddddaaaaaddddddddddddddddddddddddddddddaadddaadddddddddddddddddddaaaaaacccccccccccccccc
aadddddaaaaddddddddddddddddddaadddffffffffffddddddddffffffffffffffffffffffdddddddddddaadddddddddddfffddddddaaaaacccccccccccccccc
aaddddaaaaddddddddddddddadddaaadfffffffffffffffffffffffffffffffffffffffffffffdddddddaadddddddddddgggggddddddaaaccccccccccccccccc
aaddddaaaadddddaddddaaadddaaadddfffffffffffffffffffffffffffffffffffffffffffffffddddaaaddddddddddfgfddddddffddacccccccccccccccccc
aaddddaaaddddaaaaddaaadddaaaddffffffffffffffffffffffffffffffffffffffffffffffffffddaaaddddddddddffffddgddfffdddcccccccccccccccccc
aadddddadddddaaaaaaaadddaaaddffffffffffffffffffffffffffffffffffffffffffffffffffffddddddddddddddffgfddgddffffddcccccccccccccccccc
aaaddddaddffddaaaaaaddddaaddffffffffffffffffffffffffffffffffffffffffffffffffffffffddddddddddddddfgdddgddffffddcccccccccccccccccc
aaaaddddddfffddddaaadddaaddffffffffffffffffffffffffffffffffffffffffffffffffffffffffddddddddddddddgggdgddffffddcccccccccccccccccc
aaaaaddddfffffdddddaaaaaddffffffffffffffffffffffffffffffffffffffffffffffffffffffffffdddddddddddddffddddddffdddcccccccccccccccccc
aaaaaddddddddffffddaaaaddffffffffffffffffffffffffffffffffffffffffffffffffffffffffffdddddddddddddddddddddddddddcccccccccccccccccc
aaaaaddaaaaadddffffddaadfffffffffffffffffffffffffffffffffffffffffffffffffffffffffffdaaaadddddddddddddfggggggfdcccccccccccccccccc
aaadddaaaaaadddddfffddddfffffffffffffffffffffffffffffffffffffffffffffffffffffffffffdddaaaadddddddddddfgfffffddcccccccccccccccccc
aaaddddaaaaddddaddfffffffffffffffffffffffffffffffffffffffffffffffffffffffffffffffffffdddaaaaaddddddddffffdddddcccccccccccccccccc
aadddddaaadddddaaadffffffffffffffffffffffffffffffffffffffffffffffffffffffffffffffffffffdddaaaaadddddddgffffdddcccccccccccccccccc
aaaddddaaaddddaaaaaddffffffffffffffffffffffffffffffffffffffffffffffffffffffffffffffffffffdddaaaaaaaaddgggggdddcccccccccccccccccc
aaaadaaaaddddaaaaaaddffffffffffffffffffffffffffffffffffffffffffffffffffffffffffffffffffffffdddaaaaaaadddddddddcccccccccccccccccc
aaaaaaaadddddaaaaaddffffffffffffffffffffffffffffffffffffffffffffffffffffffffffffffffffffffffddddaaaaaaaaadddddcccccccccccccccccc
aaaaddddddddaaaaaddffffffffffffffffffffffffffffffffffffffffffffffffffffffffffffffffffffffffffffddddaaaaaaaaaadcccccccccccccccccc
aaaddddddddaaaadddffffffffffffffffffffffffffffffffffffffffffffffffffffffffffffffffffffffffffffffffddddaaaaaaaacccccccccccccccccc
aaddddddddaaaaddfffffffffffffffffffffffffffffffffffffffffffffffffffffffffffffffffffffffffffffffffffffdddddaaddcccccccccccccccccc
adddddddaaaaaddffffffffffffffffffffffffffffffffffffffffffffffffffffffffffffffffffffffffffffffffffffffffffffffdcccccccccccccccccc
aadddddaaaaaddfffffffffffffffffffffffffffffffffffffffffffffffffffffffffffffffffffffffffffffffffffffffffffffffdcccccccccccccccccc
aaaaaaaaaaaadffffffffffffffffffffffffffffffffffffffffffffffffffffffffffffffffffffffffffffffffffffffffffffffffdcccccccccccccccccc
aaaaaaaaaaaddffffffffffffffffffffffffffffffffffffffffffffffffffffffffffffffffffffffffffffffffffffffffffffffffdcccccccccccccccccc
aaaaaaaaaaadfffffffffffffffffffffffffffffffffffffffffffffffffffffffffffffffffffffffffffffffffffffffffffffffffdcccccccccccccccccc
aaaaaaaaaaadfffffffffffffffffffffffffffffffffffffffffffffffffffffffffffffffffffffffffffffffffffffffffffffffffdcccccccccccccccccc
aaaaaaaaaaddfffffffffffffffffffffffffffffffffffffffffffffffffffffffffffffffffffffffffffffffffffffffffffffffffdcccccccccccccccccc
aaaaaaaaaadffffffffffffffffffffffffffffffffffffffffffffffffffffffffffffffffffffffffffffffffffffffffffffffffffdcccccccccccccccccc
aaaaaaaaaadffffffffffffffffffffffffffffffffffffffffffffffffffffffffffffffffffffffffffffffffffffffffffffffffffdcccccccccccccccccc
aaaaaaaaaddffffffffffffffffffffffffffffffffffffffffffffffffffffffffffffffffffffffffffffffffffffffffffffffffffdcccccccccccccccccc
aaaaaaaaddfffffffffffffffffffffffffffffffffffffffffffffffffffffffffffffffffffffffffffffffffffffffffffffffffffdcccccccccccccccccc
aaaaaaaadffffffffffffffffffffffffffffffffffffffffffffffffffffffffffffffffffffffffffffffffffffffffffffffffffffdcccccccccccccccccc
aaaaaaaddffffffffffffffffffffffffffffffffffffffffffffffffffffffffffffffffffffffffffffffffffffffffffffffffffffdcccccccccccccccccc
aaaaaaadfffffffffffffffffffffffffffffffffffffffffffffffffffffffffffffffffffffffffffffffffffffffffffffffffffffdcccccccccccccccccc
aaaaaaadfffffffffffffffffffffffffffffffffffffffffffffffffffffffffffffffffffffffffffffffffffffffffffffffffffffdcccccccccccccccccc
aaaaaaadfffffffffffffffffffffffffffffffffffffffffffffffffffffffffffffffffffffffffffffffffffffffffffffffffffffdcccccccccccccccccc
aaaaaaadfffffffffffffffffffffffffffffffffffffffffffffffffffffffffffffffffffffffffffffffffffffffffffffffffffffdcccccccccccccccccc
aaaaaaddfffffffffffffffffffffffffffffffffffffffffffffffffffffffffffffffffffffffffffffffffffffffffffffffffffffdcccccccccccccccccc
aaaaaadffffffffffffffffffffffffffffffffffffffffffffffffffffffffffffffffffffffffffffffffffffffffffffffffffffffdcccccccccccccccccc
aaaaaadffffffffffffffffffffffffffffffffffffffffffffffffffffffffffffffffffffffffffffffffffffffffffffffffffffffdcccccccccccccccccc
aaaaaadffffffffffffffffffffffffffffffffffffffffffffffffffffffffffffffffffffffffffffffffffffffffffffffffffffffdcccccccccccccccccc
aaaaaadffffffffffffffffffffffffffffffffffffffffffffffffffffffffffffffffffffffffffffffffffffffffffffffffffffffdcccccccccccccccccc
aaaaaadffffffffffffffffffffffffffffffffffffffffffffffffffffffffffffffffffffffffffffffffffffffffffffffffffffffdcccccccccccccccccc
aaaaaddffffffffffffffffffffffffffffffffffffffffffffffffffffffffffffffffffffffffffffffffffffffffffffffffffffffdcccccccccccccccccc
aaaaadfffffffffffffffffffffffffffffffffffffffffffffffffffffffffffffffffffffffffffffffffffffffffffffffffffffffdcccccccccccccccccc
aaaaadfffffffffffffffffffffffffffffffffffffffffffffffffffffffffffffffffffffffffffffffffffffffffffffffffffffffdcccccccccccccccccc
aaaaadfffffffffffffffffffffffffffffffffffffffffffffffffffffffffffffffffffffffffffffffffffffffffffffffffffffffdcccccccccccccccccc
aaaaadfffffffffffffffffffffffffffffffffffffffffffffffffffffffffffffffffffffffffffffffffffffffffffffffffffffffdcccccccccccccccccc
aaaaddfffffffffffffffffffffffffffffffffffffffffffffffffffffffffffffffffffffffffffffffffffffffffffffffffffffffdcccccccccccccccccc
aaaddffffffffffffffffffffffffffffffffffffffffffffffffffffffffffffffffffffffffffffffffffffffffffffffffffffffffdcccccccccccccccccc
aaddfffffffffffffffffffffffffffffffffffffffffffffffffffffffffffffffffffffffffffffffffffffffffffffffffffffffffdcccccccccccccccccc
aadffffffffffffffffffffffffffffffffffffffffffffffffffffffffffffffffffffffffffffffffffffffffffffffffffffffffffdcccccccccccccccccc
addffffffffffffffffffffffffffffffffffffffffffffffffffffffffffffffffffffffffffffffffffffffffffffffffffffffffffdcccccccccccccccccc
adfffffffffffffffffffffffffffffffffffffffffffffffffffffffffffffffffffffffffffffffffffffffffffffffffffffffffffdcccccccccccccccccc
adfffffffffffffffffffffffffffffffffffffffffffffffffffffffffffffffffffffffffffffffffffffffffffffffffffffffffffdcccccccccccccccccc
adfffffffffffffffffffffffffffffffffffffffffffffffffffffffffffffffffffffffffffffffffffffffffffffffffffffffffffdcccccccccccccccccc
adfffffffffffffffffffffffffffffffffffffffffffffffffffffffffffffffffffffffffffffffffffffffffffffffffffffffffffdcccccccccccccccccc
adfffffffffffffffffffffffffffffffffffffffffffffffffffffffffffffffffffffffffffffffffffffffffffffffffffffffffffdcccccccccccccccccc
adfffffffffffffffffffffffffffffffffffffffffffffffffffffffffffffffffffffffffffffffffffffffffffffffffffffffffffdcccccccccccccccccc
addffffffffffffffffffffffffffffffffffffffffffffffffffffffffffffffffffffffffffffffffffffffffffffffffffffffffffdcccccccccccccccccc
aaddfffffffffffffffffffffffffffffffffffffffffffffffffffffffffffffffffffffffffffffffffffffffffffffffffffffffffdcccccccccccccccccc
aaaddffffffffffffffffffffffffffffffffffffffffffffffffffffffffffffffffffffffffffffffffffffffffffffffffffffffffdcccccccccccccccccc
aaaadffffffffffffffffffffffffffffffffffffffffffffffffffffffffffffffffffffffffffffffffffffffffffffffffffffffffdcccccccccccccccccc
aaaadffffffffffffffffffffffffffffffffffffffffffffffffffffffffffffffffffffffffffffffffffffffffffffffffffffffffdcccccccccccccccccc
aaaadffffffffffffffffffffffffffffffffffffffffffffffffffffffffffffffffffffffffffffffffffffffffffffffffffffffffdcccccccccccccccccc
aaaaddfffffffffffffffffffffffffffffffffffffffffffffffffffffffffffffffffffffffffffffffffffffffffffffffffffffffdcccccccccccccccccc
aaaaadfffffffffffffffffffffffffffffffffffffffffffffffffffffffffffffffffffffffffffffffffffffffffffffffffffffffdcccccccccccccccccc
aaaaddfffffffffffffffffffffffffffffffffffffffffffffffffffffffffffffffffffffffffffffffffffffffffffffffffffffffdcccccccccccccccccc
aaaadffffffffffffffffffffffffffffffffffffffffffffffffffffffffffffffffffffffffffffffffffffffffffffffffffffffffdcccccccccccccccccc
aaaadffffffffffffffffffffffffffffffffffffffffffffffffffffffffffffffffffffffffffffffffffffffffffffffffffffffffdcccccccccccccccccc
aaaadffffffffffffffffffffffffffffffffffffffffffffffffffffffffffffffffffffffffffffffffffffffffffffffffffffffffdcccccccccccccccccc
aaaadffffffffffffffffffffffffffffffffffffffffffffffffffffffffffffffffffffffffffffffffffffffffffffffffffffffffdcccccccccccccccccc
aaaadffffffffffffffffffffffffffffffffffffffffffffffffffffffffffffffffffffffffffffffffffffffffffffffffffffffffdcccccccccccccccccc
aaaddfffffffffffffffffffffffffffffffffffffffffffgggfffffffffgggffffffffffffffffffffffffffffffffffffffffffffffdcccccccccccccccccc
aaddffffffffffffffffffffffffffffffffffffffffffffffggggfffggggffffffffffffffffffffffffffffffffffffffffffffffffdcccccccccccccccccc
aadffffffffffffffffffffffffffffffffffffffffffffffffgfffffffgfffffffffffffffffffffffffffffffffffffffffffffffffdcccccccccccccccccc
addffffffffffffffffffffffffffffffffffffffffffffffffgfgfffgfgfffffffffffffffffffffffffffffffffffffffffffffffffdcccccccccccccccccc
adfffffffffffffffffffffffffffffffffffffffffffffffffgfffffffgfffffffffffffffffffffffffffffffffffffffffffffffffdcccccccccccccccccc
adffffffffffffffffffffffffffffffffffffffffffffffffgggffgffgggffffffffffffffffffffffffffffffffffffffffffffffffdcccccccccccccccccc
adfffffffffffffffffffffffffffffffffffffffffffffffggfggfffggfggfffffffffffffffffffffffffffffffffffffffffffffffdcccccccccccccccccc
adfffffffffffffffffffffffffffffffffffffffffffffffgfffgfffgfffgfffffffffffffffffffffffffffffffffffffffffffffffdcccccccccccccccccc
adfffffffffffffffffffffffffffffffffffffffffffffffgfgfghhhgfgfgfffffffffffffffffffffffffffffffffffffffffffffffdcccccccccccccccccc
addffffffffffffffffffffffffffffffffffffffffffffffgfgfgiiigfgfgfffffffffffffffffffffffffffffffffffffffffffffffdcccccccccccccccccc
aadfffffffffffffffffffffffffffffffffffffffffffffggfgfgggggfgfggffffffffffffffffffffffffffffffffffffffffffffffdcccccccccccccccccc
aadfffffffffffffffffffffffffffffffffffffffffffffgffgfffffffgffgffffffffffffffffffffffffffffffffffffffffffffffdcccccccccccccccccc
aadfffffffffffffffffffffffffffffffffffffffffffffgfgggggggggggfgffffffffffffffffffffffffffffffffffffffffffffffdcccccccccccccccccc
aadfffffffffffffffffffffffffffffffffffffffffffffgfgfffgfffffgfgffffffffffffffffffffffffffffffffffffffffffffffdcccccccccccccccccc
aadfffffffffffffffffffffffffffffffffffffffffffffgfgfgggfgggfgfgffffffffffffffffffffffffffffffffffffffffffffffdcccccccccccccccccc
aadfffffffffffffffffffffffffffffffffffffffffffffgfgfgfffffgfgfgffffffffffffffffffffffffffffffffffffffffffffffdcccccccccccccccccc
aadfffffffffffffffffffffffffffffffffffffffffffffgfgfgfgggfgfgfgffffffffffffffffffffffffffffffffffffffffffffffdcccccccccccccccccc
aaddffffffffffffffffffffffffffffffffffffffffffffgfffgfffffgfffgffffffffffffffffffffffffffffffffffffffffffffffdcccccccccccccccccc
aaadffffffffffffffffffffffffffffffffffffffffffffggggggfffggggggffffffffffffffffffffffffffffffffffffffffffffffdcccccccccccccccccc
aaadfffffffffffffffffffffffffffffffffffffffffffffffffffffffffffffffffffffffffffffffffffffffffffffffffffffffffdcccccccccccccccccc
aaaddffffffffffffffffffffffffffffffffffffffffffffffffffffffffffffffffffffffffffffffffffffffffffffffffffffffffdcccccccccccccccccc
aaaadffffffffffffffffffffffffffffffffffffffffffffffffffffffffffffffffffffffffffffffffffffffffffffffffffffffffdcccccccccccccccccc
aaaadffffffffffffffffffffffffffffffffffffffffffffffffffffffffffffffffffffffffffffffffffffffffffffffffffffffffdcccccccccccccccccc
aaaaddfffffffffffffffffffffffffffffffffffffffffffffffffffffffffffffffffffffffffffffffffffffffffffffffffffffffdcccccccccccccccccc
aaaaaddffffffffffffffffffffffffffffffffffffffffffffffffffffffffffffffffffffffffffffffffffffffffffffffffffffffdcccccccccccccccccc
aaaaaadffffffffffffffffffffffffffffffffffffffffffffffffffffffffffffffffffffffffffffffffffffffffffffffffffffffdcccccccccccccccccc
aaaaaadffffffffffffffffffffffffffffffffffffffffffffffffffffffffffffffffffffffffffffffffffffffffffffffffffffffdcccccccccccccccccc
aaaaaadffffffffffffffffffffffffffffffffffffffffffffffffffffffffffffffffffffffffffffffffffffffffffffffffffffffdcccccccccccccccccc
aaaaaadffffffffffffffffffffffffffffffffffffffffffffffffffffffffffffffffffffffffffffffffffffffffffffffffffffffdcccccccccccccccccc
aaaaaaddfffffffffffffffffffffffffffffffffffffffffffffffffffffffffffffffffffffffffffffffffffffffffffffffffffffdcccccccccccccccccc
aaaaaaaddffffffffffffffffffffffffffffffffffffffffffffffffffffffffffffffffffffffffffffffffffffffffffffffffffffdcccccccccccccccccc
aaaaaaaadffffffffffffffffffffffffffffffffffffffffffffffffffffffffffffffffffffffffffffffffffffffffffffffffffffdcccccccccccccccccc
aaaaaaaadffffffffffffffffffffffffffffffffffffffffffffffffffffffffffffffffffffffffffffffffffffffffffffffffffffdcccccccccccccccccc
aaaaaaaddffffffffffffffffffffffffffffffffffffffffffffffffffffffffffffffffffffffffffffffffffffffffffffffffffffdcccccccccccccccccc
aaaaaaaddffffffffffffffffffffffffffffffffffffffffffffffffffffffffffffffffffffffffffffffffffffffffffffffffffffdcccccccccccccccccc
aaaaaaddfffffffffffffffffffffffffffffffffffffffffffffffffffffffffffffffffffffffffffffffffffffffffffffffffffffdcccccccccccccccccc
aaaaaaddfffffffffffffffffffffffffffffffffffffffffffffffffffffffffffffffffffffffffffffffffffffffffffffffffffffdcccccccccccccccccc
jjjjaddffffffffffffffffffffffffffffffffffffffffffffffffffffffffffffffffffffffffffffffffffffffffffffffffffffffdcccccccccccccccccc
jjjjddfffffffffffffffffffffffffffffffffffffffffffffffffffffffffffffffffffffffffffffffffffffffffffffffffffffffdcccccccccccccccccc
jjjkdffffffffffffffffffffffffffffffffffffffffffffffffffffffffffffffffffffffffffffffffffffffffffffffffffffffffdcccccccccccccccccc
kkkkfffffffffffffffffffffffffffffffffffffffffffffffffffffffffffffffffffffffffffffffffffffffffffffffffffffffffdcccccccccccccccccc
kkkdfffffffffffffffffffffffffffffffffffffffffffffffffffffffffffffffffffffffffffffffffffffffffffffffffffffffffdcccccccccccccccccc
kkkddffffffffffffffffffffffffffffffffffffffffffffffffffffffffffffffffffffffffffffffffffffffffffffffffffffffffdcccccccccccccccccc
kkkkdddffffffffffffffffffffffffffffffffffffffffffffffffffffffffffffffffffffffffffffffffffffffffffffffffffffffdcccccccccccccccccc
jjjjjadddddffffffffffffffffffffffffffffffffffffffffffffffffffffffffffffffffffffffffffffffffffffffffffffffffffdcccccccccccccccccc
aaaaaaaaaadddddddddffffffffffffffffffffffffffffffffffffffffffffffffffffffffffffffffffffffffffffffffffffffffffdcccccccccccccccccc
aaaaaaaaaaaaaaaaaaddddfffffffffffffffffffffffffffffffffffffffffffffffffffffffffffffffffffffffffffffffffffffffdcccccccccccccccccc
aaaaaaaaaaaaaaaaaaaaadddfffffffffffffffffffffffffffffffffffffffffffffffffffffffffffffffffffffffffffffffffffffdcccccccccccccccccc
aaaaaaaaaaaaaaaaaaaaaaaddddffffffffffffffffffffffffffffffffffffffffffffffffffffffffffffffffffffffffffffffffffdcccccccccccccccccc
aaaaaaaaaaaaaaaaaaaaaaaaaadddddffffffffffffffffffffffffffffffffffffffffffffffffffffffffffffffffffffffffffffffdcccccccccccccccccc
aaaaaaaaaaaaaaaaaaaaaaaaaaaaaadddffffffffffffffffffffffffffffffffffffffffffffffffffffffffffffffffffffffffffffdcccccccccccccccccc
aaaaaaaaaaaaaaaaaaaaaaaaaaaaaaaaddfffffffffffffffffffffffffffffffffffffffffffffffffffffffffffffffffffffffffffdcccccccccccccccccc
"}
