"a" = (/turf/simulated/wall/rock,/area/world/desert/exterior/village)
"b" = (/mob/living/simple/npc/spacecarp,/turf/simulated/floor/river,/area/world/forest/exterior/river)
"c" = (/turf/simulated/floor/river,/area/world/forest/exterior/river)
"d" = (/turf/simulated/floor/asteroid,/area/world/desert/exterior)
"e" = (/turf/simulated/floor/asteroid,/area/world/desert/exterior/village)
"f" = (/turf/simulated/floor/colored/sand/desert,/area/world/desert/exterior)
"g" = (/turf/simulated/wall/brick/sand,/area/world/desert/exterior)
"h" = (/obj/effect/fake_lighting/gradient/black{icon_state = "gradient"; dir = 1},/turf/simulated/floor/colored/sand/desert,/area/world/desert/exterior)
"i" = (/obj/effect/fake_lighting/solid/black,/turf/simulated/floor/colored/sand/desert,/area/world/desert/exterior)
"j" = (/turf/simulated/wall/rock,/area/world/desert/cave)
"k" = (/turf/simulated/floor/asteroid,/area/world/desert/cave)
"l" = (/turf/simulated/wall/brick/sand,/area/world/desert/exterior/village/shop01)
"m" = (/obj/structure/interactive/vendor/ammo,/obj/item/bullet/shotgun/slug,/obj/item/bullet/shotgun/buckshot,/obj/item/magazine/pistol_357,/turf/simulated/floor/colored/sand/desert,/area/world/desert/exterior/village/shop01)
"n" = (/turf/simulated/floor/colored/sand/desert,/area/world/desert/exterior/village)
"o" = (/turf/simulated/floor/colored/sand/desert,/area/world/desert/exterior/village/shop01)
"p" = (/turf/simulated/floor/asteroid,/area/world/desert/exterior/village/shop01)
"q" = (/turf/simulated/wall/brick/sand,/area/world/desert/exterior/village/shop02)
"r" = (/turf/simulated/floor/colored/sand/desert,/area/world/desert/exterior/village/shop02)
"s" = (/turf/simulated/floor/asteroid,/area/world/desert/exterior/village/shop02)
"t" = (/obj/structure/smooth/table/wood/poor,/obj/structure/interactive/shop,/obj/item/clothing/overwear/armor/cult/old,/obj/item/clothing/overwear/armor/knight/magnus/red,/turf/simulated/floor/asteroid,/area/world/desert/exterior/village/shop02)
"u" = (/turf/simulated/wall/brick/sand,/area/world/desert/exterior/village/shop03)
"v" = (/turf/simulated/floor/colored/sand/desert,/area/world/desert/exterior/village/shop03)
"w" = (/obj/structure/smooth/table/wood/poor,/obj/structure/interactive/shop,/obj/item/powercell,/turf/simulated/floor/colored/sand/desert,/area/world/desert/exterior/village/shop03)
"x" = (/turf/simulated/floor/asteroid,/area/world/desert/exterior/village/shop03)
"y" = (/obj/structure/smooth/table/wood/poor,/obj/structure/interactive/shop,/obj/item/weapon/ranged/bullet/pump/pump_shotgun,/turf/simulated/floor/colored/sand/desert,/area/world/desert/exterior/village/shop01)
"z" = (/obj/structure/smooth/table/wood/poor,/obj/structure/interactive/shop,/obj/item/weapon/ranged/magic/scroll/fireball/amount_3,/obj/item/weapon/ranged/magic/staff/fire,/obj/item/weapon/ranged/magic/tome/fireball,/turf/simulated/floor/asteroid,/area/world/desert/exterior/village/shop02)
"A" = (/obj/structure/smooth/table/wood/poor,/obj/structure/interactive/shop,/obj/item/weapon/ranged/bullet/magazine/pistol/mercenary,/turf/simulated/floor/colored/sand/desert,/area/world/desert/exterior/village/shop01)
"B" = (/obj/structure/smooth/table/wood/poor,/obj/structure/interactive/shop,/obj/item/clothing/head/hat/wizard/red,/obj/item/clothing/head/hood/cult/old,/turf/simulated/floor/asteroid,/area/world/desert/exterior/village/shop02)
"C" = (/obj/structure/smooth/table/wood/poor,/obj/structure/interactive/shop,/obj/item/weapon/melee/torch,/turf/simulated/floor/colored/sand/desert,/area/world/desert/exterior/village/shop03)
"D" = (/obj/structure/smooth/table/wood/poor,/obj/structure/interactive/shop,/obj/item/radio,/turf/simulated/floor/colored/sand/desert,/area/world/desert/exterior/village/shop03)
"E" = (/obj/structure/smooth/table/wood/poor,/obj/structure/interactive/shop,/obj/item/clothing/back/storage/backpack,/turf/simulated/floor/colored/sand/desert,/area/world/desert/exterior/village/shop03)
"F" = (/turf/simulated/floor/colored/sand/desert,/area/world/desert/cave)
"G" = (/mob/living/simple/npc/screech,/turf/simulated/floor/asteroid,/area/world/desert/exterior)
"H" = (/mob/living/simple/npc/screech,/turf/simulated/floor/colored/sand/desert,/area/world/desert/exterior)
"I" = (/obj/structure/smooth/table/wood/poor,/obj/structure/interactive/shop,/obj/item/container/beaker/bottle/large/water,/turf/simulated/floor/colored/sand/desert,/area/world/desert/exterior/village/shop02)
"J" = (/obj/structure/smooth/table/wood/poor,/obj/structure/interactive/shop,/turf/simulated/floor/asteroid,/area/world/desert/exterior/village/shop02)
"K" = (/obj/structure/smooth/table/wood/poor,/obj/structure/interactive/shop,/obj/item/storage/bags/chemistry,/turf/simulated/floor/colored/sand/desert,/area/world/desert/exterior/village/shop02)
"L" = (/obj/structure/smooth/table/wood/poor,/obj/structure/interactive/shop,/obj/item/storage/bags/mining,/turf/simulated/floor/colored/sand/desert,/area/world/desert/exterior/village/shop03)
"M" = (/turf/simulated/wall/brick/sand,/area/world/desert/exterior/village)
"N" = (/mob/living/simple/npc/spacecarp/leader,/turf/simulated/floor/river,/area/world/forest/exterior/river)
"O" = (/turf/simulated/wall/rock,/area/world/desert/exterior)
"P" = (/mob/living/simple/npc/spacecarp,/turf/simulated/floor/colored/sand/desert,/area/world/desert/exterior)
"Q" = (/mob/living/simple/npc/spacecarp/leader,/turf/simulated/floor/colored/sand/desert,/area/world/desert/exterior)

(1,1,1) = {"
jjjjjjjjjjjjjjjjjjjjjjjjjjjjjjjjjjjjjjjjjjjjjjjjjjjjjjjjjjjjjjjjjjjjjjjjjjjjjjjjjjjjjjjjjjjjjjeeejjjjjjjjjjjjjjjjccccccccccccccj
jjjjjjkkjjjjjjjjkkkjkkjjjjkkjjjjjjjjjjjjjjjjjjjjjjjjjjjjjjjjjjjjjjjjjjjjjjjjjjjjjjjjjjjllllljkeeekjeeeeejjjjjjjjjccccccccccccccj
jkkkkkkkjjjjkkkkkkkkkkjjjkkkkjjjjjjddddddjjjjjjjjjjjjjjjjjjjjjjjjjjjjjjjjjjjdddjjjjjeejlmAyleeeeeeeeeeeeejjjjjjjjccccccccccccccj
jjkkkkkkjjjkkkkkkkkkkkkjkkkkkjjjjdddffffdddddjjjjjddddjjjjjjjjjjjjjjjjjdddddddddjjeeeejloooleeeeeqqqqqeeeejjjjjjcccccccccccccccj
jjkkkkkjjjjkkkkkkkkkkkkkkkkkkjjdddffffffffffddddggddddddjjjjjjjjjjjjjdddffddddddddeeeeelooopeeeeeqKIJseeeeejjjjjcccccccccccccccj
jjkkkkjjjjkkkkkkkkkkkkkkkkkkjjjdfffffffffffffdddggdddddddjjjjjjjjjjdddfffffffdddddeejjeloopleeeeerrrrseeeeeejjjecccccccccccccccj
jjkkkkjjjjkkkkkjkkkkjkkkkkjjjdddffggggggggffffddggdfffddddjjjjjjjdddfffffffffffdddejjjeooppleeeenrrrrreeenneeeeeecccccccccccccjj
jjkkkkjjjkkkkkjjjkkjjjkkkjjjddffffgdddfddgfffffdggffffffdddjjjjdddffffffffffffffddjjjeeeeeeeeeennrrrzqeennneeeeeecccccccccccccjj
jjkkkkkjkkkkkjjjjjjjjkkkjjjddfffffgdGdffdgfffffffffffffffdddjdddfffffffffffffffffddOeeeeeeeeeennnrrsBqeennnneeeeecccccccccccccjj
jjjkkkkjkkkkkkjjjjjjkkkkjjddffffffgddfHddgfffffffffffffffffdddffffffffffffffffffffddeeeeenneeennnrsstqeennnneeeeecccccccccccccjj
jjjjkkkkkkkkkkkkkjjjjkkjjddfffffffgdfffddgfffffffffffffffffffffffffffffffffffffffffdeeeennnneeennqqqqqeennnneeeeccccccccccccccjj
jjjjjkkkkkkkkkkkkkkjjjjjddffffffffggHffdggffffffffffffffffffffffffffffffffffffffffffeeeeeennneeennnnneeeenneeeeeccccccccccccccjj
jjjjjkkkkkkkkkkkkkkjjjjddffffffffffffffffffffffffffffffffffffffffffffffffffffffffffdeeeeMeennMeennnneeeeeeeeeeecccccccccccccccjj
jjjjjkkjjjjkkkkkFFFkkjjdfffffffffffffffffffffffffffffffffffffffffffffffffffffffffffdjjjjMeeeeMeeeneeenuuuuuuneecccccccccccccccjj
jjjkkkjjjjjjkkkkkFFFkkddfffffffffffffffffffffffffffffffffffffffffffffffdddddfffffffdddjjMMMMMMeeeeeeenvwEDCLeeecccccccccccccccjj
jjjkkkkjjjjkkkkjkkFFFffffffffffffffffffffffffffdggffffffffffffffffddddddddddddddfffffddjjjjjjeeeeeeeenvvvxxxeeecccccccccccccccjj
jjkkkkkjjjkkkkkjjjkFfffffffdddffffffffffffffffddggffffffffffffffddddddddddddddjjjfffffddddjjjjjeeeeeeeuvvvvxeeecccccccccccccccjj
jjjkkkkjjjkkkkjjjjjddffffddddddfffffffffffffffddggffffffffffffddddddddddddddjjjjfffffffffdddjjjjjjejeeuuuuuxeeecccccccccccccccjj
jjjjkkkkjkkkkjjjjjjddfffddddggggffffgggfffffffddggffffffffffdddddddddddddjjjjjjffffffffffffdddjjjeejjeeeeeeeeeccccccccccccccccjj
jjjjkkkkkkkkkjjjjjddfffdddddgdffffffddgffffffffdggfffffffffddddddddddjjjjjjjjjjfffffffffffffddddjeajjjjjjeeeeeccccccccccccccccjj
jjjjkkkkkkkkjjjjjddfffffddddgddfffHffdgfffffffffffffffffffdddddddjjjjjjjjjjjjjfffffffffffffffffdddOjjjjjjjjjjeccccccccccccccccjj
jjjkkkkkkkkjjjjdddffffffffddgdGdffffHdgffffffffddgfffffffdddjjjjjjjjjjjjjjjjjffffffffffffffffffffdddddjjjjjjjjccccccccccccccccjj
jjkkkkkkkkjjjjddfffffffffffdgddddfffddgfffffffddggffffffddjjjjjjjjjjjjjjfffffffffffffffffffffffffffffdddddjjddcccccccccccccccccj
jkkkkkkkjjjjjddffffffffffffdgggggfffdggfffffffddgfffffffjjjjjjjjjjfffffffffffffffffffffffffffffffffffffffffffdcccccccccccccccccj
jjkkkkkjjjjjddffffffffffffffffffffffffffffffffddgffffffffffjjffffffffffffffffffffffffffffffffffffffffffffffffdcccccccccccccccccj
jjjkkkjjjjjjdfffdgggfffgggffffffffffffffffffffddggfffffffffffffffffffffffffffffffffffffffffffffffffffffffffffdcccccccccccccccccj
jjjkkkjjjjjddffddgffffdddgfffffffffffffffffffffdggfffffffffffffffffffffffffffffffffffffffffffffffffffffffffffddccbcccccccccccccj
jjkkkkjjjjjdffdddgfHfdGddgffffffffffffffffffffffddffffffffffffffffffffffffffffffffffffffffffffffffffffffffffffddccccccccccccccjj
jkkkkkjkjjjdfffddgffdddddgfffffffffffffffffffffddffffffffffffffffffffffffffffffffffffffffffffffffffffffffffffffdcNccccccccccccjj
jkkkkkkkjjddfffffffdGddddgffffffffffffffffffffdddffffffffffffffffffffffffffffffffffffffffffffffffffffffffffffffddccccbccccccccjj
jkkkkkkkjjdffffffffgggggggfffffffffffffffffffddddffffffffffffffffffffffffffffffffffffffffffffffffffffffffffffffPddccccccccccccjj
jkkkkkkjjjdffffffffffffffffffffffffffffffffdddddgffffffffffffffffffffffffffffffffffffffffffffffffffffffffffffffffddcccccccccccjj
jjkkkkjjjdddffffffffffffffffffffffffffffddddddddggffffffffffffffffffffffffffffffffffffffffffffffffffffffffffffffffdcccccccccccjj
jjjkjjjjdddddddddddddddddfffffffffffddddddddddddggjfffffffffffffffffffffffffffffffffffffffffffffffffffffffffffffffddcccccccccccj
jjjjjjjjgggddggggggggggggggggffffddddgggggggggggggjjfffffffffffffffffffffffffffffffffffffffffffffffffffffffffffffffddccccccccccj
jjjjjjjgggddgggggggggggggggffffffffddgggggggggggggjjjfffffffffffffffffffffffffffffffffffffffffffffffffffffffffffffffddcccccccccj
jjjjjjjjjjkkkkkkkkkkkfffffffffffffffffddjjjjjjjjjjjjjffffffffffffffffffffffffffffffffffffffffffffffffffffffffffffffffddccccccccj
jjjjjjjjjkkkjjjkkkkkkkkffffffffffffffffddddjjjjjjjjjjfffffffffffffffffffffffffffffffffffffffffffffffffffffffffffffffffdccccccccj
jjjjjjjjjkkjjjjjjjjkkkkkkffffffffffffffffddddjjjjjjjffffffffffffffffffffffffffffffffffffffffffffffffffffffffffffffffffdccccccccj
jjjjjjjjjkkjjjjjjjjkkkkkkjjffffffffffffffffdddjjjjjfffffffffffffffffffffffffffffffffffffffffffffffffffffffffffffffffffdccccccccj
jjjjjjjjkkkkkjjjjjjjkkkkjjjjjddfffffffffffffffffffffffffffffffffffffffffffffffffffffffffffffffffffffffffffffffffffffffdccccccccj
jjjjjjjkkkkkkkkjjjjjjkkkjjjjjkkjjfffffffffffffffffffffffffffffffffffffffffffffffffffffffffffffffffffffffffffffffffffffddcccccccj
jjjjjjkkkkkkkkkkjjjjjkkkkjjjjkkjjjfffffffffffffffffffffffffffffffffffffffffffffffffffffffffffffffffffffffffffffffffffffdcccccccj
jjjjjkkkjjkkkkkkkjjjjjkkkkkjjkkkjjjffffffffffffffffffffffffffffffffffffffffffffffffffffffffffffffffffffffffffffffffffffdcccccccj
jjjjkkkkjjjkkkkkkkjjjjkkkkkkjkkkjjjjfffffffffffffffffffffffffffffffffffffffffffffffffffffffffffffffffffffffffffffffffffdcccccccj
jjjkkkkjjjjjkkkkkkjjjjkkkkkkkkkkjjjjjffffffffffffffffffffffffffffffffffffffffffffffffffffffffffffffffffffffffffffffffffdcccccccj
jjkkkkkjjjjjjkkkkkjjjjkkkkkkkkkkkjjjjjfffffffffdddjjjjjjfffffffffffffffffffffffffffffffffffffffffffffffffffffffffffffffddccccccj
jkkkkkjjjjjjjjkkkjjjjkkkkkkkkkkkkjjjjjjfffffffdddjjjjjjjjfffffffffffffffffffffffffffffffffffffffffffffffffffffffffffffPfdccccccj
jkkkkkjjjjjjjjjjjjjjjjjkjjjjkkkkkjjjjjjjffffffddjjjjjjjjjjffffffffffffffffffffffffffffffffffffffffffffffffffffffffffffffdccccccj
jjkkkkjjjjjjjjjjjjjjjjjjjjjjjkkkkkjjjjjjfffffffdjjjjjjjjjjfffffffffffffffffffffffffffffffffffffffffffffffffffffffffffPffdccccccj
jjkkkkjjjjjjjjjjjjjjjjjjjjjjjkkkkkjjjjjjfffffffddjjjjjjjjjjfffffffffffffffffffffffffffffffffffffffffffffffffffffffffffffdbcccccj
jkkkkkjjjjjjjjjjjjjjjjjjjjjjkkkkkkjjjjjjffffffffddjjjjjjjjjffffffffffffffffffffffffffffffffffffffffffffffffffffffffffffddccccccj
jjjkkkkjjjjjjjjjjjkkkkkkjjjkkkkkkjjjjjjjffffffffdddjjjjjjjjjfffffffffffffffffffffffffffffffffffffffffffffffffffffffffQfdcccccccj
jjkkkkkjjjjjjjkkjkkkkkkkkjkkkkkkjjjjjjjjfffffffffdddjjjjjjjjjffffffffffffffffffffffffffffffffffffffffffffffffffffffffffdcccccccj
jjjjkkkkjjjjjkkkkkkkkkkkkkkkkkjjjjjjjjjjffffffffffdddjjjjjjjjfffffffffffffffffffffffffffffffffffffffffffffffffffffPffffdcccccccj
jjjjjkkkkkjjkkkkkkkkkkkkkkkkjjjjjjjjjjjffffffffffffdddjjjjjjjffffffffffffffffffffffffffffffffffffffffffffffffffffffffffdcccccccj
jjjjjkkkkkkkkkkkkkkkkkkkkkkjjjjjjjjjjjfffffffffffffdddjjjjjjjfffffffffffffffffffffffffffffffffffffffffffffffffffffffffddcccccccj
jjjjjjkkkkkkkkkkjkkkkkkkkkkjjjjjjjjjffffffffffffffffdddjjjjjjfffffffffffffffffffffffffffffffffffffffffffffffffffffffffdccccccccj
jjjjkkkkkkkkjkkjjkkkkkkkkkkkjjjjjjjffffffffffffffffffdddjjjjffffffffffffffffffffffffffffffffffffffffffffffffffffffffffdccccccccj
jjjkkkkkkkkjjjjjjjkkkkkkkkkkkjkjjfffffffffffffffffffffdddjjffffffffffffffffffffffffffffffffffffffffffffffffffffffffffddccccccccj
jjkkkkkkkjjjjjjjjkkkjjjkkkkkdddffffffffffffffffffffffffffffffffffffffffffffffffffffffffffffffffffffffffffffffffffffffdcccccccccj
jjkkkkkkjjjjjjjjkkkkjjjjkkkkddfffffffffffffffffffffffffffffffffffffffffffffffffffffffffffffffffffffffffffffffffffffffdcccccccccj
jjjkkkkjjjjjjjkkkkkjjjjjkkkddffffffffffgggffgggggffffffffffffffffffffffffffffffffffffffffffffffffffffffffffffffffffffdcccccccccj
jjjjkkjjjjjjjkkkkkjjjjjjkddfffffffffffffffffddddgffffffffffffffffffffffffffffffffffffffffffffffffffffffffffffffffffffdcccccccccj
jjjjjjjjjjjjkkkkkjjjjjjjddfffffffffffffffHfdddddgffffffffffffffffffffffffffffffffffffffffffffffffffffffffffffffffffffdcccccccccj
jjjjjjjjjjjkkkkkjjjjjjjddffffffffffffffffddddGddgffddddfffffffffffffffffffffffffffffffffffffffffffffffffffffffffffffddcccccccccj
jjjjjjjjkkkkkkjjjjjjjjddfffffffffffffffgddddddddgddddddfffffffffffffffffffffffffffffffffffffffffffffffffffffffffffffdccccccccccj
jjjjjjkkkkkkkjjjjjjjdddffffffffffffffffgggddgggggdddjjjfffffffffffffffffffffffffffffffffffffffffffffffffffffffffffffdccccccccccj
jjjjjkkkkkkkjjjjjjjdddffffgffdggffffffffffffffdddddjjjjfffffffffffffffffffffffffffffffffffffffffffffffffffffffffffffdccccccccccj
jjjjjjkkkkjjjjjjjjdddffffffffffdfffffffffffffddddjjjjjjffffffffffffffffffffffffffffffffffffffffffffffffffffffffffffddccccccccccj
jjjjkkkkkjjjjjjjjddddfffffffHfddfffffffffdddddddjjjjjjfffffffffffffffffffffffffffffffffffffffffffffffffffffffffffffdcccccccccccj
jjjjkkkkkjjjjjjdddddfffffffdddGdffffffffddddddjjjjjjjjfffffffffffffffffffffffffffffffffffffffffffffffffffffffffffffdcccccccccccj
jjjkkkkjjjjjjddddddfffffffgddddgfffffffddddddjjjjjjjjffffffffffffffffffffffffffffffffffffffffffffffffffffffffffffffddccccccccccj
jjjkkkjjjjjddddddfffffffffggggggfffffdddddddjjjjjjjjjfffffffffffffffffffffffffffffffffffffffffffffffffffffffffffffffdccccccccccj
jjjkkkjjjjdddddfffffffffffffffffffddddddddjjjjjjjjjjffffffffffffffffffffffffffffffffffffffffffffffffffffffffffffffffdccccccccccj
jjjkkkjjjjdddfffffffffffffffffffdddddddjjjjjjjjjjjjjffffffffffffffffffffffffffffffffffffffffffffffffffffffffffffffffddcccccccccj
jjkkkkjjjjdddfffffffffffffffffddddddjjjjjjjjjjjjjjfffffffffffffffffffffffffffffffffffffffffffffffffffffffffffffffffffddccccccccj
jjjkkkjjjjddffffffffffffffffdddddjjjjjjjjjjjjjjjffffffffffffffffffffffffffffffffffffffffffffffffffffffffffffffffffffffdccccccccj
jjjkkkjjjjddffffffffffffffddddddjjjjjjjjjjjjjjffffffffffffffffffffffffffffffffffffffffffffffffffffffffffffffffffffffffdccccccccj
jjjjkkkjjjdddfffffffffffdddddddjjjjjjjjjjjjjffffffffffffffffffffffffffffffffffffffffffffffffffffffffffffffffffffffffffdccccccccj
jjjjkkkjjjdddffffffffffddddddjjjjjjjjjjjjjffffffffffffffffffffffffffffffffffffffffffffffffffffffffffffffffffffffffffffdccccccccj
jjjjkkkjjjddddffffffffdddddjjjjjjjjjjjjfffffffffffffffffffffffffffffffffffffffffffffffffffffffffffffffffffffffffffffffdccccccccj
jjjjkkkjjjjddddfffffffddddjjjjjjjjjfffffffffffffffffffffffffffffffffffgggfffffffffgggffffffffffffffffffffffffffffffffddccccccccj
jjjjjkkkjjjddddffffffffdddjjjjjfffffffffffffffffffffffffffffffffffffffffggggfffggggffffffffffffffffffffffffffffffffffdcccccccccj
jjjjjkkkkjjjddddffffffffdddjjjfffffffffffffffffffffffffffffffffffffffffffgfffffffgfffffffffffffffffffffffffffffffffffdcccccccccj
jjjjjjkkkjjjjjddfffffffffffffffffffffffffffffffffffffffffffffffffffffffffgfgfffgfgfffffffffffffffffffffffffffffffffffdcccccccccj
jjjjjjkkkjjjjjjddffffffffffffffffffffffffffffffffffffffffffffffffffffffffgfffffffgfffffffffffffffffffffffffffffffffffddccccccccj
jjjjjjkkkkkjjjjddfffffffffffffffffffffffffffffffffffffffffffffffffffffffgggffgffgggfffffffffffffffffffffffffffffffffffdccccccccj
jjjjjkkkkkkjjjdddffffffffffffffffffffffffffffffffffffffffffffffffffffffggfggfffggfggffffffffffffffffffffffffffffffffffdccccccccj
jjjjkkkkkkjjjjddfffffffffffffffffffffffffffffffffffffffffffffffffffffffgfffgfffgfffgffffffffffffffffffffffffffffffffffddcccccccj
jjjkkkkkkjjjjdddfffffffffffffffffffffffffffffffffffffffffffffffffffffffgfgfghhhgfgfgfffffffffffffffffffffffffffffffffffdcccccccj
jjjkkkkkjjjjjddffffffffffffffffffffffffffffffffffffffffffffffffffffffffgfgfgiiigfgfgfffffffffffffffffffffffffffffffffffdcccccccj
jjjkkkkjjjjjjdffffffffffffffffffffffffffffffffffffffffffffffffffffffffggfgfgggggfgfggffffffffffffffffffffffffffffffffffddccccccj
jjjjkkjjjjjjddffffffffffffffffffffffffffffffffffffffffffffffffffffffffgffgfffffffgffgfffffffffffffffffffffffffffffffffffdccccccj
jjjjkkjjjjjjdfffffffffffffffffffffffffffffffffffffffffffffffffffffffffgfgggggggggggfgfffffffffffffffffffffffffffffffffffdccccccj
jjjjkkkjjjjddfffffffffffffffffffffffffffffffffffffffffffffffffffffffffgfgfffgfffffgfgfffffffffffffffffffffffffffffffffffdccccccj
jjjjkkkjjjjdffffffffffffffffffffffffffffffffffffffffffffffffffffffffffgfgfgggfgggfgfgfffffffffffffffffffffffffffffffffffdccccccj
jjjjjkkkjjddffffffffffffffffffffffffffffffffffffffffffffffffffffffffffgfgfgfffffgfgfgfffffffffffffffffffffffffffffffffffdccccccj
jjjjjkkkjjdfffffffffffjjjfffffffffffffffffffffffffffffffffffffffffffffgfgfgfgggfgfgfgfffffffffffffffffffffffffffffffffffdccccccj
jjjjjjkddddffffffffffjjjjjffffffffffffffffffffffffffffffffffffffffffffgfffgfffffgfffgfffffffffffffffffffffffffffffffffffdccccccj
jjjjjdddddffffffffffdjjjjjjfffffffffffffffffffffffffffffffffffffffffffggggggfffggggggfffffffffffffffffffffffffffffffffffdccccccj
jjjjdddddfffffffffffdjjjjjjjffffffffffffffffffffffffffffffffffffffffffffffffffffffffffffffffffffffffffffffffffffffffffffdccccccj
jjjdddddfffffffffffddjjjjjjjjfffffffffffffffffffffffffffffffffffffffffffffffffffffffffffffffffffffffffffffffffffffffffffdccccccj
jjjdddddffffffffffddddjjjjjjjjffffffffffffffffffffffffffffffffffffffffffffffffffffffffffffffffffffffffffffffffffffffffffdccccccj
jjjjddddffffffffffddddjjjjjjjjjfffffffffffffffffffffffffffffffffffffffffffffffffffffffffffffffffffffffffffffffffffffffffdccccccj
jjjjjjddfffffffffffddddjjjjjjjjfffffffffffffffffffffffffffffffffffffffffffffffffffffffffffffffffffffffffffffffffffffffffdccccccj
jjjjjjjddfffffffffffddddjjjjjjjjfffffffffffffffffffffffffffffffffffffffffffffffffffffffffffffffffffffffffffffffffffffffddccccccj
jjjjjjjjdfffffffffffddddjjjjjjjjjffffffffffffffffffffffffffffffffffffffffffffffffffffffffffffffffffffffffffffffffffffffdcccccccj
jjjjjjjjdfffffffffffdddddjjjjjjjjffffffffffffffffffffffffffffffffffffffffffffffffffffffffffffffffffffffffffffffffffffffdcccccccj
jjjjjjjddfffffffffffdddddjjjjjjjjjfffffffffffffffffffffffffffffffffffffffffffffffffffffffffffffffffffffffffffffffffffffdcccccccj
jjjjjjjddffffffffffdddddddjjjjjjjjffffffffffffffffffffffffffffffffffffffffffffffffffffffffffffffffffffffffffffffffffffddcccccccj
jjjjjjddfffffffffffdddddddjjjjjjjjffffffffffffffffffffffffffffffffffffffffffffffffffffffffffffffffffffffffffffffffffffdccccccccj
jjjjjjddfffffffffdddddddddjjjjjjjjjfffffffffffffffffffffffffffffffffffffffffffffffffffffffffffffffffffffffffffffffffffdccccccccj
jjjjjddffffffffdddddddddddddjjjjjjjfffffffffffffffffffffffffffffffffffffffffffffffffffffffffffffffffffffffffffffffffffdccccccccj
jjjjddfffffffffddddddddddddddjjjjjjjffffffffffffffffffffffffffffffffffffffffffffffffffffffffffffffffffffffffffffffffffdccccccccj
jjjkdfffffffffffffdddddddddddjjjjjjjffffffffffffffffffffffffffffffffffffffffffffffffffffffffffffffffffffffffffffffffffdccccccccj
kkkkffffffffffffffffffddddddddjjjjjjfffffffffffffffffffffffffffffffffffffffffffffffffffffffffffffffffffffffffffffffffddccccccccj
kkkdffffffffffffffffffffdddddddjjjjjfffffffffffffffffffffffffffffffffffffffffffffffffffffffffffffffffffffffffffffffffdcccccccccj
kkkddffffffffffffffffffffffffdddjjjddfffffffffffffffffffffffffffffffffffffffffffffdddddddjjjddddfffffffffffffffffffffdcccccccccj
kkkkdddfffffffffffffffffffffffddddddfffffffffffddddfffffffffffffffffffffffffffdddddddddjjjjjjdddddfffffffffffffffffffdcccccccccj
jjjjjjdddddfffffffffffffffffffffffffffffffffffddjjddfffffffffffffffffffffffddddddddddjjjjjjjjjdddddffffffffffffffffffdcccccccccj
jjjjjjjjjjdddddddddffffffffffffffffffffffffffddjjjjdddffffffffffffffffffdddddddddddjjjjjjjjjjjjdddddffffffffffffffffddcccccccccj
jjjjjjjjjjjjjjjjjjddddffffffffffffffffffffffddjjjjjjjdddffffffffffffffdddddddddddjjjjjjjjjjjjjjjddddddffffffffffffffdccccccccccj
jjjjjjjjjjjjjjjjjjjjjdddfffffffffffffffffffddjjjjjjjjjjddfffffffffffdddddddddddjjjjjjjjjjjjjjjjjjddddddfffffffffffffdccccccccccj
jjjjjjjjjjjjjjjjjjjjjjjddddffffffffffffffdddjjjjjjjjjjjjddddddddffdddddddddddjjjjjjjjjjjjjjjjjjjjjddddddfffffffffffddccccccccccj
jjjjjjjjjjjjjjjjjjjjjjjjjjdddddffffffdddddjjjjjjjjjjjjjjjjjjjjjdddddddddddjjjjjjjjjjjjjjjjjjjjjjjjjjdddddffffffffffdcccccccccccj
jjjjjjjjjjjjjjjjjjjjjjjjjjjjjjddddddddjjjjjjjjjjjjjjjjjjjjjjjjjjjddddddddjjjjjjjjjjjjjjjjjjjjjjjjjjjjdddddfffffffffdcccccccccccj
jjjjjjjjjjjjjjjjjjjjjjjjjjjjjjjjjjjjjjjjjjjjjjjjjjjjjjjjjjjjjjjjjjjjjjjjjjjjjjjjjjjjjjjjjjjjjjjjjjjjjjjjjjjjjjjjjjjjjjjjjjjjjjjj
"}
