"a" = (/turf/simulated/wall/rock,/area/world/desert/exterior/village)
"b" = (/obj/marker/mob_blocker,/turf/simulated/floor/colored/sand/desert,/area/world/desert/exterior)
"c" = (/turf/simulated/floor/river,/area/world/forest/exterior/river)
"d" = (/turf/simulated/floor/asteroid,/area/world/desert/exterior)
"e" = (/turf/simulated/floor/asteroid,/area/world/desert/exterior/village)
"f" = (/turf/simulated/floor/colored/sand/desert,/area/world/desert/exterior)
"g" = (/turf/simulated/wall/brick/sand,/area/world/desert/exterior)
"h" = (/obj/effect/fake_lighting/gradient/black{icon_state = "gradient"; dir = 1},/turf/simulated/floor/colored/sand/desert,/area/world/desert/exterior)
"i" = (/obj/effect/fake_lighting/solid/black,/turf/simulated/floor/colored/sand/desert,/area/world/desert/exterior)
"j" = (/turf/simulated/wall/rock,/area/world/desert/cave)
"k" = (/turf/simulated/floor/asteroid,/area/world/desert/cave)
"l" = (/turf/simulated/wall/brick/sand,/area/world/desert/exterior/village/shop01)
"m" = (/obj/structure/smooth/table/wood/poor,/obj/structure/interactive/shop,/obj/item/weapon/melee/sword/sabre,/turf/simulated/floor/colored/sand/desert,/area/world/desert/exterior/village/shop01)
"n" = (/turf/simulated/floor/colored/sand/desert,/area/world/desert/exterior/village)
"o" = (/turf/simulated/floor/colored/sand/desert,/area/world/desert/exterior/village/shop01)
"p" = (/turf/simulated/floor/asteroid,/area/world/desert/exterior/village/shop01)
"q" = (/turf/simulated/wall/brick/sand,/area/world/desert/exterior/village/shop02)
"r" = (/turf/simulated/floor/colored/sand/desert,/area/world/desert/exterior/village/shop02)
"s" = (/turf/simulated/floor/asteroid,/area/world/desert/exterior/village/shop02)
"t" = (/obj/structure/smooth/table/wood/poor,/obj/structure/interactive/shop,/obj/item/clothing/overwear/armor/cult/old,/obj/item/clothing/overwear/armor/knight/magnus/red,/turf/simulated/floor/asteroid,/area/world/desert/exterior/village/shop02)
"u" = (/turf/simulated/wall/brick/sand,/area/world/desert/exterior/village/shop03)
"v" = (/turf/simulated/floor/colored/sand/desert,/area/world/desert/exterior/village/shop03)
"w" = (/obj/structure/smooth/table/wood/poor,/obj/structure/interactive/shop,/obj/item/powercell,/turf/simulated/floor/colored/sand/desert,/area/world/desert/exterior/village/shop03)
"x" = (/turf/simulated/floor/asteroid,/area/world/desert/exterior/village/shop03)
"y" = (/obj/structure/smooth/table/wood/poor,/obj/structure/interactive/shop,/obj/item/weapon/ranged/bullet/magazine/pistol,/turf/simulated/floor/colored/sand/desert,/area/world/desert/exterior/village/shop01)
"z" = (/obj/structure/smooth/table/wood/poor,/obj/structure/interactive/shop,/obj/item/weapon/ranged/magic/scroll/fireball/amount_3,/obj/item/weapon/ranged/magic/staff/fire,/obj/item/weapon/ranged/magic/tome/fireball,/turf/simulated/floor/asteroid,/area/world/desert/exterior/village/shop02)
"A" = (/obj/structure/smooth/table/wood/poor,/obj/structure/interactive/shop,/obj/item/magazine/pistol_10mm/surplus,/turf/simulated/floor/colored/sand/desert,/area/world/desert/exterior/village/shop01)
"B" = (/obj/structure/smooth/table/wood/poor,/obj/structure/interactive/shop,/obj/item/clothing/head/hat/wizard/red,/obj/item/clothing/head/hood/cult/old,/turf/simulated/floor/asteroid,/area/world/desert/exterior/village/shop02)
"C" = (/obj/structure/smooth/table/wood/poor,/obj/structure/interactive/shop,/obj/item/weapon/melee/torch,/turf/simulated/floor/colored/sand/desert,/area/world/desert/exterior/village/shop03)
"D" = (/obj/structure/smooth/table/wood/poor,/obj/structure/interactive/shop,/obj/item/radio,/turf/simulated/floor/colored/sand/desert,/area/world/desert/exterior/village/shop03)
"E" = (/obj/structure/smooth/table/wood/poor,/obj/structure/interactive/shop,/obj/item/clothing/back/storage/backpack,/turf/simulated/floor/colored/sand/desert,/area/world/desert/exterior/village/shop03)
"F" = (/turf/simulated/floor/colored/sand/desert,/area/world/desert/cave)
"G" = (/obj/structure/smooth/table/wood/poor,/obj/structure/interactive/shop,/obj/item/magazine/smg_22,/turf/simulated/floor/colored/sand/desert,/area/world/desert/exterior/village/shop01)
"H" = (/obj/structure/smooth/table/wood/poor,/obj/structure/interactive/shop,/obj/item/weapon/ranged/bullet/magazine/bull,/turf/simulated/floor/colored/sand/desert,/area/world/desert/exterior/village/shop01)
"I" = (/obj/structure/smooth/table/wood/poor,/obj/structure/interactive/shop,/obj/item/container/beaker/bottle/large/water,/turf/simulated/floor/colored/sand/desert,/area/world/desert/exterior/village/shop02)
"J" = (/obj/structure/smooth/table/wood/poor,/obj/structure/interactive/shop,/turf/simulated/floor/asteroid,/area/world/desert/exterior/village/shop02)
"K" = (/obj/structure/smooth/table/wood/poor,/obj/structure/interactive/shop,/obj/item/storage/bags/chemistry,/turf/simulated/floor/colored/sand/desert,/area/world/desert/exterior/village/shop02)
"L" = (/obj/structure/smooth/table/wood/poor,/obj/structure/interactive/shop,/obj/item/storage/bags/mining,/turf/simulated/floor/colored/sand/desert,/area/world/desert/exterior/village/shop03)
"M" = (/turf/simulated/wall/brick/sand,/area/world/desert/exterior/village)
"N" = (/obj/structure/smooth/table/wood/poor,/obj/structure/interactive/shop,/turf/simulated/floor/asteroid,/area/world/desert/exterior/village)
"O" = (/turf/simulated/wall/rock,/area/world/desert/exterior)

(1,1,1) = {"
jjjjjjjjjjjjjjjjjjjjjjjjjjjjjjjjjjjjjjjjjjjjjjjjjjjjjjjjjjjjjjjjjjjjjjjjjjjjjjjjjjjjjjjjjjjjjjeeejjjjjjjjjjjjjjjjccccccccccccccj
jjjjjjkkjjjjjjjjkkkjkkjjjjkkjjjjjjjjjjjjjjjjjjjjjjjjjjjjjjjjjjjjjjjjjjjjjjjjjjjjjjjjjjjllllljjeeejjeeeeejjjjjjjjjccccccccccccccj
jkkkkkkkjjjjkkkkkkkkkkjjjkkkkjjjjjjddddddjjjjjjjjjjjjjjjjjjjjjjjjjjjjjjjjjjjdddjjjjjeejlyAmleeeeeeeeeeeeejjjjjjjjccccccccccccccj
jjkkkkkkjjjkkkkkkkkkkkkjkkkkkjjjjdddffffdddddjjjjjddddjjjjjjjjjjjjjjjjjdddddddddjjeeeejloooleeeeeqqqqqeeeejjjjjjcccccccccccccccj
jjkkkkkjjjjkkkkkkkkkkkkkkkkkkjjdddffffffffffddddggddddddjjjjjjjjjjjjjdddffddddddddeeeeelGoopeeeeeqKIJseeeeejjjjjcccccccccccccccj
jjkkkkjjjjkkkkkkkkkkkkkkkkkkjjjdfffffffffffffdddggdddddddjjjjjjjjjjdddfffffffdddddeejjelHopleeeeerrrrseeeeeejjjecccccccccccccccj
jjkkkkjjjjkkkkkjkkkkjkkkkkjjjdddffggggggggffffddggdfffddddjjjjjjjdddfffffffffffdddejjjeooppleeeenrrrrreeenneeeeeecccccccccccccjj
jjkkkkjjjkkkkkjjjkkjjjkkkjjjddffffgdddfddgfffffdggffffffdddjjjjdddffffffffffffffddjjjeeeeeeeeeennrrrzqeennneeeeeecccccccccccccjj
jjkkkkkjkkkkkjjjjjjjjkkkjjjddfffffgdddffdgfffffffffffffffdddjdddfffffffffffffffffddOeeeeeeeeeennnrrsBqeennnneeeeecccccccccccccjj
jjjkkkkjkkkkkkjjjjjjkkkkjjddffffffgddffddgfffffffffffffffffdddffffffffffffffffffffddeeeeenneeennnrsstqeennnneeeeecccccccccccccjj
jjjjkkkkkkkkkkkkkjjjjkkjjddfffffffgdfffddgfffffffffffffffffffffffffffffffffffffffffdeeeennnneeennqqqqqeennnneeeeccccccccccccccjj
jjjjjkkkkkkkkkkkkkkjjjjjddffffffffggfffdggffffffffffffffffffffffffffffffffffffffffffeeeeeennneeennnnneeeenneeeeeccccccccccccccjj
jjjjjkkkkkkkkkkkkkkjjjjddffffffffffffffffffffffffffffffffffffffffffffffffffffffffffdeeeeMeennMeennnneeeeeeeeeeecccccccccccccccjj
jjjjjkkjjjjkkkkkFFFkkjjdfffffffffffffffffffffffffffffffffffffffffffffffffffffffffffdjjjjMNNNNMeeeneeenuuuuuuneecccccccccccccccjj
jjjkkkjjjjjjkkkkkFFFkkddfffffffffffffffffffffffffffffffffffffffffffffffdddddfffffffdddjjMMMMMMeeeeeeenvwEDCLeeecccccccccccccccjj
jjjkkkkjjjjkkkkjkkFFFffffffffffffffffffffffffffdggffffffffffffffffddddddddddddddfffffddjjjjjjeeeeeeeenvvvxxxeeecccccccccccccccjj
jjkkkkkjjjkkkkkjjjkFfffffffdddffffffffffffffffddggffffffffffffffddddddddddddddjjjfffffddddjjjjjeeeeeeeuvvvvxeeecccccccccccccccjj
jjjkkkkjjjkkkkjjjjjddffffddddddfffffffffffffffddggffffffffffffddddddddddddddjjjjfffffffffdddjjjjjjejeeuuuuuxeeecccccccccccccccjj
jjjjkkkkjkkkkjjjjjjddfffddddggggffffgggfffffffddggffffffffffdddddddddddddjjjjjjffffffffffffdddjjjeejjeeeeeeeeeccccccccccccccccjj
jjjjkkkkkkkkkjjjjjddfffdddddgdffffffddgffffffffdggfffffffffddddddddddjjjjjjjjjjfffffffffffffddddjeajjjjjjeeeeeccccccccccccccccjj
jjjjkkkkkkkkjjjjjddfffffddddgddffffffdgfffffffffffffffffffdddddddjjjjjjjjjjjjjfffffffffffffffffdddOjjjjjjjjjjeccccccccccccccccjj
jjjkkkkkkkkjjjjdddffffffffddgdddfffffdgffffffffddgfffffffdddjjjjjjjjjjjjjjjjjffffffffffffffffffffdddddjjjjjjjjccccccccccccccccjj
jjkkkkkkkkjjjjddfffffffffffdgddddfffddgfffffffddggffffffddjjjjjjjjjjjjjjfffffffffffffffffffffffffffffdddddjjddcccccccccccccccccj
jkkkkkkkjjjjjddffffffffffffdgggggfffdggfffffffddgfffffffjjjjjjjjjjfffffffffffffffffffffffffffffffffffffffffbfdcccccccccccccccccj
jjkkkkkjjjjjddffffffffffffffffffffffffffffffffddgffffffffffjjffffffffffffffffffffffffffffffffffffffffffffffbfdcccccccccccccccccj
jjjkkkjjjjjjdfffdgggfffgggffffffffffffffffffffddggfffffffffffffffffffffffffffffffffffffffffffffffffffffffffbfdcccccccccccccccccj
jjjkkkjjjjjddffddgffffdddgfffffffffffffffffffffdggfffffffffffffffffffffffffffffffffffffffffffffffffffffffffbfddccccccccccccccccj
jjkkkkjjjjjdffdddgfffddddgffffffffffffffffffffffddfffffffffffffffffffffffffffffffffffffffffffffffffffffffffbffddccccccccccccccjj
jkkkkkjkjjjdfffddgffdddddgfffffffffffffffffffffddffffffffffffffffffffffffffffffffffffffffffffffffffffffffffbfffdccccccccccccccjj
jkkkkkkkjjddfffffffddddddgffffffffffffffffffffdddffffffffffffffffffffffffffffffffffffffffffffffffffffffffffbfffddcccccccccccccjj
jkkkkkkkjjdffffffffgggggggfffffffffffffffffffddddffffffffffffffffffffffffffffffffffffffffffffffffffffffffffbffffddccccccccccccjj
jkkkkkkjjjdffffffffffffffffffffffffffffffffdddddgffffffffffffffffffffffffffffffffffffffffffffffffffffffffffbfffffddcccccccccccjj
jjkkkkjjjdddffffffffffffffffffffffffffffddddddddggfffffffffffffffffffffffffffffffffffffffffffffffffffffffffbffffffdcccccccccccjj
jjjkjjjjdddddddddddddddddfffffffffffddddddddddddggjffffffffffffffffffffffffffffffffffffffffffffffffffffffffbffffffddcccccccccccj
jjjjjjjjgggddggggggggggggggggffffddddgggggggggggggjjfffffffffffffffffffffffffffffffffffffffffffffffffffffffbfffffffddccccccccccj
jjjjjjjgggddgggggggggggggggffffffffddgggggggggggggjjjffffffffffffffffffffffffffffffffffffffffffffffffffffffbffffffffddcccccccccj
jjjjjjjjjjkkkkkkkkkkkfffffffffffffffffddjjjjjjjjjjjjjffffffffffffffffffffffffffffffffffffffffffffffffffffffbfffffffffddccccccccj
jjjjjjjjjkkkjjjkkkkkkkkffffffffffffffffddddjjjjjjjjjjffffffffffffffffffffffffffffffffffffffffffffffffffffffbffffffffffdccccccccj
jjjjjjjjjkkjjjjjjjjkkkkkkffffffffffffffffddddjjjjjjjfffffffffffffffffffffffffffffffffffffffffffffffffffffffbffffffffffdccccccccj
jjjjjjjjjkkjjjjjjjjkkkkkkjjffffffffffffffffdddjjjjjffffffffffffffffffffffffffffffffffffffffffffffffffffffffbffffffffffdccccccccj
jjjjjjjjkkkkkjjjjjjjkkkkjjjjjddffffffffffffffffffffffffffffffffffffffffffffffffffffffffffffffffffffffffffffbffffffffffdccccccccj
jjjjjjjkkkkkkkkjjjjjjkkkjjjjjkkjjffffffffffffffffffffffffffffffffffffffffffffffffffffffffffffffffffffffffffbffffffffffddcccccccj
jjjjjjkkkkkkkkkkjjjjjkkkkjjjjkkjjjfffffffffffffffffffffffffffffffffffffffffffffffffffffffffffffffffffffffffbfffffffffffdcccccccj
jjjjjkkkjjkkkkkkkjjjjjkkkkkjjkkkjjjffffffffffffffffffffffffffffffffffffffffffffffffffffffffffffffffffffffffbfffffffffffdcccccccj
jjjjkkkkjjjkkkkkkkjjjjkkkkkkjkkkjjjjfffffffffffffffffffffffffffffffffffffffffffffffffffffffffffffffffffffffbfffffffffffdcccccccj
jjjkkkkjjjjjkkkkkkjjjjkkkkkkkkkkjjjjjffffffffffffffffffffffffffffffffffffffffffffffffffffffffffffffffffffffbfffffffffffdcccccccj
jjkkkkkjjjjjjkkkkkjjjjkkkkkkkkkkkjjjjjfffffffffdddjjjjjjfffffffffffffffffffffffffffffffffffffffffffffffffffbfffffffffffddccccccj
jkkkkkjjjjjjjjkkkjjjjkkkkkkkkkkkkjjjjjjfffffffdddjjjjjjjjffffffffffffffffffffffffffffffffffffffffffffffffffbffffffffffffdccccccj
jkkkkkjjjjjjjjjjjjjjjjjkjjjjkkkkkjjjjjjjffffffddjjjjjjjjjjfffffffffffffffffffffffffffffffffffffffffffffffffbffffffffffffdccccccj
jjkkkkjjjjjjjjjjjjjjjjjjjjjjjkkkkkjjjjjjfffffffdjjjjjjjjjjfffffffffffffffffffffffffffffffffffffffffffffffffbffffffffffffdccccccj
jjkkkkjjjjjjjjjjjjjjjjjjjjjjjkkkkkjjjjjjfffffffddjjjjjjjjjjffffffffffffffffffffffffffffffffffffffffffffffffbffffffffffffdccccccj
jkkkkkjjjjjjjjjjjjjjjjjjjjjjkkkkkkjjjjjjffffffffddjjjjjjjjjffffffffffffffffffffffffffffffffffffffffffffffffbfffffffffffddccccccj
jjjkkkkjjjjjjjjjjjkkkkkkjjjkkkkkkjjjjjjjffffffffdddjjjjjjjjjfffffffffffffffffffffffffffffffffffffffffffffffbfffffffffffdcccccccj
jjkkkkkjjjjjjjkkjkkkkkkkkjkkkkkkjjjjjjjjfffffffffdddjjjjjjjjjffffffffffffffffffffffffffffffffffffffffffffffbfffffffffffdcccccccj
jjjjkkkkjjjjjkkkkkkkkkkkkkkkkkjjjjjjjjjjffffffffffdddjjjjjjjjffffffffffffffffffffffffffffffffffffffffffffffbfffffffffffdcccccccj
jjjjjkkkkkjjkkkkkkkkkkkkkkkkjjjjjjjjjjjffffffffffffdddjjjjjjjffffffffffffffffffffffffffffffffffffffffffffffbfffffffffffdcccccccj
jjjjjkkkkkkkkkkkkkkkkkkkkkkjjjjjjjjjjjfffffffffffffdddjjjjjjjffffffffffffffffffffffffffffffffffffffffffffffbffffffffffddcccccccj
jjjjjjkkkkkkkkkkjkkkkkkkkkkjjjjjjjjjffffffffffffffffdddjjjjjjffffffffffffffffffffffffffffffffffffffffffffffbffffffffffdccccccccj
jjjjkkkkkkkkjkkjjkkkkkkkkkkkjjjjjjjffffffffffffffffffdddjjjjfffffffffffffffffffffffffffffffffffffffffffffffbffffffffffdccccccccj
jjjkkkkkkkkjjjjjjjkkkkkkkkkkkjkjjfffffffffffffffffffffdddjjffffffffffffffffffffffffffffffffffffffffffffffffbfffffffffddccccccccj
jjkkkkkkkjjjjjjjjkkkjjjkkkkkdddffffffffffffffffffffffffffffffffffffffffffffffffffffffffffffffffffffffffffffbfffffffffdcccccccccj
jjkkkkkkjjjjjjjjkkkkjjjjkkkkddfffffffffffffffffffffffffffffffffffffffffffffffffffffffffffffffffffffffffffffbfffffffffdcccccccccj
jjjkkkkjjjjjjjkkkkkjjjjjkkkddffffffffffgggffgggggffffffffffffffffffffffffffffffffffffffffffffffffffffffffffbfffffffffdcccccccccj
jjjjkkjjjjjjjkkkkkjjjjjjkddfffffffffffffffffddddgffffffffffffffffffffffffffffffffffffffffffffffffffffffffffbfffffffffdcccccccccj
jjjjjjjjjjjjkkkkkjjjjjjjddfffffffffffffffffdddddgffffffffffffffffffffffffffffffffffffffffffffffffffffffffffbfffffffffdcccccccccj
jjjjjjjjjjjkkkkkjjjjjjjddffffffffffffffffdddddddgffddddffffffffffffffffffffffffffffffffffffffffffffffffffffbffffffffddcccccccccj
jjjjjjjjkkkkkkjjjjjjjjddfffffffffffffffgddddddddgddddddffffffffffffffffffffffffffffffffffffffffffffffffffffbffffffffdccccccccccj
jjjjjjkkkkkkkjjjjjjjdddffffffffffffffffgggddgggggdddjjjffffffffffffffffffffffffffffffffffffffffffffffffffffbffffffffdccccccccccj
jjjjjkkkkkkkjjjjjjjdddffffgffdggffffffffffffffdddddjjjjffffffffffffffffffffffffffffffffffffffffffffffffffffbffffffffdccccccccccj
jjjjjjkkkkjjjjjjjjdddffffffffffdfffffffffffffddddjjjjjjffffffffffffffffffffffffffffffffffffffffffffffffffffbfffffffddccccccccccj
jjjjkkkkkjjjjjjjjddddfffffffffddfffffffffdddddddjjjjjjfffffffffffffffffffffffffffffffffffffffffffffffffffffbfffffffdcccccccccccj
jjjjkkkkkjjjjjjdddddfffffffdddddffffffffddddddjjjjjjjjfffffffffffffffffffffffffffffffffffffffffffffffffffffbfffffffdcccccccccccj
jjjkkkkjjjjjjddddddfffffffgddddgfffffffddddddjjjjjjjjffffffffffffffffffffffffffffffffffffffffffffffffffffffbfffffffddccccccccccj
jjjkkkjjjjjddddddfffffffffggggggfffffdddddddjjjjjjjjjffffffffffffffffffffffffffffffffffffffffffffffffffffffbffffffffdccccccccccj
jjjkkkjjjjdddddfffffffffffffffffffddddddddjjjjjjjjjjfffffffffffffffffffffffffffffffffffffffffffffffffffffffbffffffffdccccccccccj
jjjkkkjjjjdddfffffffffffffffffffdddddddjjjjjjjjjjjjjfffffffffffffffffffffffffffffffffffffffffffffffffffffffbffffffffddcccccccccj
jjkkkkjjjjdddfffffffffffffffffddddddjjjjjjjjjjjjjjfffffffffffffffffffffffffffffffffffffffffffffffffffffffffbfffffffffddccccccccj
jjjkkkjjjjddffffffffffffffffdddddjjjjjjjjjjjjjjjfffffffffffffffffffffffffffffffffffffffffffffffffffffffffffbffffffffffdccccccccj
jjjkkkjjjjddffffffffffffffddddddjjjjjjjjjjjjjjfffffffffffffffffffffffffffffffffffffffffffffffffffffffffffffbffffffffffdccccccccj
jjjjkkkjjjdddfffffffffffdddddddjjjjjjjjjjjjjfffffffffffffffffffffffffffffffffffffffffffffffffffffffffffffffbffffffffffdccccccccj
jjjjkkkjjjdddffffffffffddddddjjjjjjjjjjjjjfffffffffffffffffffffffffffffffffffffffffffffffffffffffffffffffffbffffffffffdccccccccj
jjjjkkkjjjddddffffffffdddddjjjjjjjjjjjjffffffffffffffffffffffffffffffffffffffffffffffffffffffffffffffffffffbffffffffffdccccccccj
jjjjkkkjjjjddddfffffffddddjjjjjjjjjfffffffffffffffffffffffffffffffffffgggfffffffffgggffffffffffffffffffffffbfffffffffddccccccccj
jjjjjkkkjjjddddffffffffdddjjjjjfffffffffffffffffffffffffffffffffffffffffggggfffggggffffffffffffffffffffffffbfffffffffdcccccccccj
jjjjjkkkkjjjddddffffffffdddjjjfffffffffffffffffffffffffffffffffffffffffffgfffffffgfffffffffffffffffffffffffbfffffffffdcccccccccj
jjjjjjkkkjjjjjddfffffffffffffffffffffffffffffffffffffffffffffffffffffffffgfgfffgfgfffffffffffffffffffffffffbfffffffffdcccccccccj
jjjjjjkkkjjjjjjddffffffffffffffffffffffffffffffffffffffffffffffffffffffffgfffffffgfffffffffffffffffffffffffbfffffffffddccccccccj
jjjjjjkkkkkjjjjddfffffffffffffffffffffffffffffffffffffffffffffffffffffffgggffgffgggffffffffffffffffffffffffbffffffffffdccccccccj
jjjjjkkkkkkjjjdddffffffffffffffffffffffffffffffffffffffffffffffffffffffggfggfffggfggfffffffffffffffffffffffbffffffffffdccccccccj
jjjjkkkkkkjjjjddfffffffffffffffffffffffffffffffffffffffffffffffffffffffgfffgfffgfffgfffffffffffffffffffffffbffffffffffddcccccccj
jjjkkkkkkjjjjdddfffffffffffffffffffffffffffffffffffffffffffffffffffffffgfgfghhhgfgfgfffffffffffffffffffffffbfffffffffffdcccccccj
jjjkkkkkjjjjjddffffffffffffffffffffffffffffffffffffffffffffffffffffffffgfgfgiiigfgfgfffffffffffffffffffffffbfffffffffffdcccccccj
jjjkkkkjjjjjjdffffffffffffffffffffffffffffffffffffffffffffffffffffffffggfgfgggggfgfggffffffffffffffffffffffbfffffffffffddccccccj
jjjjkkjjjjjjddffffffffffffffffffffffffffffffffffffffffffffffffffffffffgffgfffffffgffgffffffffffffffffffffffbffffffffffffdccccccj
jjjjkkjjjjjjdfffffffffffffffffffffffffffffffffffffffffffffffffffffffffgfgggggggggggfgffffffffffffffffffffffbffffffffffffdccccccj
jjjjkkkjjjjddfffffffffffffffffffffffffffffffffffffffffffffffffffffffffgfgfffgfffffgfgffffffffffffffffffffffbffffffffffffdccccccj
jjjjkkkjjjjdffffffffffffffffffffffffffffffffffffffffffffffffffffffffffgfgfgggfgggfgfgffffffffffffffffffffffbffffffffffffdccccccj
jjjjjkkkjjddffffffffffffffffffffffffffffffffffffffffffffffffffffffffffgfgfgfffffgfgfgffffffffffffffffffffffbffffffffffffdccccccj
jjjjjkkkjjdfffffffffffjjjfffffffffffffffffffffffffffffffffffffffffffffgfgfgfgggfgfgfgffffffffffffffffffffffbffffffffffffdccccccj
jjjjjjkddddffffffffffjjjjjffffffffffffffffffffffffffffffffffffffffffffgfffgfffffgfffgffffffffffffffffffffffbffffffffffffdccccccj
jjjjjdddddffffffffffdjjjjjjfffffffffffffffffffffffffffffffffffffffffffggggggfffggggggffffffffffffffffffffffbffffffffffffdccccccj
jjjjdddddfffffffffffdjjjjjjjfffffffffffffffffffffffffffffffffffffffffffffffffffffffffffffffffffffffffffffffbffffffffffffdccccccj
jjjdddddfffffffffffddjjjjjjjjffffffffffffffffffffffffffffffffffffffffffffffffffffffffffffffffffffffffffffffbffffffffffffdccccccj
jjjdddddffffffffffddddjjjjjjjjfffffffffffffffffffffffffffffffffffffffffffffffffffffffffffffffffffffffffffffbffffffffffffdccccccj
jjjjddddffffffffffddddjjjjjjjjjffffffffffffffffffffffffffffffffffffffffffffffffffffffffffffffffffffffffffffbffffffffffffdccccccj
jjjjjjddfffffffffffddddjjjjjjjjffffffffffffffffffffffffffffffffffffffffffffffffffffffffffffffffffffffffffffbffffffffffffdccccccj
jjjjjjjddfffffffffffddddjjjjjjjjfffffffffffffffffffffffffffffffffffffffffffffffffffffffffffffffffffffffffffbfffffffffffddccccccj
jjjjjjjjdfffffffffffddddjjjjjjjjjffffffffffffffffffffffffffffffffffffffffffffffffffffffffffffffffffffffffffbfffffffffffdcccccccj
jjjjjjjjdfffffffffffdddddjjjjjjjjffffffffffffffffffffffffffffffffffffffffffffffffffffffffffffffffffffffffffbfffffffffffdcccccccj
jjjjjjjddfffffffffffdddddjjjjjjjjjfffffffffffffffffffffffffffffffffffffffffffffffffffffffffffffffffffffffffbfffffffffffdcccccccj
jjjjjjjddffffffffffdddddddjjjjjjjjfffffffffffffffffffffffffffffffffffffffffffffffffffffffffffffffffffffffffbffffffffffddcccccccj
jjjjjjddfffffffffffdddddddjjjjjjjjfffffffffffffffffffffffffffffffffffffffffffffffffffffffffffffffffffffffffbffffffffffdccccccccj
jjjjjjddfffffffffdddddddddjjjjjjjjjffffffffffffffffffffffffffffffffffffffffffffffffffffffffffffffffffffffffbffffffffffdccccccccj
jjjjjddffffffffdddddddddddddjjjjjjjffffffffffffffffffffffffffffffffffffffffffffffffffffffffffffffffffffffffbffffffffffdccccccccj
jjjjddfffffffffddddddddddddddjjjjjjjfffffffffffffffffffffffffffffffffffffffffffffffffffffffffffffffffffffffbffffffffffdccccccccj
jjjkdfffffffffffffdddddddddddjjjjjjjfffffffffffffffffffffffffffffffffffffffffffffffffffffffffffffffffffffffbffffffffffdccccccccj
kkkkffffffffffffffffffddddddddjjjjjjfffffffffffffffffffffffffffffffffffffffffffffffffffffffffffffffffffffffbfffffffffddccccccccj
kkkdffffffffffffffffffffdddddddjjjjjfffffffffffffffffffffffffffffffffffffffffffffffffffffffffffffffffffffffbfffffffffdcccccccccj
kkkddffffffffffffffffffffffffdddjjjddfffffffffffffffffffffffffffffffffffffffffffffdddddddjjjddddfffffffffffbfffffffffdcccccccccj
kkkkdddfffffffffffffffffffffffddddddfffffffffffddddfffffffffffffffffffffffffffdddddddddjjjjjjdddddfffffffffbfffffffffdcccccccccj
jjjjjjdddddfffffffffffffffffffffffffffffffffffddjjddfffffffffffffffffffffffddddddddddjjjjjjjjjdddddffffffffbfffffffffdcccccccccj
jjjjjjjjjjdddddddddffffffffffffffffffffffffffddjjjjdddffffffffffffffffffdddddddddddjjjjjjjjjjjjdddddfffffffbffffffffddcccccccccj
jjjjjjjjjjjjjjjjjjddddffffffffffffffffffffffddjjjjjjjdddffffffffffffffdddddddddddjjjjjjjjjjjjjjjddddddfffffbffffffffdccccccccccj
jjjjjjjjjjjjjjjjjjjjjdddfffffffffffffffffffddjjjjjjjjjjddfffffffffffdddddddddddjjjjjjjjjjjjjjjjjjddddddffffbffffffffdccccccccccj
jjjjjjjjjjjjjjjjjjjjjjjddddffffffffffffffdddjjjjjjjjjjjjddddddddffdddddddddddjjjjjjjjjjjjjjjjjjjjjddddddfffbfffffffddccccccccccj
jjjjjjjjjjjjjjjjjjjjjjjjjjdddddffffffdddddjjjjjjjjjjjjjjjjjjjjjdddddddddddjjjjjjjjjjjjjjjjjjjjjjjjjjdddddffbfffffffdcccccccccccj
jjjjjjjjjjjjjjjjjjjjjjjjjjjjjjddddddddjjjjjjjjjjjjjjjjjjjjjjjjjjjddddddddjjjjjjjjjjjjjjjjjjjjjjjjjjjjdddddfbfffffffdcccccccccccj
jjjjjjjjjjjjjjjjjjjjjjjjjjjjjjjjjjjjjjjjjjjjjjjjjjjjjjjjjjjjjjjjjjjjjjjjjjjjjjjjjjjjjjjjjjjjjjjjjjjjjjjjjjjjjjjjjjjjjjjjjjjjjjjj
"}
