"a" = (/turf/simulated/wall/rock,/area/world/desert/exterior)
"b" = (/turf/simulated/wall/rock,/area/world/desert/exterior/village)
"c" = (/turf/simulated/floor/river,/area/world/desert/exterior)
"d" = (/turf/simulated/floor/asteroid,/area/world/desert/exterior)
"e" = (/turf/simulated/floor/asteroid,/area/world/desert/exterior/village)
"f" = (/turf/simulated/floor/colored/sand/desert,/area/world/desert/exterior)
"g" = (/turf/simulated/wall/brick/sand,/area/world/desert/exterior)
"h" = (/obj/effect/fake_lighting/gradient/black{icon_state = "gradient"; dir = 1},/turf/simulated/floor/colored/sand/desert,/area/world/desert/exterior)
"i" = (/obj/effect/fake_lighting/solid/black,/turf/simulated/floor/colored/sand/desert,/area/world/desert/exterior)
"j" = (/turf/simulated/wall/rock,/area/world/desert/cave)
"k" = (/turf/simulated/floor/asteroid,/area/world/desert/cave)
"l" = (/turf/simulated/wall/brick/sand,/area/world/desert/exterior/village/shop01)
"m" = (/obj/structure/smooth/table/wood/poor,/obj/structure/interactive/shop,/obj/item/weapon/melee/sword/sabre,/turf/simulated/floor/colored/sand/desert,/area/world/desert/exterior/village/shop01)
"n" = (/turf/simulated/floor/colored/sand/desert,/area/world/desert/exterior/village)
"o" = (/turf/simulated/floor/colored/sand/desert,/area/world/desert/exterior/village/shop01)
"p" = (/turf/simulated/floor/asteroid,/area/world/desert/exterior/village/shop01)
"q" = (/turf/simulated/wall/brick/sand,/area/world/desert/exterior/village/shop02)
"r" = (/turf/simulated/floor/colored/sand/desert,/area/world/desert/exterior/village/shop02)
"s" = (/turf/simulated/floor/asteroid,/area/world/desert/exterior/village/shop02)
"t" = (/obj/structure/smooth/table/wood/poor,/obj/structure/interactive/shop,/obj/item/clothing/overwear/armor/cult/old,/obj/item/clothing/overwear/armor/knight/magnus/red,/turf/simulated/floor/asteroid,/area/world/desert/exterior/village/shop02)
"u" = (/turf/simulated/wall/brick/sand,/area/world/desert/exterior/village/shop03)
"v" = (/turf/simulated/floor/colored/sand/desert,/area/world/desert/exterior/village/shop03)
"w" = (/obj/structure/smooth/table/wood/poor,/obj/structure/interactive/shop,/turf/simulated/floor/colored/sand/desert,/area/world/desert/exterior/village/shop03)
"x" = (/turf/simulated/floor/asteroid,/area/world/desert/exterior/village/shop03)
"y" = (/obj/structure/smooth/table/wood/poor,/obj/structure/interactive/shop,/obj/item/weapon/ranged/bullet/magazine/pistol,/turf/simulated/floor/colored/sand/desert,/area/world/desert/exterior/village/shop01)
"z" = (/obj/structure/smooth/table/wood/poor,/obj/structure/interactive/shop,/obj/item/weapon/ranged/magic/scroll/fireball/amount_3,/obj/item/weapon/ranged/magic/staff/fire,/obj/item/weapon/ranged/magic/tome/fireball,/turf/simulated/floor/asteroid,/area/world/desert/exterior/village/shop02)
"A" = (/obj/structure/smooth/table/wood/poor,/obj/structure/interactive/shop,/obj/item/magazine/pistol_10mm/surplus,/turf/simulated/floor/colored/sand/desert,/area/world/desert/exterior/village/shop01)
"B" = (/obj/structure/smooth/table/wood/poor,/obj/structure/interactive/shop,/obj/item/clothing/head/hat/wizard/red,/obj/item/clothing/head/hood/cult/old,/turf/simulated/floor/asteroid,/area/world/desert/exterior/village/shop02)
"C" = (/obj/structure/smooth/table/wood/poor,/obj/structure/interactive/shop,/obj/item/weapon/melee/torch,/turf/simulated/floor/colored/sand/desert,/area/world/desert/exterior/village/shop03)
"D" = (/obj/structure/smooth/table/wood/poor,/obj/structure/interactive/shop,/obj/item/radio,/turf/simulated/floor/colored/sand/desert,/area/world/desert/exterior/village/shop03)
"E" = (/obj/structure/smooth/table/wood/poor,/obj/structure/interactive/shop,/obj/item/clothing/back/storage/backpack,/turf/simulated/floor/colored/sand/desert,/area/world/desert/exterior/village/shop03)

(1,1,1) = {"
aaaaaaaaaaaaaaaaaaaaaaaaaaaaaaaaaaaaaaaaaaaaaaaaaaaaaaaaaaaaaaaaaaaaaaaaaaaaaaaaaabbbbbbbbbbbbeeebbbbbbbbbbbbbbbbccccccccccccccc
aaaaaaddaaaaaaaadddaddaaaaddaaaaaaaaaaaaaaaaaaaaaaaaaaaaaaaaaaaaaaaaaaaaaaaaaaaaaabbbbblllllbbeeebbeeeeebbbbbbbbbccccccccccccccc
adddddddaaaaddddddddddaaaddddaaaaaaddddddaaaaaaaaaaaaaaaaaaaaaaaaaaaaaaaaaaaddddaabbeeblyAmleeeeeeeeeeeeebbbbbbbbccccccccccccccc
aaddddddaaadddddddddddaaaddddaaaadddffffdddddaaaaaddddddddddddddddddddddddddddddaaeeeebloooleeeeeeeeeeeeeebbbbbbcccccccccccccccc
aadddddaaaaddddddddddddddddddaadddffffffffffddddddddffffffffffffffffffffffddddddddeeeeelooopeeeeeennneeeeeebbbbbcccccccccccccccc
aaddddaaaaddddddddddddddadddaaadfffffffffffffffffffffffffffffffffffffffffffffdddddeebbeloopleeeeeqqqqqeeeeeebbbccccccccccccccccc
aaddddaaaadddddaddddaaadddaaadddfffffffffffffffffffffffffffffffffffffffffffffffdddebbbeooppleeeenqrssseeenneebcccccccccccccccccc
aaddddaaaddddaaaaddaaadddaaaddffffffffffffffffffffffffffffffffffffffffffffffffffddbbbeeeeeeeeeennrrszqeennneeecccccccccccccccccc
aadddddadddddaaaaaaaadddaaaddffffffffffffffffffffffffffffffffffffffffffffffffffffdddeeeeeeeeeeennrrsBqeennnneecccccccccccccccccc
aaaddddaddffddaaaaaaddddaaddffffffffffffffffffffffffffffffffffffffffffffffffffffffddeeeeenneeeeenrsstqeennnneecccccccccccccccccc
aaaaddddddfffddddaaadddaaddffffffffffffffffffffffffffffffffffffffffffffffffffffffffdeeeennnneeeeeqqqqqeennnneecccccccccccccccccc
aaaaaddddfffffdddddaaaaaddffffffffffffffffffffffffffffffffffffffffffffffffffffffffffeeeeeennneeeenneeeeeenneeecccccccccccccccccc
aaaaaddddddddffffddaaaaddffffffffffffffffffffffffffffffffffffffffffffffffffffffffffdeeeeeeennneeeeeeeeeeeeeeeecccccccccccccccccc
aaaaaddaaaaadddffffddaadfffffffffffffffffffffffffffffffffffffffffffffffffffffffffffdbbbbeeeeeeeeeeeeenuuuuuunecccccccccccccccccc
aaadddaaaaaadddddfffddddfffffffffffffffffffffffffffffffffffffffffffffffffffffffffffdddbbbbeeeeeeeeeeenvwEDCveecccccccccccccccccc
aaaddddaaaaddddaddfffffffffffffffffffffffffffffffffffffffffffffffffffffffffffffffffffdddbbbbbeeeeeeeenvvvxxxeecccccccccccccccccc
aadddddaaadddddaaadffffffffffffffffffffffffffffffffffffffffffffffffffffffffffffffffffffdddbbbbbeeeeeeeuvvvvxeecccccccccccccccccc
aaaddddaaaddddaaaaaddffffffffffffffffffffffffffffffffffffffffffffffffffffffffffffffffffffdddbbbbbbebeeuuuuuxeecccccccccccccccccc
aaaadaaaaddddaaaaaaddffffffffffffffffffffffffffffffffffffffffffffffffffffffffffffffffffffffdddbbbeebbeeeeeeeeecccccccccccccccccc
aaaaaaaadddddaaaaaddffffffffffffffffffffffffffffffffffffffffffffffffffffffffffffffffffffffffddddbeebbbbbbeeeeecccccccccccccccccc
aaaaddddddddaaaaaddffffffffffffffffffffffffffffffffffffffffffffffffffffffffffffffffffffffffffffddddbbbbbbbbbbecccccccccccccccccc
aaaddddddddaaaadddffffffffffffffffffffffffffffffffffffffffffffffffffffffffffffffffffffffffffffffffddddbbbbbbbbcccccccccccccccccc
aaddddddddaaaaddfffffffffffffffffffffffffffffffffffffffffffffffffffffffffffffffffffffffffffffffffffffdddddaaddcccccccccccccccccc
adddddddaaaaaddffffffffffffffffffffffffffffffffffffffffffffffffffffffffffffffffffffffffffffffffffffffffffffffdcccccccccccccccccc
aadddddaaaaaddfffffffffffffffffffffffffffffffffffffffffffffffffffffffffffffffffffffffffffffffffffffffffffffffdcccccccccccccccccc
aaaaaaaaaaaadffffffffffffffffffffffffffffffffffffffffffffffffffffffffffffffffffffffffffffffffffffffffffffffffdcccccccccccccccccc
aaaaaaaaaaaddffffffffffffffffffffffffffffffffffffffffffffffffffffffffffffffffffffffffffffffffffffffffffffffffdcccccccccccccccccc
aaaaaaaaaaadfffffffffffffffffffffffffffffffffffffffffffffffffffffffffffffffffffffffffffffffffffffffffffffffffdcccccccccccccccccc
aaaaaaaaaaadfffffffffffffffffffffffffffffffffffffffffffffffffffffffffffffffffffffffffffffffffffffffffffffffffdcccccccccccccccccc
aaaaaaaaaaddfffffffffffffffffffffffffffffffffffffffffffffffffffffffffffffffffffffffffffffffffffffffffffffffffdcccccccccccccccccc
aaaaaaaaaadffffffffffffffffffffffffffffffffffffffffffffffffffffffffffffffffffffffffffffffffffffffffffffffffffdcccccccccccccccccc
aaaaaaaaaadffffffffffffffffffffffffffffffffffffffffffffffffffffffffffffffffffffffffffffffffffffffffffffffffffdcccccccccccccccccc
aaaaaaaaaddffffffffffffffffffffffffffffffffffffffffffffffffffffffffffffffffffffffffffffffffffffffffffffffffffdcccccccccccccccccc
aaaaaaaaddfffffffffffffffffffffffffffffffffffffffffffffffffffffffffffffffffffffffffffffffffffffffffffffffffffdcccccccccccccccccc
aaaaaaaadffffffffffffffffffffffffffffffffffffffffffffffffffffffffffffffffffffffffffffffffffffffffffffffffffffdcccccccccccccccccc
aaaaaaaddffffffffffffffffffffffffffffffffffffffffffffffffffffffffffffffffffffffffffffffffffffffffffffffffffffdcccccccccccccccccc
aaaaaaadfffffffffffffffffffffffffffffffffffffffffffffffffffffffffffffffffffffffffffffffffffffffffffffffffffffdcccccccccccccccccc
aaaaaaadfffffffffffffffffffffffffffffffffffffffffffffffffffffffffffffffffffffffffffffffffffffffffffffffffffffdcccccccccccccccccc
aaaaaaadfffffffffffffffffffffffffffffffffffffffffffffffffffffffffffffffffffffffffffffffffffffffffffffffffffffdcccccccccccccccccc
aaaaaaadfffffffffffffffffffffffffffffffffffffffffffffffffffffffffffffffffffffffffffffffffffffffffffffffffffffdcccccccccccccccccc
aaaaaaddfffffffffffffffffffffffffffffffffffffffffffffffffffffffffffffffffffffffffffffffffffffffffffffffffffffdcccccccccccccccccc
aaaaaadffffffffffffffffffffffffffffffffffffffffffffffffffffffffffffffffffffffffffffffffffffffffffffffffffffffdcccccccccccccccccc
aaaaaadffffffffffffffffffffffffffffffffffffffffffffffffffffffffffffffffffffffffffffffffffffffffffffffffffffffdcccccccccccccccccc
aaaaaadffffffffffffffffffffffffffffffffffffffffffffffffffffffffffffffffffffffffffffffffffffffffffffffffffffffdcccccccccccccccccc
aaaaaadffffffffffffffffffffffffffffffffffffffffffffffffffffffffffffffffffffffffffffffffffffffffffffffffffffffdcccccccccccccccccc
aaaaaadffffffffffffffffffffffffffffffffffffffffffffffffffffffffffffffffffffffffffffffffffffffffffffffffffffffdcccccccccccccccccc
aaaaaddffffffffffffffffffffffffffffffffffffffffffffffffffffffffffffffffffffffffffffffffffffffffffffffffffffffdcccccccccccccccccc
aaaaadfffffffffffffffffffffffffffffffffffffffffffffffffffffffffffffffffffffffffffffffffffffffffffffffffffffffdcccccccccccccccccc
aaaaadfffffffffffffffffffffffffffffffffffffffffffffffffffffffffffffffffffffffffffffffffffffffffffffffffffffffdcccccccccccccccccc
aaaaadfffffffffffffffffffffffffffffffffffffffffffffffffffffffffffffffffffffffffffffffffffffffffffffffffffffffdcccccccccccccccccc
aaaaadfffffffffffffffffffffffffffffffffffffffffffffffffffffffffffffffffffffffffffffffffffffffffffffffffffffffdcccccccccccccccccc
aaaaddfffffffffffffffffffffffffffffffffffffffffffffffffffffffffffffffffffffffffffffffffffffffffffffffffffffffdcccccccccccccccccc
aaaddffffffffffffffffffffffffffffffffffffffffffffffffffffffffffffffffffffffffffffffffffffffffffffffffffffffffdcccccccccccccccccc
aaddfffffffffffffffffffffffffffffffffffffffffffffffffffffffffffffffffffffffffffffffffffffffffffffffffffffffffdcccccccccccccccccc
aadffffffffffffffffffffffffffffffffffffffffffffffffffffffffffffffffffffffffffffffffffffffffffffffffffffffffffdcccccccccccccccccc
addffffffffffffffffffffffffffffffffffffffffffffffffffffffffffffffffffffffffffffffffffffffffffffffffffffffffffdcccccccccccccccccc
adfffffffffffffffffffffffffffffffffffffffffffffffffffffffffffffffffffffffffffffffffffffffffffffffffffffffffffdcccccccccccccccccc
adfffffffffffffffffffffffffffffffffffffffffffffffffffffffffffffffffffffffffffffffffffffffffffffffffffffffffffdcccccccccccccccccc
adfffffffffffffffffffffffffffffffffffffffffffffffffffffffffffffffffffffffffffffffffffffffffffffffffffffffffffdcccccccccccccccccc
adfffffffffffffffffffffffffffffffffffffffffffffffffffffffffffffffffffffffffffffffffffffffffffffffffffffffffffdcccccccccccccccccc
adfffffffffffffffffffffffffffffffffffffffffffffffffffffffffffffffffffffffffffffffffffffffffffffffffffffffffffdcccccccccccccccccc
adfffffffffffffffffffffffffffffffffffffffffffffffffffffffffffffffffffffffffffffffffffffffffffffffffffffffffffdcccccccccccccccccc
addffffffffffffffffffffffffffffffffffffffffffffffffffffffffffffffffffffffffffffffffffffffffffffffffffffffffffdcccccccccccccccccc
aaddfffffffffffffffffffffffffffffffffffffffffffffffffffffffffffffffffffffffffffffffffffffffffffffffffffffffffdcccccccccccccccccc
aaaddffffffffffffffffffffffffffffffffffffffffffffffffffffffffffffffffffffffffffffffffffffffffffffffffffffffffdcccccccccccccccccc
aaaadffffffffffffffffffffffffffffffffffffffffffffffffffffffffffffffffffffffffffffffffffffffffffffffffffffffffdcccccccccccccccccc
aaaadffffffffffffffffffffffffffffffffffffffffffffffffffffffffffffffffffffffffffffffffffffffffffffffffffffffffdcccccccccccccccccc
aaaadffffffffffffffffffffffffffffffffffffffffffffffffffffffffffffffffffffffffffffffffffffffffffffffffffffffffdcccccccccccccccccc
aaaaddfffffffffffffffffffffffffffffffffffffffffffffffffffffffffffffffffffffffffffffffffffffffffffffffffffffffdcccccccccccccccccc
aaaaadfffffffffffffffffffffffffffffffffffffffffffffffffffffffffffffffffffffffffffffffffffffffffffffffffffffffdcccccccccccccccccc
aaaaddfffffffffffffffffffffffffffffffffffffffffffffffffffffffffffffffffffffffffffffffffffffffffffffffffffffffdcccccccccccccccccc
aaaadffffffffffffffffffffffffffffffffffffffffffffffffffffffffffffffffffffffffffffffffffffffffffffffffffffffffdcccccccccccccccccc
aaaadffffffffffffffffffffffffffffffffffffffffffffffffffffffffffffffffffffffffffffffffffffffffffffffffffffffffdcccccccccccccccccc
aaaadffffffffffffffffffffffffffffffffffffffffffffffffffffffffffffffffffffffffffffffffffffffffffffffffffffffffdcccccccccccccccccc
aaaadffffffffffffffffffffffffffffffffffffffffffffffffffffffffffffffffffffffffffffffffffffffffffffffffffffffffdcccccccccccccccccc
aaaadffffffffffffffffffffffffffffffffffffffffffffffffffffffffffffffffffffffffffffffffffffffffffffffffffffffffdcccccccccccccccccc
aaaddfffffffffffffffffffffffffffffffffffffffffffgggfffffffffgggffffffffffffffffffffffffffffffffffffffffffffffdcccccccccccccccccc
aaddffffffffffffffffffffffffffffffffffffffffffffffggggfffggggffffffffffffffffffffffffffffffffffffffffffffffffdcccccccccccccccccc
aadffffffffffffffffffffffffffffffffffffffffffffffffgfffffffgfffffffffffffffffffffffffffffffffffffffffffffffffdcccccccccccccccccc
addffffffffffffffffffffffffffffffffffffffffffffffffgfgfffgfgfffffffffffffffffffffffffffffffffffffffffffffffffdcccccccccccccccccc
adfffffffffffffffffffffffffffffffffffffffffffffffffgfffffffgfffffffffffffffffffffffffffffffffffffffffffffffffdcccccccccccccccccc
adffffffffffffffffffffffffffffffffffffffffffffffffgggffgffgggffffffffffffffffffffffffffffffffffffffffffffffffdcccccccccccccccccc
adfffffffffffffffffffffffffffffffffffffffffffffffggfggfffggfggfffffffffffffffffffffffffffffffffffffffffffffffdcccccccccccccccccc
adfffffffffffffffffffffffffffffffffffffffffffffffgfffgfffgfffgfffffffffffffffffffffffffffffffffffffffffffffffdcccccccccccccccccc
adfffffffffffffffffffffffffffffffffffffffffffffffgfgfghhhgfgfgfffffffffffffffffffffffffffffffffffffffffffffffdcccccccccccccccccc
addffffffffffffffffffffffffffffffffffffffffffffffgfgfgiiigfgfgfffffffffffffffffffffffffffffffffffffffffffffffdcccccccccccccccccc
aadfffffffffffffffffffffffffffffffffffffffffffffggfgfgggggfgfggffffffffffffffffffffffffffffffffffffffffffffffdcccccccccccccccccc
aadfffffffffffffffffffffffffffffffffffffffffffffgffgfffffffgffgffffffffffffffffffffffffffffffffffffffffffffffdcccccccccccccccccc
aadfffffffffffffffffffffffffffffffffffffffffffffgfgggggggggggfgffffffffffffffffffffffffffffffffffffffffffffffdcccccccccccccccccc
aadfffffffffffffffffffffffffffffffffffffffffffffgfgfffgfffffgfgffffffffffffffffffffffffffffffffffffffffffffffdcccccccccccccccccc
aadfffffffffffffffffffffffffffffffffffffffffffffgfgfgggfgggfgfgffffffffffffffffffffffffffffffffffffffffffffffdcccccccccccccccccc
aadfffffffffffffffffffffffffffffffffffffffffffffgfgfgfffffgfgfgffffffffffffffffffffffffffffffffffffffffffffffdcccccccccccccccccc
aadfffffffffffffffffffffffffffffffffffffffffffffgfgfgfgggfgfgfgffffffffffffffffffffffffffffffffffffffffffffffdcccccccccccccccccc
aaddffffffffffffffffffffffffffffffffffffffffffffgfffgfffffgfffgffffffffffffffffffffffffffffffffffffffffffffffdcccccccccccccccccc
aaadffffffffffffffffffffffffffffffffffffffffffffggggggfffggggggffffffffffffffffffffffffffffffffffffffffffffffdcccccccccccccccccc
aaadfffffffffffffffffffffffffffffffffffffffffffffffffffffffffffffffffffffffffffffffffffffffffffffffffffffffffdcccccccccccccccccc
aaaddffffffffffffffffffffffffffffffffffffffffffffffffffffffffffffffffffffffffffffffffffffffffffffffffffffffffdcccccccccccccccccc
aaaadffffffffffffffffffffffffffffffffffffffffffffffffffffffffffffffffffffffffffffffffffffffffffffffffffffffffdcccccccccccccccccc
aaaadffffffffffffffffffffffffffffffffffffffffffffffffffffffffffffffffffffffffffffffffffffffffffffffffffffffffdcccccccccccccccccc
aaaaddfffffffffffffffffffffffffffffffffffffffffffffffffffffffffffffffffffffffffffffffffffffffffffffffffffffffdcccccccccccccccccc
aaaaaddffffffffffffffffffffffffffffffffffffffffffffffffffffffffffffffffffffffffffffffffffffffffffffffffffffffdcccccccccccccccccc
aaaaaadffffffffffffffffffffffffffffffffffffffffffffffffffffffffffffffffffffffffffffffffffffffffffffffffffffffdcccccccccccccccccc
aaaaaadffffffffffffffffffffffffffffffffffffffffffffffffffffffffffffffffffffffffffffffffffffffffffffffffffffffdcccccccccccccccccc
aaaaaadffffffffffffffffffffffffffffffffffffffffffffffffffffffffffffffffffffffffffffffffffffffffffffffffffffffdcccccccccccccccccc
aaaaaadffffffffffffffffffffffffffffffffffffffffffffffffffffffffffffffffffffffffffffffffffffffffffffffffffffffdcccccccccccccccccc
aaaaaaddfffffffffffffffffffffffffffffffffffffffffffffffffffffffffffffffffffffffffffffffffffffffffffffffffffffdcccccccccccccccccc
aaaaaaaddffffffffffffffffffffffffffffffffffffffffffffffffffffffffffffffffffffffffffffffffffffffffffffffffffffdcccccccccccccccccc
aaaaaaaadffffffffffffffffffffffffffffffffffffffffffffffffffffffffffffffffffffffffffffffffffffffffffffffffffffdcccccccccccccccccc
aaaaaaaadffffffffffffffffffffffffffffffffffffffffffffffffffffffffffffffffffffffffffffffffffffffffffffffffffffdcccccccccccccccccc
aaaaaaaddffffffffffffffffffffffffffffffffffffffffffffffffffffffffffffffffffffffffffffffffffffffffffffffffffffdcccccccccccccccccc
aaaaaaaddffffffffffffffffffffffffffffffffffffffffffffffffffffffffffffffffffffffffffffffffffffffffffffffffffffdcccccccccccccccccc
aaaaaaddfffffffffffffffffffffffffffffffffffffffffffffffffffffffffffffffffffffffffffffffffffffffffffffffffffffdcccccccccccccccccc
aaaaaaddfffffffffffffffffffffffffffffffffffffffffffffffffffffffffffffffffffffffffffffffffffffffffffffffffffffdcccccccccccccccccc
jjjjaddffffffffffffffffffffffffffffffffffffffffffffffffffffffffffffffffffffffffffffffffffffffffffffffffffffffdcccccccccccccccccc
jjjjddfffffffffffffffffffffffffffffffffffffffffffffffffffffffffffffffffffffffffffffffffffffffffffffffffffffffdcccccccccccccccccc
jjjkdffffffffffffffffffffffffffffffffffffffffffffffffffffffffffffffffffffffffffffffffffffffffffffffffffffffffdcccccccccccccccccc
kkkkfffffffffffffffffffffffffffffffffffffffffffffffffffffffffffffffffffffffffffffffffffffffffffffffffffffffffdcccccccccccccccccc
kkkdfffffffffffffffffffffffffffffffffffffffffffffffffffffffffffffffffffffffffffffffffffffffffffffffffffffffffdcccccccccccccccccc
kkkddffffffffffffffffffffffffffffffffffffffffffffffffffffffffffffffffffffffffffffffffffffffffffffffffffffffffdcccccccccccccccccc
kkkkdddffffffffffffffffffffffffffffffffffffffffffffffffffffffffffffffffffffffffffffffffffffffffffffffffffffffdcccccccccccccccccc
jjjjjadddddffffffffffffffffffffffffffffffffffffffffffffffffffffffffffffffffffffffffffffffffffffffffffffffffffdcccccccccccccccccc
aaaaaaaaaadddddddddffffffffffffffffffffffffffffffffffffffffffffffffffffffffffffffffffffffffffffffffffffffffffdcccccccccccccccccc
aaaaaaaaaaaaaaaaaaddddfffffffffffffffffffffffffffffffffffffffffffffffffffffffffffffffffffffffffffffffffffffffdcccccccccccccccccc
aaaaaaaaaaaaaaaaaaaaadddfffffffffffffffffffffffffffffffffffffffffffffffffffffffffffffffffffffffffffffffffffffdcccccccccccccccccc
aaaaaaaaaaaaaaaaaaaaaaaddddffffffffffffffffffffffffffffffffffffffffffffffffffffffffffffffffffffffffffffffffffdcccccccccccccccccc
aaaaaaaaaaaaaaaaaaaaaaaaaadddddffffffffffffffffffffffffffffffffffffffffffffffffffffffffffffffffffffffffffffffdcccccccccccccccccc
aaaaaaaaaaaaaaaaaaaaaaaaaaaaaadddffffffffffffffffffffffffffffffffffffffffffffffffffffffffffffffffffffffffffffdcccccccccccccccccc
aaaaaaaaaaaaaaaaaaaaaaaaaaaaaaaaddfffffffffffffffffffffffffffffffffffffffffffffffffffffffffffffffffffffffffffdcccccccccccccccccc
"}
