"a" = (/turf/simulated/floor/chasm,/area/world/mountain/exterior)
"b" = (/turf/simulated/wall/rock/snow,/area/world/mountain/exterior)
"c" = (/mob/living/simple/npc/bear/snow,/turf/simulated/floor/colored/snow,/area/world/mountain/exterior)
"d" = (/turf/simulated/wall/rock/basalt,/area/world/mountain)
"e" = (/obj/structure/scenery/snow_bush,/turf/simulated/floor/colored/snow,/area/world/mountain/exterior)
"f" = (/obj/structure/scenery/pinetrees,/turf/simulated/floor/colored/snow,/area/world/mountain/exterior)
"g" = (/obj/structure/interactive/lighting/streetlamp/snow,/turf/simulated/floor/colored/snow,/area/world/mountain/exterior)
"h" = (/turf/simulated/wall/rock/basalt,/area/world/mountain/interior/cave)
"i" = (/turf/simulated/floor/basalt,/area/world/mountain/interior/cave)
"j" = (/turf/simulated/floor/colored/snow,/area/world/mountain/exterior)
"k" = (/obj/structure/scenery/snow_grass,/turf/simulated/floor/colored/snow,/area/world/mountain/exterior)
"l" = (/turf/simulated/wall/rock,/area/world/mountain/exterior)
"m" = (/turf/simulated/wall/rock/snow,/area/world/mountain/interior/cave)
"n" = (/turf/simulated/floor/colored/dirt/snow,/area/world/mountain/exterior)
"o" = (/turf/simulated/floor/colored/snow,/area/world/mountain/interior/cave)
"p" = (/turf/simulated/floor/ice,/area/world/mountain/exterior)
"s" = (/obj/structure/scenery/rocks,/turf/simulated/floor/colored/dirt/snow,/area/world/mountain/exterior)
"t" = (/turf/simulated/floor/colored/snow,/area/world/mountain/exterior/village)
"u" = (/turf/simulated/wall/wood/brown,/area/world/mountain/interior/bar)
"v" = (/obj/structure/scenery/snow_grass,/turf/simulated/floor/colored/snow,/area/world/mountain/exterior/village)
"w" = (/turf/simulated/wall/wood/brown,/area/world/mountain/interior/cave)
"y" = (/turf/simulated/wall/rock/snow,/area/world/mountain)
"z" = (/turf/simulated/wall/rock,/area/world/mountain)
"A" = (/turf/simulated/floor/cave_dirt,/area/world/mountain/interior/cave)
"B" = (/turf/simulated/wall/rock,/area/world/mountain/interior/cave)
"C" = (/obj/structure/scenery/rocks,/turf/simulated/floor/cave_dirt,/area/world/mountain/interior/cave)
"D" = (/turf/simulated/floor/colored/dirt/snow,/area/world/mountain/exterior/village)
"E" = (/turf/simulated/floor/ice,/area/world/mountain/exterior/village)
"F" = (/obj/structure/scenery/pinetrees,/turf/simulated/floor/colored/snow,/area/world/mountain/exterior/village)
"G" = (/obj/structure/interactive/lighting/streetlamp,/turf/simulated/floor/colored/dirt/snow,/area/world/mountain/exterior/village)
"H" = (/obj/structure/scenery/snow_bush,/turf/simulated/floor/colored/snow,/area/world/mountain/exterior/village)
"I" = (/obj/structure/interactive/wishgranter/normal/northern_heights,/turf/simulated/floor/colored/dirt/snow,/area/world/mountain/exterior/village)
"J" = (/obj/structure/interactive/lighting/streetlamp/snow,/turf/simulated/floor/colored/snow,/area/world/mountain/exterior/village)
"K" = (/turf/simulated/floor/wood/brown,/area/world/mountain/interior/bar)
"L" = (/obj/structure/smooth/table/wood,/turf/simulated/floor/wood/brown,/area/world/mountain/interior/bar)
"M" = (/turf/simulated/wall/wood/brown,/area/world/mountain/interior/shack)
"N" = (/turf/simulated/floor/wood/brown,/area/world/mountain/interior/shack)
"O" = (/turf/simulated/floor/river,/area/world/mountain/exterior)

(1,1,1) = {"
hhhhhhhhhhhhhhhhhhhhhhhhhhhddddddyyyyyyyyyyyyyyyyyyyyyyyyyyyyyyyyyyyyyyyyyyyyyyyyyyyyyyyyyyyyyyyyyyyyyyyyyyyyyyyyyyyyyyyyyyyyyyy
hhhhhhhiiiiiihhhhhhhhhhhhhhbbbbbbbaaaaabbbbbbbbbbbbbbbbbbbbbbbbbbbbbbbbbbbbbbbbbbbbbbbbbbbbbbbbbbbbbbbbbbbbbbbbbbbbbbbbbbbbbbbby
hhhhiiiiiiiihhhhhiihhhhhhhbbbaaaaaaaaaaabbbbbbbbbbbbbbbaaaaaaaaaaaabbbbbbbbbbbbbbbbbbbbbbbbbbbbbbbbbbbbbbbbbbbbbbbbbbbbbbbbbbbby
hhhiiiiiiiihhhhiiiiihhhhhbbbaaaaaaaaaaaaaabbbbbbbbbaaaaaaaaaaaaaaaaaabbbbbbbbbbbbbbbbbbbbbbbbbbbbbbbbbbbbbbbbbbbbbbbbbbbbbbbbbby
hhiiiiiiiihhhhhiiiiiihhhhbbbaaaaaaaaaaaaaaabbbbaaaaaaaaaaaaaaaaaaaaaaaaabbbbbbbbbbbbbbbbbbbbbbbbbbbbbbbbbbbbbbbbbbbbbbbbbbbbbbby
hiiiiiiiihhhhhiiiiiiihhhbbaaaaaaaaaaaaaaaaaabaaaaaaaaaaajjjjjaaaaaaaaaaaaabbbbbbbbbbbbbbbbbbbbbbbbbbbbbbbbbbbbjjbbbbbbbbbbbbbbby
iiiiiiiihhhhhiiiiiiiihhhbaaaaaaaaaaaaaaaaaaaaaaaaajjjjjjjjjjjjjjjjaaaaaaaaabbbbbbbbbbbbbbbbbbbbbbbbjjjjjjjjjjjjjjjbbbbbbbbbbbbby
iiiiiiiihhhhiiiiiiiiihhbbaaaaaaaaaaaaaaaaaaaaaaajjjpppjjjjjjjjjejjaaaaaaaaaabbbbbbbbbbbbbbbbbbjjjjjjjjjjjjjjjjjjjjjjbbbbbbbbbbby
iiiiiiiiiiihiiiiiiiihhbbaaaaaaaaaaaaaaaaaaaaaaajjjpppppjjjjjjjjjjjjaaaaaaaaaaabbbbbbbbbbbbbjjjjjjjjjjjjjjjjjjjjjjjjjjbbbbbbbbbby
iiiiiiiiiiiiiiiiiihhhhbaaaaaaaaaaaaaaaaaaaaaaajjjpppppjjjjjfjjjjjjjjjjjjaaaaaaabbbbbbbbbbbjjjjjjjjjjjjjjjjjjjjjjjjjjjjbbbbbbbbby
iiiihhiiiiiiiihhiihhhbbaaaaaaaaaaaaaaaaaaaaaajjjpppppjjjejjjjjjjjfjjjjjjjaaaaaaabbbbbbbbbbjjjjjjjjjjjjjjjjjjjjjjjjjjjjjbbbbbbbby
iiihhhhhiiiiihhhhihhhbaaaaaaaaaaaaaaaaaaaaaajjjjpppppjjjjjjjjjjjjjjjjjjjjaaaaaaaajbbbbbbbbjjjjjjjjjjjjjjjjjjjjjjjjjjjjjjbbbbbbby
hiiiihhhiiiiihhhhhhhbbaaaaaaaaaaaaaaaaaaaaajjjjpppppjjjjjjjjjjjjjjjjjjjjjjaaaaaaajjbbbbbbjjjjjjjjjjjjjjjjjjjjjjjjjjjjjjjjbbbbbby
hiiiiihhhiiiiihhhhhhbaaaaaaaaaaaaaaaaaaaaaajjjjpppjjjjjjjjjjjjjjjjjjjjjjjjjaaaaaajjjbbbbbjjjjjjjjjjjjjjjjjjjjjjjjjjjjjjjjjbbbbby
hhiiiiihhhhiiiihmhhbbaaaaaaaaaaaaaaaaaaaaaajjjjpjjjjjjjjjjjjjjfjjfjjjjfjejjaaaaaajjjbbbbjjjjjjjjjjjjjjjjjjjjjjjjjjjjjjjjjjjbbbby
hiiiiiihhhhhiiiommhbaaaaaaaaaaaaaaaaaaaaaaajjjjjjjjjjjjfjjjfjjjjjjjjjjjjjjjaaaaajjjjjbbbjjjjjjjjjjjjjjjjjjjjjjjjjjjjjjjjjjjbbbby
hiiiiiihhhhhooooommbaaaaaaaaaaaaaaaaaaaaaaajjjjjjjjjjjjjjjjjjjjejjjjjjjjjjjaaaaajjjjjjbjjjjjjjjjjjjjjjjjjjjjjjjjjjjjjjjjjjjjbbby
hiiiiiihhhhhmmooojbbaaaaaaaaaaaaaaaaaaaaaajjjjjjjjjjjjjjjjjjjjjjjjjjjjfjjjjaaaaajjjjjjjjjjjjjjjjjjjjjjjjjjjjjjjjjjjjjjjjjjjjbbby
hiiiiihhhhhhhmoojjbaaaaaaaaaaaaaaaaaaaaaajjjjjjfjjjejjjfjjjjjjjjjjjjjjjjjjaaaaajjjjjjjjjjjjjjjjjjjjjjjjjjjjjjjjjjjjjjjjjjjjjjbby
hhhiihhhhhhhhbbjjjjaaaaaaaaaaaaaaaaaaaaaajjjjjjjjjjjjjjjjjjjjjjjjjfjjjjjjjaaaaajjjjjjjjjjjjjjjjjjjjjjjjjjjjjjjjjjjjjjjjjjjjjjbby
hhhhhhbbbbbbbbbbjjjjaaaaaaaaaaaaaaaaaaaajjjjjjjjjjjjjjjjjjjjjjjjjjjjjjjjjaaaajjjjjjjjjjjjjjjjjjjjjjjjjjjjjjjjjjjjjjjjjjjjjjjjbby
hhhhhbbbbbbbbbbbjjjjaaaaaaaaaaaaaaaaaaaajjjjjjjjjjjjjjjjjejjjfjjjjjjjjaaaaaaajjjjjjjjjjjjjjgjjjjjjjjjjjjjjjjjjjjjjjjjjjjjjjjjjby
hhhbbbbbbbaabbbajjjjjaaaaaaaaaaaaaaaaajjjjjjjjjjjjjfjjjjjjjjjjjjjjjjaaaaaaaaajjjjjjjjjjjjjjjjjjjjjjjjjjjjjjjjjjjjjjjjjjjjjjjjjby
dbbbbbbbaaaaaaaaajjjjaaaaaaaaaaaaaaaaajjjjjjfjjjjjjjjjjjjjjjjjjjjjjjaaaaaaajjjjjjjjjjjjjjjjjjjbbbbjjjjjjjjjjjjjjjjpppjjjjjjjjbby
ybbbbaaaaaaaaaaaaajjjjaaaaaaaaaaaaaajjjjjjjjjjjjfjjjjjjjjjjjjaaajjjjaaaaaajjjjjjjjjjjjjjjjjjjjbbbbbjjjjjjjjpppppppppppjjjjjjbbby
ybbbaaaaaaaaaaaaaajjjjjaaaaaaaaaaaaajjjjjjjjjjjjjjjjjjjfjjjjaaaajjjjaaaaajjjjjjjjjjjjjjjjjjjjbbbbbbjjjjjjppppppppppppjjjjjjbbbby
ybbaaaaaaaaaaaaaaaajjjjaaaaaaaaaaajjjjjejjjjjjjjjjjjjjjjjjjaaajjjjjjjjjjjjjjjjjjjjjjjjjjjjjjjbbbbbbbjjjjpppppppppppppjjjjjbbbbby
ybaaaaaaaaaaaaaaaaaajjjjaaaaaaaaaajjjjjjjjjjjjjjjjjjjjjjjaaaajjjjjjjjjjjjjjjjjjjjjjjjjjjjjjjjbbbbbbbbjjjppppppppppppjjjjbbbbbbby
ybaaaaaaaaaaaaaaaaaajjjjajjjfjjjjjjjjjjjjjjjjjjjjjjjjjjjjaaaajjjjjjjjjjjjjjjjjjjjjjjjjjjjjjjjjbbbbbbbbjjjpppppppppjjjjbbbbbbbbby
yaaaaaaaaaaaaaaaaaaaajjjjjjjjjjjjjjjjfjjjjjjjjjjjfjjjaajaaaaajjjjjjjjjjjjjjjjjjjjjjjjjjjjjjjjjjbbjjbbbbjjjjjjjjjjjjbbbbbbbbbbbby
yaaaaaaaaaaaaaaaaaaaajjjjjjjjjjjjjjjjjjjjjjjjjjjjjjjjaaaaaaaajjjjjjejjjjjjjjjjjjjjjjjjjjjjjjjjjjjjjbbbbbbbbbbbbbbbbbbbbbbbbbbbby
ybaaaaaaaaaaaaaaaaajjjjjjfjjjjjjjjjjjjjjjjjjjjjjjjjjaaaaaaaaaajjjjjjjjjjjjjjjjjjjjjjjjjjjjjjjjjjjjjjbbbbbbbbbbbbbbbbbbbbbbbbbbby
ybaaaaaaajaaaaaajjjjjjjjjjjjjfjjjjjjjjfjjjjjjjjjjjjaaaaaaaaaaajjjjjjjjjjjjjjjjjjjjjjjjjjjjjjjjgjjjjjjjbbbbbbbbbbbbbbbbbbbbbbbbby
ybbaaaaajjjjaajjjjfjjjjjjjjjjjjjjjjjjjjjjjjjjjjjjjaaaaaajaaaaajjjjjjjjjjjjjjjjjjjjjjjjjjjjjjjjjjjjjjjjjjbbbbbbbbbbbbbbbbbbbbbbby
ybbbaajjjjjjjjjfjjjjjjfjjjjjjjjjjjjjjjjjjjfjjjjjjjaaaajjjjaaaaaajjjjjjjjjjjjjjjjjjjjjjjjjjjjjjjjjjjjjjjjjbbbbbbbbbbbbbbbbbbbbbby
ybbbajjjjjjjjjjjjjjjjjjjjjjjjjjjjfjjjjjjjjjjjjjjaaaaajjjjjjaaaaajjjjjjjjjjjjjjjjjjjjjjjjjjjjjjjjjjjjjjjjjjbbbbbbbbbbbbbbbbbbbbby
ybbbajjjjpppppjjjjjjjjjjjjjjjjjjjjjjfjjjjjjjjjjjaaaajjjjjjjjaaaajjjjjjjjjjjjjjjjjjjjjjjjjjjjjjjjjjjjjjjjjjjbbbbbbbbbbbbbbbbbbbby
ybbbjjjjpppppppjjjjfjjjjjjjjjjjjjjjjjjjjjjjjjjjjaaajjjjjjjjjaaaaajjjjjjjjjjjjjjjjjjjjjjjjjjjjjjjjjjjjjjjjjjjbbbbbbbbbbbbbbbbbbby
ybbbjjjjpppppppjjjjjjjjjjfjjjjfjjjjjjjjjjjjjjjjjaaajjjjjjjjjjaaaajjjjjjjjjjjjjjjjjjjjjjjjjjjjjjjjjjjjjjjjjjjjbbbbbbbbbbbbbbbbbby
ybbbjjjjppppppppjjjjjjjjjjjjjjjjjjjjjjjjjjjjfjjjaajjjjjjjjjjjaaaajjjjjjjjjjjjjjjjjjjjjjjjjjjjjjjjjjjjjjjjjjjjjjbbbbbbbbbbbbbbbby
ybbjjjjjpppppppjjjjjjjjjjjjjjjjjjjjjjfjjjjjjjjjaaajjjjjjjjjjjaaaajjjjjjjjjjjjjjjjjjjjjjjjjjjjjjjjjjjjjjjjjjjjjjjbbbbbbbbbbbbbbby
ybbjjjjjpppppppjjjjjjjjjjjjjjjjjjjjjejkkkkkkjjjaaajjjjjjjjjjjjaaajjjjjjjjjjjjjjjjjjjjjjjjjjjjjjjjjjjjjjjjjjjjjjjjjbbbbbbbbbbbbby
ybbjjjjjpppppppjjjjjjjjjjjjjjjjjjfjjkkkkkkkkjjjaaajjjjjjjjjjjjaaajjjjjjjjjjjjjjjjjjjjjjjjjjjjjjjjjjjjjjjjjppjjjjjjjbbbbbbbbbbbby
ybbjjjjjppppppjjjjjjjfjjjjjjjjjjjjjkkkkkkkkkjjjaaajjjjjjjjjjjjaaajjjjjjjjjjjjjjjjjjjjjjjjjjjjjjjjjjjjjjjjjppppjjjjjjbbbbbbbbbbby
ybbjjjjjpppppjjjejjjjjjjjjfjjjjjjkkkkkkkkkkkjjjaaajjjjjjjjjjjjaaajjjjjjjjjjjjjjjjjjjjjjjjjjjjjjjjjjjjjjjjpppppppjjjjjbbbbbbbbbby
ybbbjjjjjjjjjjjjkkkjjjjjjjjjjfjjkkkkkkkkkkkjjjjaaaajjjjjjjjjjaaaabbbjjjjjjjjjjjjjjjjjjjjjjjjjjjjjjjjjjjjpppppppppjjjjjjbbBBBBBBz
ybbbjjjjjjjjjjkkkkkjejjjjjjjjjjjkkkkkkkkkkkjfjbbbbbbbbAAAAbbbbbbbbbbbbjjjjjjjjjjjjjjjjjjjjjjjjjjjjjjjjppppppppppppjjjjjjjjBBBBBz
ybbbbbjjjjejjkkkkkkkkjjjjjjjjjjekkkkkkkkkkjjjbbbBBBBBBAAAABBBBBBBBBBbbbbbbbjjjjjjjjjjjjjjjjjjjjjjjjjjpppppppppppppjjjjjjjjjBBBBz
ybbbbbjjjjjjkkkkkkkkkjjjjjfjjjjjkkkkkkkkkjjbbbBBBBBBBBAAAABBBBBBBBBBBbbbbbbbbbjjjjjjjjjjjjjjjjjjjjjjjpppppppppppppjjjjjjjjjjABBz
ybbbbbjjjjkkkkkkkkkjjjjjjjjjjjjjjjkkjkkejbbbbbBBBBBBBAAAAAAAABBBBBBBBbbbbbbbbbbbjjjjjjjjjjjjjjjjjjjjjjppppppppppppjjjjbjjBAAAABz
ybbbbbjjjjjkkjjejjjjjjjfjjjjjjjjjjjjjjjjbbbbbbBBBBBAAAAAAAAAAABBBBBBBBBBBbbbbbbbbjjjjjjjjjjjjjgjjjjjjjjppppppppppjjjjbbbbBBAAAAz
ybbbbbjjjjjjjjjjjjjjjjjjjjjjjfjjfjjjfjjbbbbbbbBBBBAAAAAAAAAAAAAAAAAABBBBBBbbbbbbbbjjjjjjjjjjjjjjjjjjjjjjppppppppjjjjbbbBBBBAAAAz
ybbbbbbbjjjjjppppppppppppppppppppjjjjjbbbBBBBBBBBBAAAAAAAAAAAAAAAAAABBBBBBBBBBbbbbbjjjjjjjjjjjjjjjjjjjjjjjpppppjjjjbbbbBBBBBAAAz
ybbbbbbbjppppppppppppppppppppppppppjjbbbbBBBBBBBBBAAAAAAAAAAAAAAAAABBBBBBBBBBBbbbbbbjjjjjjjjjjjjjjjjjjjjjjpppjjjjjbbbbBBBAABBAAz
ybbbbbbpppppppppppppppppppppppppppppjbbbbBBBAABBBAAAAAAAAAAAAAAAAAAABBBBBBBBBBBBBbbbbjjjjjjjjjjjjjjjjjjjjjjjjjjjjbbbBBBBAABBAAAz
ybbbbbbppppppppppppppppppppppppppppppbbbbBAAAABBAAAAAAAAAAAAAAAAAAAAAAABBBBBBBBBBbbbbbjjjjjjjjjjjjjjjjjjjjjjjjjjbbBBBBAAAABBAAAz
ybbbbbpppppppppppppppppppppppppppppbbbbbbBAAAAAAAAAAAAAAAAAAAAAAAAAAAAAABBBBBBBBBbbbbbjjjjjjjjjjnnjjjjjjjjjjjjjbbbBBAAAABBBBAABz
ybbbbbbpppppppppppppppppppppppppppbbbbBBBBAAAAAAAAAAAAAAAAAAAAAAAAAAAAAAAABBBBBBBBbbbbjjjjjjjjjjnjjjjjjjjjjjjjbbbbBBAAAABBBAAABz
ybbbbbbppppppppppppppppppppppppppbbbbbBBAAABBBBBBBBBBBBBBBBBBBBBAABAAAAAAAABBBBBBBbbbbbjjjjjjjjjnjjjjjjjjjjjjbbbBBBAABAABBAAABBz
ybbbbbpppppppppppppppppppppppppppbbBBBBBABBBBBBBBBBBBBBBBBBBBBBBBBBBBBBAAAABBBBBBBBbbbbjjjjjjjjjnjjjjjjjjjjjjbbbBBAABBAAAAAABBBz
ybbbbbpppppppppppppppppppppppppppbbBAAAAABBBAAAAABBBBBBBBBAAAAAAAAAAAAAAAAAABBBBBBBbbbbjjjjjjjjjnjjjjjjjjjjjbbbbBBAABBAAAAABBBBz
ybbbbppppppppppppppppppppppppppppbbBAAAABBAAAAAAABBBAAAAAAAAAAAAAAAAAAAAABBBBBBBBBBbbbbbjjjjjjjngjjjjjjjjjjjbbbbBBBBBAAAAABBBBBz
ybbbbbpppppppppppppppppppppppppppbbBAAAABBAAAAAAAAAAAAAAAABAABBBBBBBBBBBABBBBBBBBBBbbbbbjjjjjjnjjjjjjjjjjjjbbbbbBBBBBAAABBBBBBBz
ybbbbbbppppppppppppppppppppppppppbbBBAAABAAAAABAAAAAAAABBBBBBBBBBBABBBBBBBBBBBBBBBBbbbbbjjjjjnnjjjjjjjjjjjjbbbbbBBBBAAABBBBBBBBz
ybbbbbpppppppppppppppppppppppppppbbbBBABBAAAABBBBAABBBBBBBBBAAAAAAAAAAABBBBBBAAAABBbbbbbjjjjjnjjjjjjjjjjjjbbbbbbBBBBAABBBBBBBBBz
ybbbbbbpppppppppppppppppppppppppppbbBBBBBAAABBBBBBBBBBBABBAAAAAAAAAAAAABBBBBAAAAAABbbbbbjjjjnnjjjjjjjjjjjjbbbbbbBBBAAABBBBABBBBz
ybbbbbbpppppppppppppppppppppppppppbbBBBBBAAABBBBBBBBAAAAAAAABBBBBBBBBAAAABAAAAAAAABbbbbbjjjjnjjjjjjjjjjjjbbbbbbbBBBAAABBAAAABBBz
ybbbbbbbppppppppppppppppppppppppppbbbbBBBAAABBBBBBBAAAAAAABBBBBBBBBBBBAAAAAAAAAAAABbbbbbjjjjnjjjjjjjjjjjbbbbBBBBBAAAABBBAAAAABBz
ybbbbbbbpppppppppppppppppppppppppppbbbBBBBAAAABBBBAAAAAAABBBAAAAABBBBBAAAAAAAAAAABBbbbbbjjjnjjjjjjjjjjjbbbbbBBBBBAAABBBBAAAAAABz
ybbbbbbppppppppppppppppppppppppppppbbbbbBBAAAAAAAAAAAABBBBAAAAAAABBBBBBAABBBBAAABBBbbbbjjjjjjjjjjjjjjbbbbbbbBBBBAAAABBBBAAAAAABz
ybbbbbppppppppppppppppppppppppppppppbbbbBBBAAAAAAABBBBBBBAAAAAAAAABBBBAAABBBBBBBBBBbbbbjjjnjjjjjjjbbbbbbbbbbBBBBAAABBBBBAAAAAABz
ybbbbppppppppppppppppppppppppppppppjbbbbBBBBAAAAABBBBBBBAAAAABBAAAAAAAAAAAAABBBBBBBbbbbjjjnjjjjjbbbbbbbbbbBBBBBBAAABBBBAAAAAAABz
ybbbbbbpppppppppppppppppppppppppjjjjbbbbBBBBBAABBBBBBBBAAAAABBBAAAAAAAAAAAAAABBBBBBbbbbjjnnjjjjbbbbbbbbbbbBBAAAAAAABBBAAAAAAAAAz
ybbbbbppppppppppppppppppppppppjjjjjjbbbbBBBBBBBBBBBBBAAAAAABBBBAAAAAAAAAAAAAABBBBBBbbbbjjnjjjjbbbbbbbbbbBBBBAAAAAABBBBAAAAAAAAAz
ybbbbbbppppppppppppppppppppjjjjjjjjjjjjbbbBBBBBBBBBBAAAAABBBBBAAAAAAABBBBAAAABBBBBbbbbjjjnjjjbbbbbbbbbbbBBBBAAAABBBBBAAAAAAAAAAz
ybbbbbpppppppppppppppppppjjjjkjjjjjjjjjjjbbbBBBBBBBAAAAABBBBAAAAAAAABBBBBAAAABBBBBbbbbjjjnjjjbbbbbbBBBBBBBAAAABBBBBBBAAAAAAAAABz
ybbbbbpppppppppppppppppjjjjfjkjfjjjjkjjjjjbbbBBBBBBAAAABBBBAAAAAAAAABBBBBAAABBBBBBbbbbjjnjjjbbbbbbbBBBBBBAAAAAABBBBBBAAAAAAAAABz
ybbbbbppppppppppppppjjjjjjjjkkkjjjfkkjjjjjjbbbbBBBBAAAABBBBAAAAAAAABBBBAAABBBBBBBBbbbjjnnjjjbbbbbbBBBBBBAAAAAAABBBBBBBAAAAAAAABz
ybbbbpppppppppppppjjjkjfkkkkkjkkfjkkjjjjjjjjbbbBBBBAAAABBAAAAAAABBBBBBAAAABBBBBBBBbbbjjnjjjbbbbbbbBBBBAAAAABBAAAABBBBBAAAAAAAABz
ybbbppppppppppppjjkjjkkkkkkjjjjkjjkjjfjjjjjjbbbbBBBBAAABBAAAAAABBBBBAAAAABBBBBBBBbbbjjnnjjjbbbbBBBBBBAAABBBBBBAAAABBBBAAAAAAAABz
ybbbbppppppppppjjjkkfkkkjkjjjfjkkkkjjjjjjfjjjbbbbbBBAAABBAAAAAABBBBBAAAABBBBBBBBbbjjjjngjjjbbbbBBABBBAAABBBBBBAAAABBBBAAAAAAAABz
ybbbppppppppppjjjfjkkkjjjkkfjjkkjkkjjkkkkjjjjjjbbbBBBBBBBAAAAABBBBBBBBBBBBBBBBbbbjjjjnnjjjjbbbbBAAAAAAABBBAAABBBAAABBBBAAAAAAAAz
ybbbpppppppppjjjjkkkkjjjjjkjjjkjfjkfkkjjkkkjfjejjbbbbbbbMMMNMMMMMMMMBBBBBBBbbbbjjjjjjnjjjjjbbbbBAAAAAAAABBAAAAABAAABBBBBAAAAAAAz
ybbbpppppppppjejjkjjjjjjjjkkjjkkkjkkkjfkkjkkkkjjejjbbbbbMNNNNNNNNNNMBBBBBbbbjjjkjjjjnnjjjjjbbbbBAAAAAAAABBAAAAABAAAABBBBAAAAAAAz
ybbbppppppppjjjjjkkfjjjjjfkjjjkjkkkkjjjkjjjkjkkjjjjejbbbMNNNNNNNNNNMbbbbbbjjjjkkjjjnnjjjjjjbbbbBBBABBBAABBBAABBBBAAABBBBAAAAAAAz
ybbbpppppppjjjjjjjkkkjjjjkkjfjkkjjkjjjkkjfjkjjkkjjjjjjjjMNNNNNNNNNNMjjjjjjjjkkkkjjnnjjkkjjjbbbbBBBBBBBAAABBBABBBBAABBBBBAAAAAABz
ybbbpppppppjjjjfjjjjkkkkkkjjjkkjfjkjjjjkkjjkjfjkfjkjjjjjMNNNNNNNNNNMjjjjjkkkkkkkjnnjjkjjjjjbbbbBBBBBBBAAAABBABBBAAAABBBBAAAAAABz
ybbbpppppppjjjjjjfjjjjkkkjjjkkjjjjjkfjjjkkkkjjkkkkkjfjjjMNNNNNNNNNNMjjjkkkjkkkkjjnnjjkjjkjjbbbbbbbBBBBBAAAABABAAAABBBBBBBAAAAABz
ybbbpppppppjjjjkkkjjfkkjkkfjkjjjkjjkkjjfkkjkkkkkkjjjjjjjMMMMMMMMMNMMjjjjjkkkkkjjnnjjjkjjkjjbbbbbbbBBABBBAAABAAAAAABBBBBBBAAAAABz
ybbbpppppppjjfkkjkkkjkjfjkjjkjfjkkfjkjkkkjjjkjjjjjjejjjjgjjjjjjjjjjgjpppjjjkkjjnnjjjkkkjkjjebbbbbbBBABBBBAAAAAABBBBBBBBBBAAAAABz
ybbbpppppppjjjkjjjjkkkjjjjjjjjjjjkkkkjjkkjfkkjjkkfjjjjjjjjjjjjjjjjjjjppppjjjjjnnjjkkkkkjkjjjbbbbbbbBAABBAAAAABBBBBBBBBBBBBAAAABz
ybbbpppppppjjjkjjfjjjjjbbbbbbbjjjjjkjfjkjkkkkfjkkjkkkfjjjjjjjjjjjjjjjpppppjjjjnnjjkjjkjjkkjjbbbbbbbBAAAAABBAAAABBBBBBBBBAAAAAABz
ybbbpppppppjjjjjjjjbbbbbbbbbbbbbjfjkkjkjjjjjkkkkkkkjkjjjjjjjjjjjjjjjjppppppjjjnjjkkjjjkjekjjjbbbbbbBBAAAABBBBAAAAAABBBAAAAAAAABz
ybbbppppppppjjjjbbbbBBBBBBBBBBbbbbjjjjkkfjjjkkjjjkjjkkjjjjjjjjjjjjjjpppppppjjnnjjkejkjkjjkkjjjbbbbbBBAAABBBBBBAAAAAAAAAAAAAAAABz
ybbbppppppppjejbbbBBAAAAAAAAABBbbbbjjjjkkjjfjkjfkkjfjkjfjjkkkkkkkjjjjpppppjjjnnjjkkkkjkkkkkjejbbbbbBBBBBBBBBBBBBBAAAAAAAAAAAAAAz
ybbbppppppppjjjbbbBAAAAAAAAAAABBBbbjjfjjkjjjjkjjkkkkjjjjjjjjjjjjjjjjjjjppjjjjnnjjkkjjjkkkkjkkjjjbbbBBBBBBBBBBBBBBBAAAAAAAAAAAAAz
ybbbjpppppppjjbbbbBAAAAAAAAAAAAABBbbjjjjjjfjkkjkkjjkkjjjjjjnnnnngnjjjjjjjjkjjnnjkkjkkkkjjkkjkkjjjbbbbbbbbBBBBBBBBBBBAAAAAAAAAAAz
ybbbjppppppppjjjbbBAAAAAAAAAAAAAABbbjjjjjjjkkjjkjfjjjnnnnnnnjjnnnnnnjjjjjjkjnnjjkjkkjjkkjjkjjkkjjjbbbbbbbbbbbbbbBBBBBBAAAAAAAABz
ybbbjjpppppppjjjjbBBAAjjAAAAAAAAABbbjjjjfjkkjfjjjjjjnnjjjjjkkjjjnjnnnnjjjkkjnnjkkkkjjkkjjjkkjjkkjjjjbbbbbbbbbbbbBBBBBBBBBAAABBBz
ybbbjjppppppppjjjjbBAjjjAAAAAAAAABbbjjjjjjjjjjjjjnnjnjjjfjkkjkjjjjjjjjjjjjjjjjjjjjnnnnnjjjnnjkjjjjkkjjjejjjjjkkbbbbbbbbbbAAAlbby
ybbbjjjppppppppjjjjbjjjjjAAAAAAAABbbjjjjkjjfjjjenjjjjjjjjkkjkkjjjjjjjjjjjjjjjjjjjjjjnnnnnjnnjjsnnnjnnnjnnnjjkkjbbbbbbbbbjjAAlbby
ybbbjfjpppppppppjjjjjjjjjjAAAAAAABbbjjjjkkkjjjjngjjjkkjjkkjfkjjjjjjjjjjjjjjjjjjjjjjjjjjnnnnnnnnnnnjjjjkjjnjjkjjjjjjjbbbbjjjjbbby
ybbbbjjjpppppppppjjjjjjjjjjAAAAABBbjjjfjjjkkjjjjjkjjjkfjkjjjkjjjjjjjjjkjjjjjjjjjjjjjjjjjjnnnnjjjjjjkkkkjjjjkkjjjjjjjjbbjjjjjbbby
ybbbbkkjjpppppppppjjjjjbBBAAAAAABbbjjjjjjjjkjjjjjkjfjkjjjpppkkjjjjjjjjkjjjjjfjjjfjjjjjjjjjnnjjjjjjjjjjjjkkkkjjjjjjjjjjbjjjjbbbby
ybbbjkkjjppppppppppjjjebbBBAAAABBbjjjjjejfjkjfjjjkjjkkjpppppjkjjjjjjjkkjfjjjjjjjjjjjjbbbJtDDtJbbbbbbbbjjjjjjjjpjjjpppjjjjjbbbbby
ybbbjjkfjjppppppppppjjjjbbBBBAABbbjjjjjjjjjjjjjjkkjjkjjppppjjkjjjfjjjkjjjjjjkjjfjfjbbbttvvDDDtttEEEttbbbjjjjjpppppppppjjjbbbbbby
ybbbfjkjjjpppppppppppjjjjbbbBBBBbjjjjfjjjjjjkkjfkjjjkjjpppjjjjjjjjjjkkjkkkjjkkjjjbbbtttvvtDDDDtEEEEEtttbjejjppppppppppjjjbbbbbby
ybbbjjkkkkjpppppppppppjjjjjbbbbbjjjjjjjjjfjjjkkjjjfkkjjjjjjjjfjjjjjjkjjjkkjjkkjjbbttttvvtvttDDDtEEEEEttbbjjpppppppppppjjjjbbbbby
ybbbjjjjjkjjjpppppppppjjjjjjjbbjjjfjjkkjjjjjjjkkkjjkjfjjfjjjjkjjjjjkkjjjkkjjkjjbbttFttvtvvDDDDDttEEEEEttbjjppppppppppppjjjjbbbby
ybbjjjfjfkkjjjppppppppjjfjjjjjjjjjjjkkjjjjfjjfjkkkkkkjjjjjjfkkjjfjjkjjjkkkkkjjbbttttuuuuuuuuuGDDttEEEEEtjjjpppppppppppppjjjjbbby
ybbjjjjjjjkjjjjpppppppjjjjjjjjjkjjjcjkjjjjjjjjkkjjjjkjjjjjjjkjjjjjkkjfjkjkkkkjbbtFttuKKKKKKKuDDDvtEEEEEtjjjjppppppppppppjjjjbbby
ybjjfjkkkkkjfjjjpppppppjjjjfjjjkkfjjjkkfjjjjkjjjjjjjkjfjfjjkkjjjjkkjjjjjkkkkkjbbbttHuKKKKKKKuDDDvvtEEEEtjbjjjpppppppppppjjjjjbby
ybbjjjkjjjkjjjjjjppppppjjjjjjjjjkjjjjjkkkjfjkjjjfjjfjjjjjjjkkfjjjjjjjjjjkkkkkjbbbtHtuLLLLLLLuDvDvvttEEEtjbbjjjpppppppppjjjjjjjby
ybbjjjkjfkkkkkjfjppppppjjjjjejfjkjjjfkkjjjjkkfkkjjjjjjfjjjjkjjjjjjjjfjjjkkkkjbbbbbtHuKKKKKKKuDDDvDIttEttbbbbjjpppppppppjjjjjjjby
ybbjjfkjjkjjjkkjjjpppppjjfjjjjjkkjjjkkkjjfjkjkkjjjfjjjjjjfkkjjjjfjjjjjjkkkjjjbbbbbttuKKKKKKKuDDDDDDtttttbbbbjjjpppppppppjjjjjjby
ybbbjkkjekjfjjkkkjppppppjjjjjjkkjjfjkjjfjjkkjkjjjjjjjfkkkkjjjjjjjjjjjjkkkjjjjjbbbbttuKKKKKKKKDvDDDttttttbbbbbjjppppppppppjjjjjby
ybbbjjjjjkkkjjjjjjppppppjjjjjjjjjjjkkjjjjjkjjkjfjjjfjkkjjkjjfjjjjjjfkkkkkjjjjjbbbbttuKKKKKKKuDvDDvvtFttttbbbbbjpppppppppppjjjjby
ybbbjjjjjkkkkjfjjjjpppppjjjjjjjjfjjkjfjjjjjkfkjjjjjjjkjjjjjjjjjjjjkkkjjkkjfjjjbbbbttuKKKKKKKutvDDvvvtttttbbbbbbppppppppppppjjjby
ybbbbjjfkkjjkjjjjjjpppppjfjjjjjjkkjkkjjjfjjkkkkjjjfjjjjfjjjjjjjfjkkjjjkkkjjjejbbbbtvuuuuuuuuuJvvDDvvvtFttbbbbbbpppOpppppppppjjby
ybbbbjjkkkjjkkjjjjfpppppjjjjjjjjkjfjkjjjjjjjkjjfjjkkjjjjjjjfjjkkkjkkjjkkkkjjjejbbtvvtttttttttttvvDDDvvtttbbbbbbpppOppOOppppppjby
ybbbbjkkjjjfjkjjjjjjppppjjjjjjfjkjjjjjjfjjfkkjjjjjjbbbbjjjejjjkkjjkjjjjkjjjjjjjjJtttttttbbbbbtttvDDDvtttbbbbbbppppOpppOppOpppppy
ybbbjjjjfjjjjkjfjjjjppppjjjfjjjjkjjjjjjjjjjkjjjcjjbbbbbbbjjjejkkjjkkfjjjjjjjejjjtvtttbbbbbbbbbbwwwAAAwwbbbbbbbppppOOppOOpOOppOpy
ybbbjjjjjjjjjjjjjjejppppjjjjjjjjkjfjjfjjjjjkjfjjjbbbbbbbbjjjjjkkfjjkjkkjjjjjjjkkvvtbbbbbbbbbbbbBAAAAAACBbbbbbppppppOOppOOpOppOOO
ybbjjjbbbbbbbjjejjjjppppjjjbbbjjkjjjjjjkjfjkjjjjjbbbbbbbbbjjejkkjjjkkkkjfjjjejjjttbbbbbbbbbbbbBBBAAAAAABBbbbbpppOOOOOpppOOOOpOOO
ybbbbbbbbbbbbbjjjbbbpppbbbbbbjjjjjjjjjjkkkkkjbbbbbbbbbbbbbbjjjkjjjjkkkkjjjjjjjjjJbbbbbbbbbbbbBBBBAAAAAABBmbbpppOOOOppppppOOOOOOO
ybbbbbbbbbbbbbjbbbbbbbbbbbbbbbbbbbbbbbbjjjjjbbbbbbbbbbbbbbbbbjjjjfjkkkkjjjjjjjjbbbbbbbbbbbbbbBBBBCAAAABBBmmbppOOOOOpOOOOppOOOOOO
ybbbbbbbbbbbbbbbbbbbbbbbbbbbbbbbbbbbbbbbbbbbbbbbbbbbbbbbbbbbbbbbbbbbbbbbbbbbbbbbbbbbbbbbbbbbbBBBBAAAAABBBmmmpOOOOOOOOOOOOOOOOOOO
yyyyyyyyyyyyyyyyyyyyyyyyyyyyyyyyyyyyyyyyyyyyyyyyyyyyyyyyyyyyyyyyyyyyyyyyyyyyyyyyyyyyyyyyyyyyyBBBBCAAABBBBmmmOOOOOOOOOOOOOOOOOOOO
"}
