"a" = (/turf,/area)
"m" = (/turf/simulated/floor/plating/ai,/area)
"n" = (/turf/simulated/floor/tile/dark,/area)
"o" = (/turf/simulated/wall/metal/reinforced,/area)
"p" = (/obj/structure/smooth/window,/turf/simulated/floor/plating,/area)
"q" = (/turf/simulated/floor/basalt,/area)
"r" = (/turf/simulated/floor/lava,/area)
"s" = (/turf/simulated/wall/rock/basalt,/area)

(1,1,1) = {"
aaaaaaaaaaaaaaaaaaaaaaaaaaaaaaaaomnnnmoaaaaaaaaaaaaaaaaaaaaaaaaaaaaaaaaaaaaaaaaaaaaaaaaaaaaaaaaaaaaaaaaaaaaaaaaaaaaaaaaaaaaaaaaa
aaaaaaaaaaaaaaaaaaaaaaaaaaaaaaaaomnnnmoaaaaaaaaaaaaaaaaaaaaaaaaaaaaaaaaaaaaaaaaaaaaaaaaaaaaaaaaaaaaaaaaaaaaaaaaaaaaaaaaaaaaaaaaa
aaaaaaaaaaaaaaaaaaaaaaaaaaaaaaaaomnnnmoaaaaaaaaaaaaaaaaaaaaaaaaaaaaaaaaaaaaaaaaaaaaaaaaaaaaaaaaaaaaaaaaaaaaaaaaaaaaaaaaaaaaaaaaa
aaaaaaaaaaaaaaaaaaaaaaaaaaaaaaaaomnnnmoaaaaaaaaaaaaaaaaaaaaaaaaaaaaaaaaaaaaaaaaaaaaaaaaaaaaaaaaaaaaaaaaaaaaaaaaaaaaaaaaaaaaaaaaa
aaaaaaaaaaaaaaaaaaaaaaaaaaaaaaaaomnnnmoaaaaaaaaaaaaaaaaaaaaaaaaaaaaaaaaaaaaaaaaaaaaaaaaaaaaaaaaaaaaaaaaaaaaaaaaaaaaaaaaaaaaaaaaa
aaaaaaaaaaaaaaaaaaaaaaaaaaaaaaaaomnnnmoaaaaaaaaaaaaaaaaaaaaaaaaaaaaaaaaaaaaaaaaaaaaaaaaaaaaaaaaaaaaaaaaaaaaaaaaaaaaaaaaaaaaaaaaa
aaaaaaaaaaaaaaaaaaaaaaaaaaaaaaaaomnnnmoaaaaaaaaaaaaaaaaaaaaaaaaaaaaaaaaaaaaaaaaaaaaaaaaaaaaaaaaaaaaaaaaaaaaaaaaaaaaaaaaaaaaaaaaa
aaaaaaaaaaaaaaaaaaaaaaaaaaaaaaaaomnnnmoaaaaaaaaaaaaaaaaaaaaaaaaaaaaaaaaaaaaaaaaaaaaaaaaaaaaaaaaaaaaaaaaaaaaaaaaaaaaaaaaaaaaaaaaa
aaaaaaaaaaaaaaaaaaaaaaaaaaaaaaaaomnnnmoaaaaaaaaaaaaaaaaaaaaaaaaaaaaaaaaaaaaaaaaaaaaaaaaaaaaaaaaaaaaaaaaaaaaaaaaaaaaaaaaaaaaaaaaa
aaaaaaaaaaaaaaaaaaaaaaaaaaaaaaaaomnnnmoaaaaaaaaaaaaaaaaaaaaaaaaaaaaaaaaaaaaaaaaaaaaaaaaaaaaaaaaaaaaaaaaaaaaaaaaaaaaaaaaaaaaaaaaa
aaaaaaaaaaaaaaaaaaaaaaaaaaaaaaaaomnnnmoaaaaaaaaaaaaaaaaaaaaaaaaaaaaaaaaaaaaaaaaaaaaaaaaaaaaaaaaaaaaaaaaaaaaaaaaaaaaaaaaaaaaaaaaa
aaaaaaaaaaaaaaaaaaaaaaaaaaaoooooomnnnmooooooaaaaaaaaaaaaaaaaaaaaaaaaaaaaaaaaaaaaaaaaaaaaaaaaaaaaaaaaaaaaaaaaaaaaaaaaaaaaaaaaaaaa
aaaaaaaaaaaaaaaaaaaaaaaaaaaommmmmmnnnmmmmmmoaaaaaaaaaaaaaaaaaaaaaaaaaaaaaaaaaaaaaaaaaaaaaaaaaaaaaaaaaaaaaaaaaaaaaaaaaaaaaaaaaaaa
aaaaaaaaaaaaaaaaaaaaaaaaaaaomnnnnnnnnnnnnnmoaaaaaaaaaaaaaaaaaaaaaaaaaaaaaaaaaaaaaaaaaaaaaaaaaaaaaaaaaaaaaaaaaaaaaaaaaaaaaaaaaaaa
aaaaaaaaaaaaaaaaaaaaaaaaaaaomnnnnnnnnnnnnnmoaaaaaaaaaaaaaaaaaaaaaaaaaaaaaaaaaaaaaaaaaaaaaaaaaaaaaaaaaaaaaaaaaaaaaaaaaaaaaaaaaaaa
aaaaaaaaaaaaaaaaaaaaaaaaaaaomnnnnnnnnnnnnnmoaaaaaaaaaaaaaaaaaaaaaaaaaaaaaaaaaaaaaaaaaaaaaaaaaaaaaaaaaaaaaaaaaaaaaaaaaaaaaaaaaaaa
aaaaaaaaaaaaaaaaaaaaaaaooooomnnnmmnnnmmnnnmoooooaaaaaaaaaaaaaaaaaaaaaaaaaaaaaaaaaaaaaaaaaaaaaaaaaaaaaaaaaaaaaaaaaaaaaaaaaaaaaaaa
aaaaaaaaaaaaaaaaaaaaaaaommmmmnnnmmnnnmmnnnmmmmmoaaaaaaaaaaaaaaaaaaaaaaaaaaaaaaaaaaaaaaaaaaaaaaaaaaaaaaaaaaaaaaaaaaaaaaaaaaaaaaaa
aaaaaaaaaaaaaaaaaaaaaaaomnnnnnnnnnnnnnnnnnnnnnmoaaaaaaaaaaaaaaaaaaaaaaaaaaaaaaaaaaaaaaaaaaaaaaaaaaaaaaaaaaaaaaaaaaaaaaaaaaaaaaaa
aaaaaaaaaaaaaaaaaaaaaaaomnnnnnnnnnnnnnnnnnnnnnmoaaaaaaaaaaaaaaaaaaaaaaaaaaaaaaaaaaaaaaaaaaaaaaaaaaaaaaaaaaaaaaaaaaaaaaaaaaaaaaaa
aaaaaaaaaaaaaaaaaaaaaaaomnnnnnnnnnnnnnnnnnnnnnmoaaaaaaaaaaaaaaaaaaaaaaaaaaaaaaaaaaaaaaaaaaaaaaaaaaaaaaaaaaaaaaaaaaaaaaaaaaaaaaaa
aaaaaaaaaaaaaaaaaaaaaaaommmmmnnnmmnnnmmnnnmmmmmoaaaaaaaaaaaaaaaaaaaaaaaaaaaaaaaaaaaaaaaaaaaaaaaaaaaaaaaaaaaaaaaaaaaaaaaaaaaaaaaa
aaaaaaaaaaaaaaaaaaaaaaaooooomnnnmmnnnmmnnnmoooooaaaaaaaaaaaaaaaaaaaaaaaaaaaaaaaaaaaaaaaaaaaaaaaaaaaaaaaaaaaaaaaaaaaaaaaaaaaaaaaa
aaaaaaaaaaaaaaaaaaaaaaaaaaaomnnnnnnnnnnnnnmoaaaaaaaaaaaaaaaaaaaaaaaaaaaaaaaaaaaaaaaaaaaaaaaaaaaaaaaaaaaaaaaaaaaaaaaaaaaaaaaaaaaa
aaaaaaaaaaaaaaaaaaaaaaaaaaaomnnnnnnnnnnnnnmoaaaaaaaaaaaaaaaaaaaaaaaaaaaaaaaaaaaaaaaaaaaaaaaaaaaaaaaaaaaaaaaaaaaaaaaaaaaaaaaaaaaa
aaaaaaaaaaaaaaaaaaaaaaaaaaaomnnnnnnnnnnnnnmoaaaaaaaaaaaaaaaaaaaaaaaaaaaaaaaaaaaaaaaaaaaaaaaaaaaaaaaaaaaaaaaaaaaaaaaaaaaaaaaaaaaa
aaaaaaaaaaaaaaaaaaaaaaaaaaaommmmmmnnnmmmmmmoaaaaaaaaaaaaaaaaaaaaaaaaaaaaaaaaaaaaaaaaaaaaaaaaaaaaaaaaaaaaaaaaaaaaaaaaaaaaaaaaaaaa
sssssssssssssssssssssssssssoooooomnnnmooooooaaaaaaaaaaaaaaaaaaaaaaaaaaaaaaaaaaaaaaaaaaaaaaaaaaaaaaaaaaaaaaaaaaaaaaaaaaaaaaaaaaaa
ssssssssssssssssssssssssssssssssomnnnmoaaaaaaaaaaaaaaaaaaaaaaaaaaaaaaaaaaaaaaaaaaaaaaaaaaaaaaaaaaaaaaaaaaaaaaaaaaaaaaaaaaaaaaaaa
sssssssrrrrrsssssssrrrrrssssssssomnnnmoaaaaaaaaaaaaaaaaaaaaaaaaaaaaaaaaaaaaaaaaaaaaaaaaaaaaaaaaaaaaaaaaaaaaaaaaaaaaaaaaaaaaaaaaa
ssssrrrrrrrrrrrrrrrrrrrrrrrsssssomnnnmoaaaaaaaaaaaaaaaaaaaaaaaaaaaaaaaaaaaaaaaaaaaaaaaaaaaaaaaaaaaaaaaaaaaaaaaaaaaaaaaaaaaaaaaaa
sssrrrrrrrrrrrrrrrrrrrrrrrrrssssomnnnmoaaaaaaaaaaaaaaaaaaaaaaaaaaaaaaaaaaaaaaaaaaaaaaaaaaaaaaaaaaaaaaaaaaaaaaaaaaaaaaaaaaaaaaaaa
ssrrrrrrrrrrrrrrrrrrrrrrrrrrrrssomnnnmoaaaaaaaaaaaaaaaaaaaaaaaaaaaaaaaaaaaaaaaaaaaaaaaaaaaaaaaaaaaaaaaaaaaaaaaaaaaaaaaaaaaaaaaaa
ssrrrrrrrrrrrrrrrrrrrrrrrrrrrrrsomnnnmoaaaaaaaaaaaaaaaaaaaaaaaaaaaaaaaaaaaaaaaaaaaaaaaaaaaaaaaaaaaaaaaaaaaaaaaaaaaaaaaaaaaaaaaaa
ssrrooooooooooooooooorrrrrroooooomnnnmooooooaaaaaaaaaaaaaaaaaaaaaaaaaaaaaaaaaaaaaaaaaaaaaaaaaaaaaaaaaaaaaaaaaaaaaaaaaaaaaaaaaaaa
srrrommmmmmmmmmmmmmmpqqrrrrpmmmmmmnnnmmmmmmoaaaaaaaaaaaaaaaaaaaaaaaaaaaaaaaaaaaaaaaaaaaaaaaaaaaaaaaaaaaaaaaaaaaaaaaaaaaaaaaaaaaa
srrromnnnnnnnnnnnnnmpqqrrrrpmnnnnnnnnnnnnnmoaaaaaaaaaaaaaaaaaaaaaaaaaaaaaaaaaaaaaaaaaaaaaaaaaaaaaaaaaaaaaaaaaaaaaaaaaaaaaaaaaaaa
srrromnnnnnnnnnnnnnmpqqqqrrpmnnnnnnnnnnnnnmoaaaaaaaaaaaaaaaaaaaaaaaaaaaaaaaaaaaaaaaaaaaaaaaaaaaaaaaaaaaaaaaaaaaaaaaaaaaaaaaaaaaa
srrromnnnnnnnnnnnnnmpqqqqqqpmnnnnnnnnnnnnnmoaaaaaaaaaaaaaaaaaaaaaaaaaaaaaaaaaaaaaaaaaaaaaaaaaaaaaaaaaaaaaaaaaaaaaaaaaaaaaaaaaaaa
srrromnnnmmnnnmmnnnmppppppppmnnnmmnnnmmnnnmoaaaaaaaaaaaaaaaaaaaaaaaaaaaaaaaaaaaaaaaaaaaaaaaaaaaaaaaaaaaaaaaaaaaaaaaaaaaaaaaaaaaa
srrromnnnmmnnnmmnnnmmmmmmmmmmnnnmmnnnmmnnnmoaaaaaaaaaaaaaaaaaaaaaaaaaaaaaaaaaaaaaaaaaaaaaaaaaaaaaaaaaaaaaaaaaaaaaaaaaaaaaaaaaaaa
srrromnnnnnnnnnnnnnnnnnnnnnnnnnnnnnnnnnnnnmoaaaaaaaaaaaaaaaaaaaaaaaaaaaaaaaaaaaaaaaaaaaaaaaaaaaaaaaaaaaaaaaaaaaaaaaaaaaaaaaaaaaa
srrromnnnnnnnnnnnnnnnnnnnnnnnnnnnnnnnnnnnnmoaaaaaaaaaaaaaaaaaaaaaaaaaaaaaaaaaaaaaaaaaaaaaaaaaaaaaaaaaaaaaaaaaaaaaaaaaaaaaaaaaaaa
srrromnnnnnnnnnnnnnnnnnnnnnnnnnnnnnnnnnnnnmoaaaaaaaaaaaaaaaaaaaaaaaaaaaaaaaaaaaaaaaaaaaaaaaaaaaaaaaaaaaaaaaaaaaaaaaaaaaaaaaaaaaa
srrromnnnmmnnnmmnnnmmmmmmmmmmnnnmmnnnmmnnnmoaaaaaaaaaaaaaaaaaaaaaaaaaaaaaaaaaaaaaaaaaaaaaaaaaaaaaaaaaaaaaaaaaaaaaaaaaaaaaaaaaaaa
srrromnnnmmnnnmmnnnmppppppppmnnnmmnnnmmnnnmoaaaaaaaaaaaaaaaaaaaaaaaaaaaaaaaaaaaaaaaaaaaaaaaaaaaaaaaaaaaaaaaaaaaaaaaaaaaaaaaaaaaa
srrromnnnnnnnnnnnnnmpqqqqqqpmnnnnnnnnnnnnnmoaaaaaaaaaaaaaaaaaaaaaaaaaaaaaaaaaaaaaaaaaaaaaaaaaaaaaaaaaaaaaaaaaaaaaaaaaaaaaaaaaaaa
sssromnnnnnnnnnnnnnmpqqqrrrpmnnnnnnnnnnnnnmoaaaaaaaaaaaaaaaaaaaaaaaaaaaaaaaaaaaaaaaaaaaaaaaaaaaaaaaaaaaaaaaaaaaaaaaaaaaaaaaaaaaa
ssssomnnnnnnnnnnnnnmpqqrrrrpmnnnnnnnnnnnnnmoaaaaaaaaaaaaaaaaaaaaaaaaaaaaaaaaaaaaaaaaaaaaaaaaaaaaaaaaaaaaaaaaaaaaaaaaaaaaaaaaaaaa
ssssommmmmmnnnmmmmmmprrrrrrpmmmmmmmmmmmmmmmossssssssaaaaaaaaaaaaaaaaaaaaaaaaaaaaaaaaaaaaaaaaaaaaaaaaaaaaaaaaaaaaaaaaaaaaaaaaaaaa
ssssopppppmnnnmppppporrrrrrooooooooooooooooossssssssaaaaaaaaaaaaaaaaaaaaaaaaaaaaaaaaaaaaaaaaaaaaaaaaaaaaaaaaaaaaaaaaaaaaaaaaaaaa
sssrrrrrqpmnnnmpqrrrrrrrrrrrrrrrrssrrrrrrrrrrrssssssaaaaaaaaaaaaaaaaaaaaaaaaaaaaaaaaaaaaaaaaaaaaaaaaaaaaaaaaaaaaaaaaaaaaaaaaaaaa
ssrrrrrqqpmnnnmpqrrrrrrrrrrrrrrrssssrrrrrrrrrrrsssssaaaaaaaaaaaaaaaaaaaaaaaaaaaaaaaaaaaaaaaaaaaaaaaaaaaaaaaaaaaaaaaaaaaaaaaaaaaa
ssrrrrrqqpmnnnmpqrrrrrrrrrrrrrrssssssrrrrrrrrrrrssssaaaaaaaaaaaaaaaaaaaaaaaaaaaaaaaaaaaaaaaaaaaaaaaaaaaaaaaaaaaaaaaaaaaaaaaaaaaa
ssrrrrrqqpmnnnmpqqrrrrrrrrrrrrrsssssssrrrrrrrrrrrsssaaaaaaaaaaaaaaaaaaaaaaaaaaaaaaaaaaaaaaaaaaaaaaaaaaaaaaaaaaaaaaaaaaaaaaaaaaaa
ssrrrrqqqpmnnnmpqqqrrrrrrrrrrsssssssssssrrrrrrrrrrssaaaaaaaaaaaaaaaaaaaaaaaaaaaaaaaaaaaaaaaaaaaaaaaaaaaaaaaaaaaaaaaaaaaaaaaaaaaa
sssrrrqqqpmnnnmpqqqqrrrrrrrrrssssssssssssssrrrrrrrssaaaaaaaaaaaaaaaaaaaaaaaaaaaaaaaaaaaaaaaaaaaaaaaaaaaaaaaaaaaaaaaaaaaaaaaaaaaa
ssssopppppmnnnmppppporrrrrrooooooooooooooooorrrrrroooooooooooooooooaaaaaaaaaaaaaaaaaaaaaaaaaaaaaaaaaaaaaaaaaaaaaaaaaaaaaaaaaaaaa
ssssommmmmmnnnmmmmmmorrrrrrommmmmmmmmmmmmmmprrrrrrpmmmmmmmmmmmmmmmoaaaaaaaaaaaaaaaaaaaaaaaaaaaaaaaaaaaaaaaaaaaaaaaaaaaaaaaaaaaaa
ssssomnnnnnnnnnnnnnmorrrrrromnnnnnnnnnnnnnmprrrrrrpmnnnnnnnnnnnnnmoaaaaaaaaaaaaaaaaaaaaaaaaaaaaaaaaaaaaaaaaaaaaaaaaaaaaaaaaaaaaa
ssssomnnnnnnnnnnnnnmorrrrrromnnnnnnnnnnnnnmpqrrrrrpmnnnnnnnnnnnnnmoaaaaaaaaaaaaaaaaaaaaaaaaaaaaaaaaaaaaaaaaaaaaaaaaaaaaaaaaaaaaa
sssromnnnnnnnnnnnnnmorrrrrromnnnnnnnnnnnnnmpqqqqqqpmnnnnnnnnnnnnnmoaaaaaaaaaaaaaaaaaaaaaaaaaaaaaaaaaaaaaaaaaaaaaaaaaaaaaaaaaaaaa
srrromnnnmmnnnmmnnnmorrrrrromnnnmmnnnmmnnnmppppppppmnnnmmnnnmmnnnmoaaaaaaaaaaaaaaaaaaaaaaaaaaaaaaaaaaaaaaaaaaaaaaaaaaaaaaaaaaaaa
srrromnnnmmnnnmmnnnmorrrrrromnnnmmnnnmmnnnmmmmmmmmmmnnnmmnnnmmnnnmoaaaaaaaaaaaaaaaaaaaaaaaaaaaaaaaaaaaaaaaaaaaaaaaaaaaaaaaaaaaaa
srrromnnnnnnnnnnnnnmorrrrrromnnnnnnnnnnnnnnnnnnnnnnnnnnnnnnnnnnnnmoaaaaaaaaaaaaaaaaaaaaaaaaaaaaaaaaaaaaaaaaaaaaaaaaaaaaaaaaaaaaa
srrromnnnnnnnnnnnnnmorrrrrromnnnnnnnnnnnnnnnnnnnnnnnnnnnnnnnnnnnnmoaaaaaaaaaaaaaaaaaaaaaaaaaaaaaaaaaaaaaaaaaaaaaaaaaaaaaaaaaaaaa
srrromnnnnnnnnnnnnnmorrrrrromnnnnnnnnnnnnnnnnnnnnnnnnnnnnnnnnnnnnmoaaaaaaaaaaaaaaaaaaaaaaaaaaaaaaaaaaaaaaaaaaaaaaaaaaaaaaaaaaaaa
srrromnnnmmnnnmmnnnmorrrrrromnnnmmnnnmmnnnmmmmmmmmmmnnnmmnnnmmnnnmoaaaaaaaaaaaaaaaaaaaaaaaaaaaaaaaaaaaaaaaaaaaaaaaaaaaaaaaaaaaaa
srrromnnnmmnnnmmnnnmorrrrrromnnnmmnnnmmnnnmppppppppmnnnmmnnnmmnnnmoaaaaaaaaaaaaaaaaaaaaaaaaaaaaaaaaaaaaaaaaaaaaaaaaaaaaaaaaaaaaa
srrromnnnnnnnnnnnnnmorrrrrromnnnnnnnnnnnnnmpqqqqqqpmnnnnnnnnnnnnnmoaaaaaaaaaaaaaaaaaaaaaaaaaaaaaaaaaaaaaaaaaaaaaaaaaaaaaaaaaaaaa
ssrromnnnnnnnnnnnnnmorrrrrromnnnnnnnnnnnnnmpqqqqqqpmnnnnnnnnnnnnnmoaaaaaaaaaaaaaaaaaaaaaaaaaaaaaaaaaaaaaaaaaaaaaaaaaaaaaaaaaaaaa
sssromnnnnnnnnnnnnnmorrrrrromnnnnnnnnnnnnnmpqqrrrqpmnnnnnnnnnnnnnmosssssssaaaaaaaaaaaaaaaaaaaaaaaaaaaaaaaaaaaaaaaaaaaaaaaaaaaaaa
ssssommmmmmnnnmmmmmmorrrrrrommmmmmnnnmmmmmmpqrrrrqpmmmmmmnnnmmmmmmosssssssaaaaaaaaaaaaaaaaaaaaaaaaaaaaaaaaaaaaaaaaaaaaaaaaaaaaaa
srrsopppppmnnnmppppporrrrrropppppmnnnmppppporrrrrropppppmnnnmppppporssssssaaaaaaaaaaaaaaaaaaaaaaaaaaaaaaaaaaaaaaaaaaaaaaaaaaaaaa
srrrrrrrqpmnnnmpqqrrrrrrrrrrrrrqpmnnnmprrrrrrrrrrrrqqqqpmnnnmpqqqqrrrsssssaaaaaaaaaaaaaaaaaaaaaaaaaaaaaaaaaaaaaaaaaaaaaaaaaaaaaa
srrrrrrqqpmnnnmpqrrrrrrrrrrrrrqqpmnnnmprrrrrrrrrrrrrqqqpmnnnmpqrrrrrrrrsssaaaaaaaaaaaaaaaaaaaaaaaaaaaaaaaaaaaaaaaaaaaaaaaaaaaaaa
srrrrrrqqpmnnnmpqrrrrrrrrrrrrrqqpmnnnmprrrrrrrrrrrrrrrqpmnnnmpqqrrrrrrrsssaaaaaaaaaaaaaaaaaaaaaaaaaaaaaaaaaaaaaaaaaaaaaaaaaaaaaa
srrrrrrqqpmnnnmpqqrrrrrrrrrrrqqqpmnnnmpqqrrrrrrrrrrrrrqpmnnnmpqqrrrrrrrsssaaaaaaaaaaaaaaaaaaaaaaaaaaaaaaaaaaaaaaaaaaaaaaaaaaaaaa
srrrrrrqqpmnnnmpqqrrrrrrrrrrqqqqpmnnnmpqqqqrrrrrrrrrrqqpmnnnmpqqqqrrrrrsssaaaaaaaaaaaaaaaaaaaaaaaaaaaaaaaaaaaaaaaaaaaaaaaaaaaaaa
srrrrrrqrpmnnnmpqqqqrrrrrrrrqqqqpmnnnmpqqqqrrrrrrrrqqqqpmnnnmpqqqqrrrrssssaaaaaaaaaaaaaaaaaaaaaaaaaaaaaaaaaaaaaaaaaaaaaaaaaaaaaa
srrsopppppmnnnmppppporrrrrropppppmnnnmppppporrrrrropppppmnnnmppppporrrrsssaaaaaaaaaaaaaaaaaaaaaaaaaaaaaaaaaaaaaaaaaaaaaaaaaaaaaa
srrsommmmmmnnnmmmmmmpqrrrrrpmmmmmmnnnmmmmmmossrrrrommmmmmnnnmmmmmmorrrrrssaaaaaaaaaaaaaaaaaaaaaaaaaaaaaaaaaaaaaaaaaaaaaaaaaaaaaa
ssssomnnnnnnnnnnnnnmpqrrrrrpmnnnnnnnnnnnnnmossrrrromnnnnnnnnnnnnnmorrrrrrsaaaaaaaaaaaaaaaaaaaaaaaaaaaaaaaaaaaaaaaaaaaaaaaaaaaaaa
ssssomnnnnnnnnnnnnnmpqqrrrrpmnnnnnnnnnnnnnmosssrrsomnnnnnnnnnnnnnmorrrrrrsaaaaaaaaaaaaaaaaaaaaaaaaaaaaaaaaaaaaaaaaaaaaaaaaaaaaaa
ssssomnnnnnnnnnnnnnmpqqqqqqpmnnnnnnnnnnnnnmossssssomnnnnnnnnnnnnnmorrrrrrsaaaaaaaaaaaaaaaaaaaaaaaaaaaaaaaaaaaaaaaaaaaaaaaaaaaaaa
sssromnnnmmnnnmmnnnmppppppppmnnnmmnnnmmnnnmossssssomnnnmmnnnmmnnnmorrrrrrsaaaaaaaaaaaaaaaaaaaaaaaaaaaaaaaaaaaaaaaaaaaaaaaaaaaaaa
sssromnnnmmnnnmmnnnmmmmmmmmmmnnnmmnnnmmnnnmossssssomnnnmmnnnmmnnnmorrrrrrsaaaaaaaaaaaaaaaaaaaaaaaaaaaaaaaaaaaaaaaaaaaaaaaaaaaaaa
ssrromnnnnnnnnnnnnnnnnnnnnnnnnnnnnnnnnnnnnmosssrssomnnnnnnnnnnnnnmorrrrrrsaaaaaaaaaaaaaaaaaaaaaaaaaaaaaaaaaaaaaaaaaaaaaaaaaaaaaa
srrromnnnnnnnnnnnnnnnnnnnnnnnnnnnnnnnnnnnnmossrrrsomnnnnnnnnnnnnnmorrrrrrsaaaaaaaaaaaaaaaaaaaaaaaaaaaaaaaaaaaaaaaaaaaaaaaaaaaaaa
srrromnnnnnnnnnnnnnnnnnnnnnnnnnnnnnnnnnnnnmossrrrsomnnnnnnnnnnnnnmorrrrrrsaaaaaaaaaaaaaaaaaaaaaaaaaaaaaaaaaaaaaaaaaaaaaaaaaaaaaa
srrromnnnmmnnnmmnnnmmmmmmmmmmnnnmmnnnmmnnnmosrrrrromnnnmmnnnmmnnnmorrrrrrsaaaaaaaaaaaaaaaaaaaaaaaaaaaaaaaaaaaaaaaaaaaaaaaaaaaaaa
srrromnnnmmnnnmmnnnmppppppppmnnnmmnnnmmnnnmosrrrrromnnnmmnnnmmnnnmorrrrrrsaaaaaaaaaaaaaaaaaaaaaaaaaaaaaaaaaaaaaaaaaaaaaaaaaaaaaa
srrromnnnnnnnnnnnnnmpqqqqqqpmnnnnnnnnnnnnnmorrrrrromnnnnnnnnnnnnnmorrrrrrssaaaaaaaaaaaaaaaaaaaaaaaaaaaaaaaaaaaaaaaaaaaaaaaaaaaaa
srrromnnnnnnnnnnnnnmpqrrrqqpmnnnnnnnnnnnnnmorrrrrromnnnnnnnnnnnnnmorrrrrrrsaaaaaaaaaaaaaaaaaaaaaaaaaaaaaaaaaaaaaaaaaaaaaaaaaaaaa
srrromnnnnnnnnnnnnnmpqrrrrqpmnnnnnnnnnnnnnmorrrrrromnnnnnnnnnnnnnmorrrrrrrssaaaaaaaaaaaaaaaaaaaaaaaaaaaaaaaaaaaaaaaaaaaaaaaaaaaa
srrrommmmmmmmmmmmmmmprrrrrqpmmmmmmmmmmmmmmmorrrrrrommmmmmnnnmmmmmmorrrrrrrrssaaaaaaaaaaaaaaaaaaaaaaaaaaaaaaaaaaaaaaaaaaaaaaaaaaa
srrrooooooooooooooooorrrrrqooooooooooooooooorrrrrropppppmnnnmppppporrssssrrrsaaaaaaaaaaaaaaaaaaaaaaaaaaaaaaaaaaaaaaaaaaaaaaaaaaa
srrrrrrrrrrrrrrrrrrrrrrrrrrrrrrrrrrrrrrrrrrrrrrrrrrqqqqpmnnnmpqqqrrrrrsssrrrssaaaaaaaaaaaaaaaaaaaaaaaaaaaaaaaaaaaaaaaaaaaaaaaaaa
srrrrrrrrrrrrrrrrrrrrrrrrrrrrrrrrrrrrrrrrrrrrrrrrrrqqqqpmnnnmpqqqrrrrrsssrrrrssaaaaaaaaaaaaaaaaaaaaaaaaaaaaaaaaaaaaaaaaaaaaaaaaa
srrrrrrrrrrrrrrrrrrrrrrrrrrrrrrrrrrrrrrrrrrrrrrrrrrqqqqpmnnnmpqqqrrrrrrssrrrrrssaaaaaaaaaaaaaaaaaaaaaaaaaaaaaaaaaaaaaaaaaaaaaaaa
srrrrrrrrrrrrrrrrrrrrrrrrrrrrrrrrrrrrrrrrrrrrrrrrrqqqqqpmnnnmpqqqrrrrrrrsrrrrrrsaaaaaaaaaaaaaaaaaaaaaaaaaaaaaaaaaaaaaaaaaaaaaaaa
srrrrrrrrrrrrrrrrrrrrrrrrrrrrrrrrrrrrrrrrrrrrrrrrqqqqqqpmnnnmpqqrrrrrrrrrrrrssssaaaaaaaaaaaaaaaaaaaaaaaaaaaaaaaaaaaaaaaaaaaaaaaa
srrrrrrrrrsssrrrrrrrrrrrrrrrrrrrrrrrrrrrrrrrrrrrrqqqqqqpmnnnmpqqqqqrrrrrrsssssssaaaaaaaaaaaaaaaaaaaaaaaaaaaaaaaaaaaaaaaaaaaaaaaa
srrrrrrrssssssrrrrrrrrrrrrrsssssrrrrrrrrrrrrrrrrrqopppppmnnnmppppporrrrrroooooooooooooooooooooooooooaaaaaaaaaaaaaaaaaaaaaaaaaaaa
srrrrrrssrssssrrrrrrrrrrrrsssssssrrrrrrrrrrrrrrrrrommmmmmnnnmmmmmmprrrrrrpmmmmmmmmmmmmmmmmmmmmmmmmmoaaaaaaaaaaaaaaaaaaaaaaaaaaaa
srrrrrrrrsssrrrrrrrrrrrrrrsssssssrrrrrrrrrrrrrrrrromnnnnnnnnnnnnnmprrrrrrpmnnnnnnnnnnnnnnnnnnnnnnnmoaaaaaaaaaaaaaaaaaaaaaaaaaaaa
srrrrrrrrrrrrrrrrrrrrrrrrrrssssssrrrrrrrrrrrrrrrrromnnnnnnnnnnnnnmprrrrrrpmnnnnnnnnnnnnnnnnnnnnnnnmoaaaaaaaaaaaaaaaaaaaaaaaaaaaa
srrrrrrrrrrrrrrrrrrrrrrrrrrssssssrrrrrrrrrrrrrrrrromnnnnnnnnnnnnnmprrrrrrpmnnnnnnnnnnnnnnnnnnnnnnnmooooooaaaaaaaaaaaaaaaaaaaaaaa
srrrrrrrrrrrrrrrrrrrrrrrrrrrrssssrrrrrrrrrrrrrrrrromnnnmmnnnmmnnnmppppppppmnnnmmnnnmmnnnmmnnnmmnnnmmmmmmoaaaaaaaaaaaaaaaaaaaaaaa
srrrrrrrrrrrrrrrrrrrrrrrrrrrrrrsrrrrrrrrrrrrrrrrrromnnnmmnnnmmnnnmmmmmmmmmmnnnmmnnnmmnnnmmnnnmmnnnmmmmmmoaaaaaaaaaaaaaaaaaaaaaaa
srrrrrrrrrrrrrrrrrrrrrssrrrrrrrrrrrrrrrrrrrrrrrrrromnnnnnnnnnnnnnnnnnnnnnnnnnnnnnnnnnnnnnnnnnnnnnnnnnmmmoaaaaaaaaaaaaaaaaaaaaaaa
srrrrrrrrrrrrrrrrrrrssssrrrrrrrrrrrrrrrrrrrrrrrrrromnnnnnnnnnnnnnnnnnnnnnnnnnnnnnnnnnnnnnnnnnnnnnnnnnmmmoaaaaaaaaaaaaaaaaaaaaaaa
srrrrrrrrrrrrrrrrrssssssrrrrrrrrrrrrrrrrrrrrrrrrrromnnnnnnnnnnnnnnnnnnnnnnnnnnnnnnnnnnnnnnnnnnnnnnnnnmmmoaaaaaaaaaaaaaaaaaaaaaaa
srrrrrrrrrrrrrrrrrsssssrrrrrrrrrrrrrrrrrrrrrrrrrrromnnnmmnnnmmnnnmmmmmmmmmmnnnmmnnnmmnnnmmnnnmmnnnmmmmmmoaaaaaaaaaaaaaaaaaaaaaaa
srrrrrrrrrrrrrrrrrrrrrrrrrrrrrrrrrrrrrrrrrrrrrrrrromnnnmmnnnmmnnnmppppppppmnnnmmnnnmmnnnmmnnnmmnnnmmmmmmoaaaaaaaaaaaaaaaaaaaaaaa
srrrrrrrrrrrrrrrrrrrrrrrrrrrrrrrrrrrrrrrrrrrrrrrrromnnnnnnnnnnnnnmpqqqrrrpmnnnnnnnnnnnnnnnnnnnnnnnmooooooaaaaaaaaaaaaaaaaaaaaaaa
srrrrrrrrrrrrrrrrrrrrrrrrrrrrrrrrrrrrrrrrrrrrrrrrromnnnnnnnnnnnnnmpqqrrrrpmnnnnnnnnnnnnnnnnnnnnnnnmoaaaaaaaaaaaaaaaaaaaaaaaaaaaa
srrrrrrrrrrrrrrrrrrrrrrrrrrrrrrrrrrrrrrrrrrrrrrrrromnnnnnnnnnnnnnmpqrrrrrpmnnnnnnnnnnnnnnnnnnnnnnnmoaaaaaaaaaaaaaaaaaaaaaaaaaaaa
srrrrrrrrrrrrrrrrrrrrrrrrrrrrrrrrrrrrrrrrrrrrrrrrrommmmmmmmmmmmmmmprrrrrrpmmmmmmmmmmmmmmmmmmmmmmmmmoaaaaaaaaaaaaaaaaaaaaaaaaaaaa
srrrrrrrrrrrrrrrrrrrrrrrrrrrrrrrrrrrrrrrrrrrrrrrrrooooooooooooooooorrrrrroooooooooooooooooooooooooooaaaaaaaaaaaaaaaaaaaaaaaaaaaa
srrrrrrrrrrrrrrrrrrrrrrrrrrrrrrrrrrrrrrrrrrrrrrrrrrrrrrrrrrrrrrrrrrrrrrrrssaaaaaaaaaaaaaaaaaaaaaaaaaaaaaaaaaaaaaaaaaaaaaaaaaaaaa
srrrrrrrrrrrrrrrrrrrrrrrrrrrrrrrrrrrrrrrrrrrrrrrrrrrrrrrrrrrrrrrrrrrrrrrrssaaaaaaaaaaaaaaaaaaaaaaaaaaaaaaaaaaaaaaaaaaaaaaaaaaaaa
srrrrrrrrrrrrrrrrrrrrrrrrrrrrrrrrrrrrrrrrrrrrrrrrrrrrrrrrrrrrrrrrrrrrrrrsssaaaaaaaaaaaaaaaaaaaaaaaaaaaaaaaaaaaaaaaaaaaaaaaaaaaaa
srrrrrrrrrrrrrrrrrrrrrrrrrrrrrrrrrrrrrrrrrrrrrrrrrrrrrrrrrrrrrrrrrrrrrrssssaaaaaaaaaaaaaaaaaaaaaaaaaaaaaaaaaaaaaaaaaaaaaaaaaaaaa
srrrrrrrrrrrrrrrrrrrrrrrrrrrrrrrrrrrrrrrrrrrrrrrrrrrrrrrrrrrrrrrrrrrrrsssssaaaaaaaaaaaaaaaaaaaaaaaaaaaaaaaaaaaaaaaaaaaaaaaaaaaaa
srrrrrrrrrrrrrrrrrrrrrrrrrrrrrrrrrrrrrrrrrrrrrrrrrrrrrrrrrrrrrrrrrrrrssssssaaaaaaaaaaaaaaaaaaaaaaaaaaaaaaaaaaaaaaaaaaaaaaaaaaaaa
srrrrrrrrrrrrrrrrrrrrrrrrrrrrrrrrrrrrrrrrrrrrrrrrrrrrrrrrrrrrrrrrrsssssssssaaaaaaaaaaaaaaaaaaaaaaaaaaaaaaaaaaaaaaaaaaaaaaaaaaaaa
sssssssssssssssssssssssssssssssssssssssssssssssssssssssssssssssssssssssssssaaaaaaaaaaaaaaaaaaaaaaaaaaaaaaaaaaaaaaaaaaaaaaaaaaaaa
"}
