"a" = (/obj/marker/chargen,/turf/unsimulated/void,/area)
"b" = (/turf/simulated/floor/colored/grass,/area/special/lobby)
"c" = (/turf/simulated/floor/colored/dirt,/area/special/lobby)
"d" = (/obj/structure/interactive/lighting/streetlamp,/turf/simulated/floor/colored/dirt,/area/special/lobby)
"e" = (/obj/structure/interactive/lighting/streetlamp,/turf/simulated/floor/colored/grass,/area/special/lobby)
"f" = (/turf/simulated/wall/wood/brown,/area/special/lobby)
"g" = (/obj/structure/interactive/wishgranter/fake,/turf/simulated/floor/colored/dirt,/area/special/lobby)
"h" = (/turf/simulated/floor/river,/area/special/lobby)
"i" = (/obj/structure/interactive/door/wood,/turf/simulated/floor/wood/brown,/area/special/lobby)
"j" = (/turf/unsimulated,/area)
"k" = (/obj/structure/scenery/grass,/turf/simulated/floor/colored/grass,/area/special/lobby)
"l" = (/obj/structure/scenery/grass_bush,/turf/simulated/floor/colored/grass,/area/special/lobby)
"m" = (/obj/structure/scenery/flowers,/turf/simulated/floor/colored/grass,/area/special/lobby)
"n" = (/obj/structure/scenery/rocks,/turf/simulated/floor/colored/dirt,/area/special/lobby)
"o" = (/obj/structure/scenery/evergreen,/turf/simulated/floor/colored/grass,/area/special/lobby)
"p" = (/obj/marker/spawnpoint/lobby,/turf/simulated/floor/colored/dirt,/area/special/lobby)
"q" = (/turf/simulated/floor/river,/area/singleplayer/exterior)
"r" = (/turf/simulated/wall/wood/boat/starting,/area/singleplayer/interior)
"s" = (/turf/simulated/floor/wood/brown,/area/special/lobby)
"t" = (/obj/structure/smooth/table/wood,/turf/simulated/floor/wood/brown,/area/singleplayer/interior)
"u" = (/obj/structure/smooth/table/wood,/obj/structure/interactive/lighting/candle,/turf/simulated/floor/wood/brown,/area/singleplayer/interior)
"v" = (/obj/trigger/jumpmarker/ship_exit,/turf/simulated/floor/stair/wood,/area/singleplayer/interior)
"w" = (/turf/unsimulated/void,/area)
"x" = (/turf/simulated/floor/wood/boat/starting,/area/singleplayer/interior)
"y" = (/obj/structure/interactive/bed,/turf/simulated/floor/wood/boat/starting,/area/singleplayer/interior)
"z" = (/obj/structure/smooth/table/wood,/obj/structure/interactive/lighting/candle,/turf/simulated/floor/wood/boat/starting,/area/singleplayer/interior)
"A" = (/obj/structure/interactive/bed,/obj/marker/spawnpoint/new_character,/turf/simulated/floor/wood/boat/starting,/area/singleplayer/interior)
"B" = (/obj/structure/smooth/table/wood,/turf/simulated/floor/wood/boat/starting,/area/singleplayer/interior)
"C" = (/mob/living/advanced/npc/unique/marwani/ship,/turf/simulated/floor/wood/boat/starting,/area/singleplayer/interior)

(1,1,1) = {"
jjjjjjjjjjjjjjjjjjjjjjjjjjjjjjjjjjjjjjjjjjjjjjjjjjjjjjjjjjjjjjjjjjjjjjjjjjjjjjjjjjjjjjjqqqqqqqqqqqqqqqqqqqqqqqqqqqqqqqqqqqqqjjjj
jjjjjjjjjjjjjjjjjjjjjjjjjjjjjjjjjjjjjjjjjjjjjjjjjjjjjjjjjjjjjjjjjjjjjjjjjjjjjjjjjjjjjjjqqqqqqqqqqqqqqqqqqqqqqqqqqqqqqqqqqqqqjjjj
jjjjjjjjjjjjjjjjjjjjjjjjjjjjjjjjjjjjjjjjjjjjjjjjjjjjjjjjjjjjjjjjjjjjjjjjjjjjjjjjjjjjjjjqqqqqqqqqqqqqqqqqqqqqqqqqqqqqqqqqqqqqjjjj
jjjjjjjjjjjjjjjjjjjjjjjjjjjjjjjjjjjjjjjjjjjjjjjjjjjjjjjjjjjjjjjjjjjjjjjjjjjjjjjjjjjjjjjqqqqqqqqqqqqqqqqqqqqqqqqqqqqqqqqqqqqqjjjj
jjjjjjjjjjjjjjjjjjjjjjjjjjjjjjjjjjjjjjjjjjjjjjjjjjjjjjjjjjjjjjjjjjjjjjjjjjjjjjjjjjjjjjjqqqqqqqqqqqqqqqqqqqqqqqqqqqqqqqqqqqqqjjjj
jjjjjjjjjjjjjjjjjjjjjjjjjjjjjjjjjjjjjjjjjjjjjjjjjjjjjjjjjjjjjjjjjjjjjjjjjjjjjjjjjjjjjjjqqqqqqqqqqqqqqqqqqqqqqqqqqqqqqqqqqqqqjjjj
jjjjjjjjjjjjjjjjjjjjjjjjjjjjjjjjjjjjjjjjjjjjjjjjjjjjjjjjjjjjjjjjjjjjjjjjjjjjjjjjjjjjjjjqqqqqqqqqqqqqqqqqqqqqqqqqqqqqqqqqqqqqjjjj
jjjjjjjjjjjjjjjjjjjjjjjjjjjjjjjjjjjjjjjjjjjjjjjjjjjjjjjjjjjjjjjjjjjjjjjjjjjjjjjjjjjjjjjqqqqqqqqqqqqqqqqqqqqqqqqqqqqqqqqqqqqqjjjj
jjjjjjjjjjjjjjjjjjjjjjjjjjjjjjjjjjjjjjjjjjjjjjjjjjjjjjjjjjjjjjjjjjjjjjjjjjjjjjjjjjjjjjjqqqqqqqqqqqqqqqqqqqqqqqqqqqqqqqqqqqqqjjjj
jjjjjjjjjjjjjjjjjjjjjjjjjjjjjjjjjjjjjjjjjjjjjjjjjjjjjjjjjjjjjjjjjjjjjjjjjjjjjjjjjjjjjjjqqqqqqqqqqqqqqqqqqqqqqqqqqqqqqqqqqqqqjjjj
jjjjjjjjjjjjjjjjjjjjjjjjjjjjjjjjjjjjjjjjjjjjjjjjjjjjjjjjjjjjjjjjjjjjjjjjjjjjjjjjjjjjjjjqqqqqqqqqqqqqqqqrrrrrqqqqqqqqqqqqqqqqjjjj
jjjjjjjjjjjjjjjjjjjjjjjjjjjjjjjjjjjjjjjjjjjjjjjjjjjjjjjjjjjjjjjjjjjjjjjjjjjjjjjjjjjjjjjqqqqqqqqqqqqqqqrrrrrrrqqqqqqqqqqqqqqqjjjj
jjjjjjjjjjjjjjjjjjjjjjjjjjjjjjjjjjjjjjjjjjjjjjjjjjjjjjjjjjjjjjjjjjjjjjjjjjjjjjjjjjjjjjjqqqqqqqqqqqqqqrrrrrrrrrqqqqqqqqqqqqqqjjjj
jjjjjjjjjjjjjjjjjjjjjjjjjjjjjjjjjjjjjjjjjjjjjjjjjjjjjjjjjjjjjjjjjjjjjjjjjjjjjjjjjjjjjjjqqqqqqqqqqqqqqrturvrttrqqqqqqqqqqqqqqjjjj
jjjjjjjjjjjjjjjjjjjjjjjjjjjjjjjjjjjjjjjjjjjjjjjjjjjjjjjjjjjjjjjjjjjjjjjjjjjjjjjjjjjjjjjqqqqqqqqqqqqqqrxxxxCxxrqqqqqqqqqqqqqqjjjj
jjjjjjjjjjjjjjjjjjjjjjjjjjjjjjjjjjjjjjjjjjjjjjjjjjjjjjjjjjjjjjjjjjjjjjjjjjjjjjjjjjjjjjjqqqqqqqqqqqqqqrxxxxxxxrqqqqqqqqqqqqqqjjjj
jjjjjjjjjjjjjjjjjjjjjjjjjjjjjjjjjjjjjjjjjjjjjjjjjjjjjjjjjjjjjjjjjjjjjjjjjjjjjjjjjjjjjjjqqqqqqqqqqqqqqrrrrxrrrrqqqqqqqqqqqqqqjjjj
jjjjjjjjjjjjjjjjjjjjjjjjjjjjjjjjjjjjjjjjjjjjjjjjjjjjjjjjjjjjjjjjjjjjjjjjjjjjjjjjjjjjjjjqqqqqqqqqqqqqqryzrxrzyrqqqqqqqqqqqqqqjjjj
jjjjjjjjjjjjjjjjjjjjjjjjjjjjjjjjjjjjjjjjjjjjjjjjjjjjjjjjjjjjjjjjjjjjjjjjjjjjjjjjjjjjjjjqqqqqqqqqqqqqqrxxrxxxxrqqqqqqqqqqqqqqjjjj
jjjjjjjjjjjjjjjjjjjjjjjjjjjjjjjjjjjjjjjjjjjjjjjjjjjjjjjjjjjjjjjjjjjjjjjjjjjjjjjjjjjjjjjqqqqqqqqqqqqqqrxxxxrxxrqqqqqqqqqqqqqqjjjj
jjjjjjjjjjjjjjjjjjjjjjjjjjjjjjjjjjjjjjjjjjjjjjjjjjjjjjjjjjjjjjjjjjjjjjjjjjjjjjjjjjjjjjjqqqqqqqqqqqqqqrxxrxrxxrqqqqqqqqqqqqqqjjjj
jjjjjjjjjjjjjjjjjjjjjjjjjjjjjjjjjjjjjjjjjjjjjjjjjjjjjjjjjjjjjjjjjjjjjjjjjjjjjjjjjjjjjjjqqqqqqqqqqqqqqrrrrxrrrrqqqqqqqqqqqqqqjjjj
jjjjjjjjjjjjjjjjjjjjjjjjjjjjjjjjjjjjjjjjjjjjjjjjjjjjjjjjjjjjjjjjjjjjjjjjjjjjjjjjjjjjjjjqqqqqqqqqqqqqqrAzrxrzyrqqqqqqqqqqqqqqjjjj
jjjjjjjjjjjjjjjjjjjjjjjjjjjjjjjjjjjjjjjjjjjjjjjjjjjjjjjjjjjjjjjjjjjjjjjjjjjjjjjjjjjjjjjqqqqqqqqqqqqqqrxxrxxxxrqqqqqqqqqqqqqqjjjj
jjjjjjjjjjjjjjjjjjjjjjjjjjjjjjjjjjjjjjjjjjjjjjjjjjjjjjjjjjjjjjjjjjjjjjjjjjjjjjjjjjjjjjjqqqqqqqqqqqqqqrxxxxrxxrqqqqqqqqqqqqqqjjjj
jjjjjjjjjjjjjjjjjjjjjjjjjjjjjjjjjjjjjjjjjjjjjjjjjjjjjjjjjjjjjjjjjjjjjjjjjjjjjjjjjjjjjjjqqqqqqqqqqqqqqrxxrxrxxrqqqqqqqqqqqqqqjjjj
jjjjjjjjjjjjjjjjjjjjjjjjjjjjjjjjjjjjjjjjjjjjjjjjjjjjjjjjjjjjjjjjjjjjjjjjjjjjjjjjjjjjjjjqqqqqqqqqqqqqqrrrrxrrrrqqqqqqqqqqqqqqjjjj
jjjjjjjjjjjjjjjjjjjjjjjjjjjjjjjjjjjjjjjjjjjjjjjjjjjjjjjjjjjjjjjjjjjjjjjjjjjjjjjjjjjjjjjqqqqqqqqqqqqqqqrxxxxxrqqqqqqqqqqqqqqqjjjj
jjjjjjjjjjjjjjjjjjjjjjjjjjjjjjjjjjjjjjjjjjjjjjjjjjjjjjjjjjjjjjjjjjjjjjjjjjjjjjjjjjjjjjjqqqqqqqqqqqqqqqrrzBBrrqqqqqqqqqqqqqqqjjjj
jjjjjjjjjjjjjjjjjjjjjjjjjjjjjjjjjjjjjjjjjjjjjjjjjjjjjjjjjjjjjjjjjjjjjjjjjjjjjjjjjjjjjjjqqqqqqqqqqqqqqqqrrrrrqqqqqqqqqqqqqqqqjjjj
jjjjjjjjjjjjjjjjjjjjjjjjjjjjjjjjjjjjjjjjjjjjjjjjjjjjjjjjjjjjjjjjjjjjjjjjjjjjjjjjjjjjjjjqqqqqqqqqqqqqqqqqqqqqqqqqqqqqqqqqqqqqjjjj
jjjjjjjjjjjjjjjjjjjjjjjjjjjjjjjjjjjjjjjjjjjjjjjjjjjjjjjjjjjjjjjjjjjjjjjjjjjjjjjjjjjjjjjqqqqqqqqqqqqqqqqqqqqqqqqqqqqqqqqqqqqqjjjj
jjjjjjjjjjjjjjjjjjjjjjjjjjjjjjjjjjjjjjjjjjjjjjjjjjjjjjjjjjjjjjjjjjjjjjjjjjjjjjjjjjjjjjjqqqqqqqqqqqqqqqqqqqqqqqqqqqqqqqqqqqqqjjjj
jjjjjjjjjjjjjjjjjjjjjjjjjjjjjjjjjjjjjjjjjjjjjjjjjjjjjjjjjjjjjjjjjjjjjjjjjjjjjjjjjjjjjjjqqqqqqqqqqqqqqqqqqqqqqqqqqqqqqqqqqqqqjjjj
jjjjjjjjjjjjjjjjjjjjjjjjjjjjjjjjjjjjjjjjjjjjjjjjjjjjjjjjjjjjjjjjjjjjjjjjjjjjjjjjjjjjjjjqqqqqqqqqqqqqqqqqqqqqqqqqqqqqqqqqqqqqjjjj
jjjjjjjjjjjjjjjjjjjjjjjjjjjjjjjjjjjjjjjjjjjjjjjjjjjjjjjjjjjjjjjjjjjjjjjjjjjjjjjjjjjjjjjqqqqqqqqqqqqqqqqqqqqqqqqqqqqqqqqqqqqqjjjj
jjjjjjjjjjjjjjjjjjjjjjjjjjjjjjjjjjjjjjjjjjjjjjjjjjjjjjjjjjjjjjjjjjjjjjjjjjjjjjjjjjjjjjjqqqqqqqqqqqqqqqqqqqqqqqqqqqqqqqqqqqqqjjjj
jjjjjjjjjjjjjjjjjjjjjjjjjjjjjjjjjjjjjjjjjjjjjjjjjjjjjjjjjjjjjjjjjjjjjjjjjjjjjjjjjjjjjjjqqqqqqqqqqqqqqqqqqqqqqqqqqqqqqqqqqqqqjjjj
jjjjjjjjjjjjjjjjjjjjjjjjjjjjjjjjjjjjjjjjjjjjjjjjjjjjjjjjjjjjjjjjjjjjjjjjjjjjjjjjjjjjjjjqqqqqqqqqqqqqqqqqqqqqqqqqqqqqqqqqqqqqjjjj
jjjjjjjjjjjjjjjjjjjjjjjjjjjjjjjjjjjjjjjjjjjjjjjjjjjjjjjjjjjjjjjjjjjjjjjjjjjjjjjjjjjjjjjqqqqqqqqqqqqqqqqqqqqqqqqqqqqqqqqqqqqqjjjj
jjjjjjjjjjjjjjjjjjjjjjjjjjjjjjjjjjjjjjjjjjjjjjjjjjjjjjjjjjjjjjjjjjjjjjjjjjjjjjjjjjjjjjjqqqqqqqqqqqqqqqqqqqqqqqqqqqqqqqqqqqqqjjjj
jjjjjjjjjjjjjjjjjjjjjjjjjjjjjjjjjjjjjjjjjjjjjjjjjjjjjjjjjjjjjjjjjjjjjjjjjjjjjjjjjjjjjjjqqqqqqqqqqqqqqqqqqqqqqqqqqqqqqqqqqqqqjjjj
jjjjjjjjjjjjjjjjjjjjjjjjjjjjjjjjjjjjjjjjjjjjjjjjjjjjjjjjjjjjjjjjjjjjjjjjjjjjjjjjjjjjjjjqqqqqqqqqqqqqqqqqqqqqqqqqqqqqqqqqqqqqjjjj
jjjjjjjjjjjjjjjjjjjjjjjjjjjjjjjjjjjjjjjjjjjjjjjjjjjjjjjjjjjjjjjjjjjjjjjjjjjjjjjjjjjjjjjqqqqqqqqqqqqqqqqqqqqqqqqqqqqqqqqqqqqqjjjj
jjjjjjjjjjjjjjjjjjjjjjjjjjjjjjjjjjjjjjjjjjjjjjjjjjjjjjjjjjjjjjjjjjjjjjjjjjjjjjjjjjjjjjjqqqqqqqqqqqqqqqqqqqqqqqqqqqqqqqqqqqqqjjjj
jjjjjjjjjjjjjjjjjjjjjjjjjjjjjjjjjjjjjjjjjjjjjjjjjjjjjjjjjjjjjjjjjjjjjjjjjjjjjjjjjjjjjjjqqqqqqqqqqqqqqqqqqqqqqqqqqqqqqqqqqqqqjjjj
jjjjjjjjjjjjjjjjjjjjjjjjjjjjjjjjjjjjjjjjjjjjjjjjjjjjjjjjjjjjjjjjjjjjjjjjjjjjjjjjjjjjjjjqqqqqqqqqqqqqqqqqqqqqqqqqqqqqqqqqqqqqjjjj
jjjjjjjjjjjjjjjjjjjjjjjjjjjjjjjjjjjjjjjjjjjjjjjjjjjjjjjjjjjjjjjjjjjjjjjjjjjjjjjjjjjjjjjqqqqqqqqqqqqqqqqqqqqqqqqqqqqqqqqqqqqqjjjj
jjjjjjjjjjjjjjjjjjjjjjjjjjjjjjjjjjjjjjjjjjjjjjjjjjjjjjjjjjjjjjjjjjjjjjjjjjjjjjjjjjjjjjjqqqqqqqqqqqqqqqqqqqqqqqqqqqqqqqqqqqqqjjjj
jjjjjjjjjjjjjjjjjjjjjjjjjjjjjjjjjjjjjjjjjjjjjjjjjjjjjjjjjjjjjjjjjjjjjjjjjjjjjjjjjjjjjjjqqqqqqqqqqqqqqqqqqqqqqqqqqqqqqqqqqqqqjjjj
jjjjjjjjjjjjjjjjjjjjjjjjjjjjjjjjjjjjjjjjjjjjjjjjjjjjjjjjjjjjjjjjjjjjjjjjjjjjjjjjjjjjjjjqqqqqqqqqqqqqqqqqqqqqqqqqqqqqqqqqqqqqjjjj
jjjjjjjjjjjjjjjjjjjjjjjjjjjjjjjjjjjjjjjjjjjjjjjjjjjjjjjjjjjjjjjjjjjjjjjjjjjjjjjjjjjjjjjqqqqqqqqqqqqqqqqqqqqqqqqqqqqqqqqqqqqqjjjj
jjjjjjjjjjjjjjjjjjjjjjjjjjjjjjjjjjjjjjjjjjjjjjjjjjjjjjjjjjjjjjjjjjjjjjjjjjjjjjjjjjjjjjjqqqqqqqqqqqqqqqqqqqqqqqqqqqqqqqqqqqqqjjjj
jjjjjjjjjjjjjjjjjjjjjjjjjjjjjjjjjjjjjjjjjjjjjjjjjjjjjjjjjjjjjjjjjjjjjjjjjjjjjjjjjjjjjjjqqqqqqqqqqqqqqqqqqqqqqqqqqqqqqqqqqqqqjjjj
jjjjjjjjjjjjjjjjjjjjjjjjjjjjjjjjjjjjjjjjjjjjjjjjjjjjjjjjjjjjjjjjjjjjjjjjjjjjjjjjjjjjjjjqqqqqqqqqqqqqqqqqqqqqqqqqqqqqqqqqqqqqjjjj
jjjjjjjjjjjjjjjjjjjjjjjjjjjjjjjjjjjjjjjjjjjjjjjjjjjjjjjjjjjjjjjjjjjjjjjjjjjjjjjjjjjjjjjqqqqqqqqqqqqqqqqqqqqqqqqqqqqqqqqqqqqqjjjj
jjjjjjjjjjjjjjjjjjjjjjjjjjjjjjjjjjjjjjjjjjjjjjjjjjjjjjjjjjjjjjjjjjjjjjjjjjjjjjjjjjjjjjjqqqqqqqqqqqqqqqqqqqqqqqqqqqqqqqqqqqqqjjjj
jjjjjjjjjjjjjjjjjjjjjjjjjjjjjjjjjjjjjjjjjjjjjjjjjjjjjjjjjjjjjjjjjjjjjjjjjjjjjjjjjjjjjjjqqqqqqqqqqqqqqqqqqqqqqqqqqqqqqqqqqqqqjjjj
jjjjjjjjjjjjjjjjjjjjjjjjjjjjjjjjjjjjjjjjjjjjjjjjjjjjjjjjjjjjjjjjjjjjjjjjjjjjjjjjjjjjjjjqqqqqqqqqqqqqqqqqqqqqqqqqqqqqqqqqqqqqjjjj
jjjjjjjjjjjjjjjjjjjjjjjjjjjjjjjjjjjjjjjjjjjjjjjjjjjjjjjjjjjjjjjjjjjjjjjjjjjjjjjjjjjjjjjqqqqqqqqqqqqqqqqqqqqqqqqqqqqqqqqqqqqqjjjj
jjjjjjjjjjjjjjjjjjjjjjjjjjjjjjjjjjjjjjjjjjjjjjjjjjjjjjjjjjjjjjjjjjjjjjjjjjjjjjjjjjjjjjjqqqqqqqqqqqqqqqqqqqqqqqqqqqqqqqqqqqqqjjjj
jjjjjjjjjjjjjjjjjjjjjjjjjjjjjjjjjjjjjjjjjjjjjjjjjjjjjjjjjjjjjjjjjjjjjjjjjjjjjjjjjjjjjjjqqqqqqqqqqqqqqqqqqqqqqqqqqqqqqqqqqqqqjjjj
jjjjjjjjjjjjjjjjjjjjjjjjjjjjjjjjjjjjjjjjjjjjjjjjjjjjjjjjjjjjjjjjjjjjjjjjjjjjjjjjjjjjjjjqqqqqqqqqqqqqqqqqqqqqqqqqqqqqqqqqqqqqjjjj
jjjjjjjjjjjjjjjjjjjjjjjjjjjjjjjjjjjjjjjjjjjjjjjjjjjjjjjjjjjjjjjjjjjjjjjjjjjjjjjjjjjjjjjqqqqqqqqqqqqqqqqqqqqqqqqqqqqqqqqqqqqqjjjj
jjjjjjjjjjjjjjjjjjjjjjjjjjjjjjjjjjjjjjjjjjjjjjjjjjjjjjjjjjjjjjjjjjjjjjjjjjjjjjjjjjjjjjjqqqqqqqqqqqqqqqqqqqqqqqqqqqqqqqqqqqqqjjjj
jjjjjjjjjjjjjjjjjjjjjjjjjjjjjjjjjjjjjjjjjjjjjjjjjjjjjjjjjjjjjjjjjjjjjjjjjjjjjjjjjjjjjjjqqqqqqqqqqqqqqqqqqqqqqqqqqqqqqqqqqqqqjjjj
jjjjjjjjjjjjjjjjjjjjjjjjjjjjjjjjjjjjjjjjjjjjjjjjjjjjjjjjjjjjjjjjjjjjjjjjjjjjjjjjjjjjjjjqqqqqqqqqqqqqqqqqqqqqqqqqqqqqqqqqqqqqjjjj
jjjjjjjjjjjjjjjjjjjjjjjjjjjjjjjjjjjjjjjjjjjjjjjjjjjjjjjjjjjjjjjjjjjjjjjjjjjjjjjjjjjjjjjqqqqqqqqqqqqqqqqqqqqqqqqqqqqqqqqqqqqqjjjj
jjjjjjjjjjjjjjjjjjjjjjjjjjjjjjjjjjjjjjjjjjjjjjjjjjjjjjjjjjjjjjjjjjjjjjjjjjjjjjjjjjjjjjjqqqqqqqqqqqqqqqqqqqqqqqqqqqqqqqqqqqqqjjjj
jjjjjjjjjjjjjjjjjjjjjjjjjjjjjjjjjjjjjjjjjjjjjjjjjjjjjjjjjjjjjjjjjjjjjjjjjjjjjjjjjjjjjjjqqqqqqqqqqqqqqqqqqqqqqqqqqqqqqqqqqqqqjjjj
jjjjjjjjjjjjjjjjjjjjjjjjjjjjjjjjjjjjjjjjjjjjjjjjjjjjjjjjjjjjjjjjjjjjjjjjjjjjjjjjjjjjjjjqqqqqqqqqqqqqqqqqqqqqqqqqqqqqqqqqqqqqjjjj
jjjjjjjjjjjjjjjjjjjjjjjjjjjjjjjjjjjjjjjjjjjjjjjjjjjjjjjjjjjjjjjjjjjjjjjjjjjjjjjjjjjjjjjqqqqqqqqqqqqqqqqqqqqqqqqqqqqqqqqqqqqqjjjj
jjjjjjjjjjjjjjjjjjjjjjjjjjjjjjjjjjjjjjjjjjjjjjjjjjjjjjjjjjjjjjjjjjjjjjjjjjjjjjjjjjjjjjjqqqqqqqqqqqqqqqqqqqqqqqqqqqqqqqqqqqqqjjjj
jjjjjjjjjjjjjjjjjjjjjjjjjjjjjjjjjjjjjjjjjjjjjjjjjjjjjjjjjjjjjjjjjjjjjjjjjjjjjjjjjjjjjjjqqqqqqqqqqqqqqqqqqqqqqqqqqqqqqqqqqqqqjjjj
jjjjjjjjjjjjjjjjjjjjjjjjjjjjjjjjjjjjjjjjjjjjjjjjjjjjjjjjjjjjjjjjjjjjjjjjjjjjjjjjjjjjjjjqqqqqqqqqqqqqqqqqqqqqqqqqqqqqqqqqqqqqjjjj
jjjjjjjjjjjjjjjjjjjjjjjjjjjjjjjjjjjjjjjjjjjjjjjjjjjjjjjjjjjjjjjjjjjjjjjjjjjjjjjjjjjjjjjqqqqqqqqqqqqqqqqqqqqqqqqqqqqqqqqqqqqqjjjj
jjjjjjjjjjjjjjjjjjjjjjjjjjjjjjjjjjjjjjjjjjjjjjjjjjjjjjjjjjjjjjjjjjjjjjjjjjjjjjjjjjjjjjjqqqqqqqqqqqqqqqqqqqqqqqqqqqqqqqqqqqqqjjjj
jjjjjjjjjjjjjjjjjjjjjjjjjjjjjjjjjjjjjjjjjjjjjjjjjjjjjjjjjjjjjjjjjjjjjjjjjjjjjjjjjjjjjjjqqqqqqqqqqqqqqqqqqqqqqqqqqqqqqqqqqqqqjjjj
jjjjjjjjjjjjjjjjjjjjjjjjjjjjjjjjjjjjjjjjjjjjjjjjjjjjjjjjjjjjjjjjjjjjjjjjjjjjjjjjjjjjjjjqqqqqqqqqqqqqqqqqqqqqqqqqqqqqqqqqqqqqjjjj
jjjjjjjjjjjjjjjjjjjjjjjjjjjjjjjjjjjjjjjjjjjjjjjjjjjjjjjjjjjjjjjjjjjjjjjjjjjjjjjjjjjjjjjqqqqqqqqqqqqqqqqqqqqqqqqqqqqqqqqqqqqqjjjj
jjjjjjjjjjjjjjjjjjjjjjjjjjjjjjjjjjjjjjjjjjjjjjjjjjjjjjjjjjjjjjjjjjjjjjjjjjjjjjjjjjjjjjjqqqqqqqqqqqqqqqqqqqqqqqqqqqqqqqqqqqqqjjjj
jjjjjjjjjjjjjjjjjjjjjjjjjjjjjjjjjjjjjjjjjjjjjjjjjjjjjjjjjjjjjjjjjjjjjjjjjjjjjjjjjjjjjjjqqqqqqqqqqqqqqqqqqqqqqqqqqqqqqqqqqqqqjjjj
jjjjjjjjjjjjjjjjjjjjjjjjjjjjjjjjjjjjjjjjjjjjjjjjjjjjjjjjjjjjjjjjjjjjjjjjjjjjjjjjjjjjjjjqqqqqqqqqqqqqqqqqqqqqqqqqqqqqqqqqqqqqjjjj
jjjjjjjjjjjjjjjjjjjjjjjjjjjjjjjjjjjjjjjjjjjjjjjjjjjjjjjjjjjjjjjjjjjjjjjjjjjjjjjjjjjjjjjqqqqqqqqqqqqqqqqqqqqqqqqqqqqqqqqqqqqqjjjj
jjjjjjjjjjjjjjjjjjjjjjjjjjjjjjjjjjjjjjjjjjjjjjjjjjjjjjjjjjjjjjjjjjjjjjjjjjjjjjjjjjjjjjjqqqqqqqqqqqqqqqqqqqqqqqqqqqqqqqqqqqqqjjjj
jjjjjjjjjjjjjjjjjjjjjjjjjjjjjjjjjjjjjjjjjjjjjjjjjjjjjjjjjjjjjjjjjjjjjjjjjjjjjjjjjjjjjjjqqqqqqqqqqqqqqqqqqqqqqqqqqqqqqqqqqqqqjjjj
jjjjjjjjjjjjjjjjjjjjjjjjjjjjjjjjjjjjjjjjjjjjjjjjjjjjjjjjjjjjjjjjjjjjjjjjjjjjjjjjjjjjjjjqqqqqqqqqqqqqqqqqqqqqqqqqqqqqqqqqqqqqjjjj
jjjjjjjjjjjjjjjjjjjjjjjjjjjjjjjjjjjjjjjjjjjjjjjjjjjjjjjjjjjjjjjjjjjjjjjjjjjjjjjjjjjjjjjqqqqqqqqqqqqqqqqqqqqqqqqqqqqqqqqqqqqqjjjj
jjjjjjjjjjjjjjjjjjjjjjjjjjjjjjjjjjjjjjjjjjjjjjjjjjjjjjjjjjjjjjjjjjjjjjjjjjjjjjjjjjjjjjjqqqqqqqqqqqqqqqqqqqqqqqqqqqqqqqqqqqqqjjjj
jjjjjjjjjjjjjjjjjjjjjjjjjjjjjjjjjjjjjjjjjjjjjjjjjjjjjjjjjjjjjjjjjjjjjjjjjjjjjjjjjjjjjjjqqqqqqqqqqqqqqqqqqqqqqqqqqqqqqqqqqqqqjjjj
jjjjjjjjjjjjjjjjjjjjjjjjjjjjjjjjjjjjjjjjjjjjjjjjjjjjjjjjjjjjjjjjjjjjjjjjjjjjjjjjjjjjjjjqqqqqqqqqqqqqqqqqqqqqqqqqqqqqqqqqqqqqjjjj
jjjjjjjjjjjjjjjjjjjjjjjjjjjjjjjjjjjjjjjjjjjjjjjjjjjjjjjjjjjjjjjjjjjjjjjjjjjjjjjjjjjjjjjqqqqqqqqqqqqqqqqqqqqqqqqqqqqqqqqqqqqqjjjj
jjjjjjjjjjjjjjjjjjjjjjjjjjjjjjjjjjjjjjjjjjjjjjjjjjjjjjjjjjjjjjjjjjjjjjjjjjjjjjjjjjjjjjjqqqqqqqqqqqqqqqqqqqqqqqqqqqqqqqqqqqqqjjjj
jjjjjjjjjjjjjjjjjjjjjjjjjjjjjjjjjjjjjjjjjjjjjjjjjjjjjjjjjjjjjjjjjjjjjjjjjjjjjjjjjjjjjjjqqqqqqqqqqqqqqqqqqqqqqqqqqqqqqqqqqqqqjjjj
jjjjjjjjjjjjjjjjjjjjjjjjjjjjjjjjjjjjjjjjjjjjjjjjjjjjjjjjjjjjjjjjjjjjjjjjjjjjjjjjjjjjjjjqqqqqqqqqqqqqqqqqqqqqqqqqqqqqqqqqqqqqjjjj
jjjjjjjjjjjjjjjjjjjjjjjjjjjjjjjjjjjjjjjjjjjjjjjjjjjjjjjjjjjjjjjjjjjjjjjjjjjjjjjjjjjjjjjqqqqqqqqqqqqqqqqqqqqqqqqqqqqqqqqqqqqqjjjj
jkkkkkkkbbbbkkkkbccebkbchhhhcbkkkkjwwwwwwwwwwwwwwwwwwwwwwwwwwwwwwwwwjjjjjjjjjjjjjjjjjjjqqqqqqqqqqqqqqqqqqqqqqqqqqqqqqqqqqqqqjjjj
jkkkkdcccccccccdbccbbkochhhhcbbkkkjwwwwwwwwwwwwwwwwwwwwwwwwwwwwwwwwwjjjjjjjjjjjjjjjjjjjqqqqqqqqqqqqqqqqqqqqqqqqqqqqqqqqqqqqqjjjj
jbbbbcfffffffffcbcccbkkchhhhccbkkkjwwwwwwwwwwwwwwwwwwwwwwwwwwwwwwwwwjjjjjjjjjjjjjjjjjjjqqqqqqqqqqqqqqqqqqqqqqqqqqqqqqqqqqqqqjjjj
jbbbbcfsssssssfcbbccebbchhhhccbkkkjwwwwwwwwwwwwwwwwwwwwwwwwwwwwwwwwwjjjjjjjjjjjjjjjjjjjqqqqqqqqqqqqqqqqqqqqqqqqqqqqqqqqqqqqqjjjj
jbbbbcfsssssssfcbbcccbbchhhhccbkkkjwwwwwwwwwwwwwwwwwwwwwwwwwwwwwwwwwjjjjjjjjjjjjjjjjjjjqqqqqqqqqqqqqqqqqqqqqqqqqqqqqqqqqqqqqjjjj
jbbbbcfsssssssfclbmccbnnhhhhccbkkkjwwwwwwwwwwwwwwwwwwwwwwwwwwwwwwwwwjjjjjjjjjjjjjjjjjjjqqqqqqqqqqqqqqqqqqqqqqqqqqqqqqqqqqqqqjjjj
jbbbbcfsssssssfcbbeccnnnhhhhccbokkjwwwwwwwwwwwwwwwwwwwwwwwwwwwwwwwwwjjjjjjjjjjjjjjjjjjjqqqqqqqqqqqqqqqqqqqqqqqqqqqqqqqqqqqqqjjjj
jkkbbcfsssssssfckbbccnnnhhhhccbkkkjwwwwwwwwwwwwwwwwwwwwwwwwwwwwwwwwwjjjjjjjjjjjjjjjjjjjqqqqqqqqqqqqqqqqqqqqqqqqqqqqqqqqqqqqqjjjj
jkkbbcfsssssssfckkbcccnnhhhhcbkkkkjwwwwwwwwwwwwwwwwwwwwwwwwwwwwwwwwwjjjjjjjjjjjjjjjjjjjqqqqqqqqqqqqqqqqqqqqqqqqqqqqqqqqqqqqqjjjj
jkkbbcfsssssssfcbkocccnnhhhhcbkkkkjwwwwwwwwwwwwwwwwwwwwwwwwwwwwwwwwwjjjjjjjjjjjjjjjjjjjqqqqqqqqqqqqqqqqqqqqqqqqqqqqqqqqqqqqqjjjj
jkkbbcfsssssssfcbkkccbcchhhhcbbkkkjwwwwwwwwwwwwwwwwwwwwwwwwwwwwwwwwwjjjjjjjjjjjjjjjjjjjqqqqqqqqqqqqqqqqqqqqqqqqqqqqqqqqqqqqqjjjj
jkkbbcffffiffffcbbbccbbchhhhccbkkkjwwwwwwwwwwwwwwwwwwwwwwwwwwwwwwwwwjjjjjjjjjjjjjjjjjjjqqqqqqqqqqqqqqqqqqqqqqqqqqqqqqqqqqqqqjjjj
jkkbbdcccccccccdbbecccbchhhhcnbkkkjwwwwwwwwwwwwwwwwwwwwwwwwwwwwwwwwwjjjjjjjjjjjjjjjjjjjqqqqqqqqqqqqqqqqqqqqqqqqqqqqqqqqqqqqqjjjj
jbkbbbbblbcbbbbbblcccbbchhhhccbkkkjwwwwwwwwwwwwwwwwwwwwwwwwwwwwwwwwwjjjjjjjjjjjjjjjjjjjqqqqqqqqqqqqqqqqqqqqqqqqqqqqqqqqqqqqqjjjj
jbkbobbbbbcckkkbbccccblchhhhccbkkkjwwwwwwwwwwwwwwwwwwwwwwwwwwwwwwwwwjjjjjjjjjjjjjjjjjjjqqqqqqqqqqqqqqqqqqqqqqqqqqqqqqqqqqqqqjjjj
jbkbmmmmmkkckokbcpccbbcchhhhcbbkkkjwwwwwwwwwwwwwwwwwwwwwwwwwwwwwwwwwjjjjjjjjjjjjjjjjjjjqqqqqqqqqqqqqqqqqqqqqqqqqqqqqqqqqqqqqjjjj
jbkbmmmmmkkcccbeccccbbcchhhhckkkkkjwwwwwwwwwwwwwwwwawwwwwwwwwwwwwwwwjjjjjjjjjjjjjjjjjjjqqqqqqqqqqqqqqqqqqqqqqqqqqqqqqqqqqqqqjjjj
jbkbmmgmmkkkkccccccbbbcchhhhcbkkkkjwwwwwwwwwwwwwwwwwwwwwwwwwwwwwwwwwjjjjjjjjjjjjjjjjjjjqqqqqqqqqqqqqqqqqqqqqqqqqqqqqqqqqqqqqjjjj
jbkkmmcmmkkkbbccccebbbbchhhhcbkkkkjwwwwwwwwwwwwwwwwwwwwwwwwwwwwwwwwwjjjjjjjjjjjjjjjjjjjqqqqqqqqqqqqqqqqqqqqqqqqqqqqqqqqqqqqqjjjj
jbbkbmcmbkkbbbccccbbombchhhhcbbkokjwwwwwwwwwwwwwwwwwwwwwwwwwwwwwwwwwjjjjjjjjjjjjjjjjjjjqqqqqqqqqqqqqqqqqqqqqqqqqqqqqqqqqqqqqjjjj
jbbkbbccbmobecccclbkkbcchhhhccbkkkjwwwwwwwwwwwwwwwwwwwwwwwwwwwwwwwwwjjjjjjjjjjjjjjjjjjjqqqqqqqqqqqqqqqqqqqqqqqqqqqqqqqqqqqqqjjjj
jbbkkbbccbbbccccbbbkkbcchhhhccbkkkjwwwwwwwwwwwwwwwwwwwwwwwwwwwwwwwwwjjjjjjjjjjjjjjjjjjjqqqqqqqqqqqqqqqqqqqqqqqqqqqqqqqqqqqqqjjjj
jbeobbbbcelccccebmkkkmcchhhhnckkkkjwwwwwwwwwwwwwwwwwwwwwwwwwwwwwwwwwjjjjjjjjjjjjjjjjjjjqqqqqqqqqqqqqqqqqqqqqqqqqqqqqqqqqqqqqjjjj
jcccccbbcccccccbbkkkkbcchhhhnckkkkjwwwwwwwwwwwwwwwwwwwwwwwwwwwwwwwwwjjjjjjjjjjjjjjjjjjjqqqqqqqqqqqqqqqqqqqqqqqqqqqqqqqqqqqqqjjjj
jccccccccccccclbmkkkkbbchhhhnckkkkjwwwwwwwwwwwwwwwwwwwwwwwwwwwwwwwwwjjjjjjjjjjjjjjjjjjjqqqqqqqqqqqqqqqqqqqqqqqqqqqqqqqqqqqqqjjjj
jcccccccccccbbbbbkkokbbchhhhcckkkkjwwwwwwwwwwwwwwwwwwwwwwwwwwwwwwwwwjjjjjjjjjjjjjjjjjjjqqqqqqqqqqqqqqqqqqqqqqqqqqqqqqqqqqqqqjjjj
jbeccccccebbbbbbkkkkkbbchhhhccbkkkjwwwwwwwwwwwwwwwwwwwwwwwwwwwwwwwwwjjjjjjjjjjjjjjjjjjjqqqqqqqqqqqqqqqqqqqqqqqqqqqqqqqqqqqqqjjjj
jbbbbbbbbbbkkkkkkkkkbbbchhhhccbkkkjwwwwwwwwwwwwwwwwwwwwwwwwwwwwwwwwwjjjjjjjjjjjjjjjjjjjqqqqqqqqqqqqqqqqqqqqqqqqqqqqqqqqqqqqqjjjj
jbbobbbbkkkkkkkkkkkbbbbnhhhhcnbokkjwwwwwwwwwwwwwwwwwwwwwwwwwwwwwwwwwjjjjjjjjjjjjjjjjjjjqqqqqqqqqqqqqqqqqqqqqqqqqqqqqqqqqqqqqjjjj
jbbbbbkkkkkkkkkkkkkbbbcnhhhhcnbkkkjwwwwwwwwwwwwwwwwwwwwwwwwwwwwwwwwwjjjjjjjjjjjjjjjjjjjqqqqqqqqqqqqqqqqqqqqqqqqqqqqqqqqqqqqqjjjj
jbbbbbbbbbbbbbbbbbbbobcnhhhhcnbkkkjwwwwwwwwwwwwwwwwwwwwwwwwwwwwwwwwwjjjjjjjjjjjjjjjjjjjqqqqqqqqqqqqqqqqqqqqqqqqqqqqqqqqqqqqqjjjj
jjjjjjjjjjjjjjjjjjjjjjjjjjjjjjjjjjjjjjjjjjjjjjjjjjjjjjjjjjjjjjjjjjjjjjjjjjjjjjjjjjjjjjjqqqqqqqqqqqqqqqqqqqqqqqqqqqqqqqqqqqqqjjjj
"}
