"a" = (/turf/simulated/wall/boss,/area/dmm_suite/clear_area)
"b" = (/turf/dmm_suite/no_wall,/area/dmm_suite/clear_area)
"c" = (/turf/dmm_suite/clear_turf,/area/dmm_suite/clear_area)
"d" = (/mob/living/simple/leaper,/turf/dmm_suite/no_wall,/area/dmm_suite/clear_area)

(1,1,1) = {"
aaaaaaaaaaabbbbbaaaaaaaaaaaaaaaa
accccccccccbbbccccccccccccccccca
accccccccccbbbccccccccccccccccca
acccccccccccbbbcccccccccccccccca
acccccccccccbbbcccccccccccccccca
acccccccccccbbbbccccccccccccccca
acccccccccccbbbbccccccccccccccca
accccccccccccbbbccccccccccccccca
accccccccccccbbbccccccccccccccca
acccccccccccccbbbcccccccccccccca
bbbccccccccccbbbbbccccccccccccca
bbbbccccccccbbbbbbbcccccccccccca
bbbbbbcccccbbbbbbbbcccccccccccca
bbbbbbbbbbbbbbdbbbbbccccccccccca
accccbbbbbbbbbbbbbbbbbccccccccca
accccccccccbbbbbbbbbbbbcccccccca
accccccccccbbbbbbbcbbbbbccccccca
acccccccccccbbbbbcccbbbbbbccccca
accccccccccccbbbcccccbbbbbbcccca
accccccccccccbbbccccccbbbbbbccca
accccccccccccbbbccccccbbbbbbbcca
acccccccccccbbbbcccccccbbbbbbcca
acccccccccccbbbcccccccccbbbbbbba
acccccccccccbbbcccccccccccbbbbbb
accccccccccbbbcccccccccccccbbbbb
accccccccccbbbccccccccccccccbbbb
accccccccccbbbccccccccccccccccbb
acccccccccbbbbccccccccccccccccca
acccccccccbbbcccccccccccccccccca
accccccccbbbbcccccccccccccccccca
accccccccbbbccccccccccccccccccca
aaaaaaaabbbbbbaaaaaaaaaaaaaaaaaa
"}
