//MAP CONVERTED BY dmm2tgm.py THIS HEADER COMMENT PREVENTS RECONVERSION, DO NOT REMOVE
"a" = (
/turf/dmm_suite/clear_turf,
/area/dmm_suite/clear_area)
"b" = (
/turf/simulated/wall/shuttle,
/area/dmm_suite/clear_area)
"c" = (
/obj/structure/interactive/door/airlock/shuttle,
/turf/simulated/floor/tile/shuttle,
/area/dmm_suite/clear_area)
"d" = (
/turf/simulated/floor/plating/shuttle,
/area/dmm_suite/clear_area)
"e" = (
/obj/structure/shuttle_engine/large{
	dir = 4
	},
/turf/simulated/floor/plating/shuttle,
/area/dmm_suite/clear_area)
"f" = (
/turf/simulated/floor/tile/shuttle,
/area/dmm_suite/clear_area)
"g" = (
/turf/simulated/floor/tile/shuttle/purple,
/area/dmm_suite/clear_area)
"h" = (
/obj/structure/interactive/reagent_tank/water,
/turf/simulated/floor/plating/shuttle,
/area/dmm_suite/clear_area)
"i" = (
/obj/marker/spawning/window/extra,
/turf/simulated/floor/plating/shuttle,
/area/dmm_suite/clear_area)
"j" = (
/obj/structure/interactive/reagent_tank/ethanol,
/turf/simulated/floor/plating/shuttle,
/area/dmm_suite/clear_area)
"k" = (
/obj/structure/interactive/crate,
/turf/simulated/floor/plating/shuttle,
/area/dmm_suite/clear_area)
"l" = (
/obj/structure/interactive/vending/mining,
/turf/simulated/floor/tile/shuttle/purple,
/area/dmm_suite/clear_area)
"m" = (
/obj/structure/interactive/statue/director,
/turf/simulated/floor/tile/shuttle,
/area/dmm_suite/clear_area)
"n" = (
/obj/structure/smooth/table/wood,
/turf/simulated/floor/tile/shuttle/purple,
/area/dmm_suite/clear_area)
"o" = (
/obj/structure/interactive/computer/arcade/bubbletwist,
/turf/simulated/floor/tile/shuttle,
/area/dmm_suite/clear_area)
"p" = (
/obj/structure/smooth/table/wood,
/turf/simulated/floor/tile/shuttle,
/area/dmm_suite/clear_area)
"q" = (
/obj/structure/interactive/lighting/fixture/tube/station/strong,
/turf/simulated/floor/tile/shuttle/purple,
/area/dmm_suite/clear_area)
"r" = (
/obj/structure/interactive/lighting/fixture/tube/station/strong{
	icon_state = "preview";
	dir = 1
	},
/turf/simulated/floor/tile/shuttle/purple,
/area/dmm_suite/clear_area)
"s" = (
/obj/structure/interactive/lighting/fixture/tube/station,
/turf/simulated/floor/tile/shuttle/purple,
/area/dmm_suite/clear_area)
"t" = (
/obj/structure/interactive/lighting/fixture/tube/station{
	icon_state = "preview";
	dir = 1
	},
/turf/simulated/floor/tile/shuttle/purple,
/area/dmm_suite/clear_area)
"u" = (
/obj/structure/smooth/table/wood,
/obj/structure/interactive/lighting/fixture/tube/station{
	icon_state = "preview";
	dir = 1
	},
/turf/simulated/floor/tile/shuttle/purple,
/area/dmm_suite/clear_area)
"v" = (
/obj/structure/interactive/lighting/fixture/tube/station{
	icon_state = "preview";
	dir = 8
	},
/turf/simulated/floor/tile/shuttle,
/area/dmm_suite/clear_area)
"w" = (
/obj/structure/interactive/lighting/fixture/tube/station,
/turf/simulated/floor/tile/shuttle,
/area/dmm_suite/clear_area)
"x" = (
/obj/structure/interactive/lighting/fixture/tube/station{
	icon_state = "preview";
	dir = 1
	},
/turf/simulated/floor/tile/shuttle,
/area/dmm_suite/clear_area)

(1,1,1) = {"
a
a
a
a
a
a
a
a
a
a
a
a
a
a
a
a
a
a
a
a
a
a
a
a
a
a
a
a
a
a
a
a
"}
(2,1,1) = {"
a
a
a
a
a
a
a
a
a
a
a
a
a
a
a
a
a
a
a
a
a
a
a
a
a
a
a
a
a
a
a
a
"}
(3,1,1) = {"
a
a
a
a
a
a
a
a
a
a
a
a
a
a
a
a
a
a
a
a
a
a
a
a
a
a
a
a
a
a
a
a
"}
(4,1,1) = {"
a
a
a
a
a
a
a
a
a
a
a
a
a
b
b
b
b
b
b
b
a
a
a
a
a
a
a
a
a
a
a
a
"}
(5,1,1) = {"
a
a
a
a
a
a
a
a
a
a
a
a
a
b
q
i
m
i
r
b
a
a
a
a
a
a
a
a
a
a
a
a
"}
(6,1,1) = {"
a
a
a
a
a
a
a
a
a
a
a
a
a
b
g
i
i
i
g
b
a
a
a
a
a
a
a
a
a
a
a
a
"}
(7,1,1) = {"
a
a
a
a
a
a
a
a
a
a
a
a
a
b
g
f
p
f
g
b
a
a
a
a
a
a
a
a
a
a
a
a
"}
(8,1,1) = {"
a
a
a
a
a
a
a
a
a
a
a
a
a
b
g
f
f
f
g
b
a
a
a
a
a
a
a
a
a
a
a
a
"}
(9,1,1) = {"
a
a
a
a
a
a
a
a
a
a
a
a
a
b
g
f
f
f
g
b
a
a
a
a
a
a
a
a
a
a
a
a
"}
(10,1,1) = {"
a
a
a
a
a
a
a
a
a
a
a
a
a
b
s
f
f
f
t
b
a
a
a
a
a
a
a
a
a
a
a
a
"}
(11,1,1) = {"
a
a
a
a
a
a
a
b
b
b
b
b
c
b
g
f
f
f
g
b
c
b
b
b
b
b
a
a
a
a
a
a
"}
(12,1,1) = {"
a
a
a
a
a
a
a
b
h
h
b
o
f
b
g
f
f
f
g
b
f
f
b
h
h
b
a
a
a
a
a
a
"}
(13,1,1) = {"
a
a
a
a
a
a
a
c
d
d
b
f
f
b
g
f
f
f
g
b
f
f
b
d
d
c
a
a
a
a
a
a
"}
(14,1,1) = {"
a
a
a
a
a
a
a
b
k
d
b
f
f
b
g
f
f
f
g
b
f
f
b
d
d
b
a
a
a
a
a
a
"}
(15,1,1) = {"
a
a
a
a
a
a
a
b
k
d
b
f
x
b
s
f
f
f
t
b
w
f
b
d
d
b
a
a
a
a
a
a
"}
(16,1,1) = {"
a
a
a
a
a
a
a
b
k
d
c
f
f
b
b
c
c
c
b
b
f
f
c
d
d
b
a
a
a
a
a
a
"}
(17,1,1) = {"
a
a
a
a
a
a
a
b
k
d
b
f
f
b
g
f
f
f
g
b
f
f
b
d
d
b
a
a
a
a
a
a
"}
(18,1,1) = {"
a
a
a
a
a
a
a
b
k
d
b
f
f
b
g
f
f
f
g
b
f
f
b
d
d
b
a
a
a
a
a
a
"}
(19,1,1) = {"
a
a
a
a
a
a
a
b
k
d
b
b
c
b
s
f
f
f
t
b
c
b
b
d
d
b
a
a
a
a
a
a
"}
(20,1,1) = {"
a
a
a
a
a
a
a
b
k
d
c
g
g
g
g
f
f
f
g
g
g
g
c
d
d
b
a
a
a
a
a
a
"}
(21,1,1) = {"
a
a
a
a
a
a
a
b
k
d
c
g
f
f
f
f
f
f
f
f
f
g
c
d
d
b
a
a
a
a
a
a
"}
(22,1,1) = {"
a
a
a
a
a
a
a
b
k
d
b
g
f
f
f
f
f
f
f
f
f
n
b
d
d
b
a
a
a
a
a
a
"}
(23,1,1) = {"
a
a
a
a
a
a
a
b
k
d
b
s
f
f
f
f
f
f
f
f
f
u
b
d
d
b
a
a
a
a
a
a
"}
(24,1,1) = {"
a
a
a
a
a
a
a
c
d
d
b
g
f
f
v
f
f
f
v
f
f
n
b
d
d
c
a
a
a
a
a
a
"}
(25,1,1) = {"
a
a
a
a
a
a
a
b
d
d
b
g
f
f
b
c
c
c
b
f
f
n
b
d
d
b
a
a
a
a
a
a
"}
(26,1,1) = {"
a
a
a
a
a
a
a
b
j
j
b
l
l
g
b
f
f
f
b
n
n
n
b
j
j
b
a
a
a
a
a
a
"}
(27,1,1) = {"
a
a
a
a
a
a
a
b
b
b
b
b
b
b
b
w
f
x
b
b
b
b
b
b
b
b
a
a
a
a
a
a
"}
(28,1,1) = {"
a
a
a
a
a
a
a
b
d
e
d
e
d
e
b
f
f
f
b
d
e
d
e
d
e
b
a
a
a
a
a
a
"}
(29,1,1) = {"
a
a
a
a
a
a
a
b
d
d
d
d
d
d
b
c
c
c
b
d
d
d
d
d
d
b
a
a
a
a
a
a
"}
(30,1,1) = {"
a
a
a
a
a
a
a
a
a
a
a
a
a
a
a
a
a
a
a
a
a
a
a
a
a
a
a
a
a
a
a
a
"}
(31,1,1) = {"
a
a
a
a
a
a
a
a
a
a
a
a
a
a
a
a
a
a
a
a
a
a
a
a
a
a
a
a
a
a
a
a
"}
(32,1,1) = {"
a
a
a
a
a
a
a
a
a
a
a
a
a
a
a
a
a
a
a
a
a
a
a
a
a
a
a
a
a
a
a
a
"}
