//MAP CONVERTED BY dmm2tgm.py THIS HEADER COMMENT PREVENTS RECONVERSION, DO NOT REMOVE
"a" = (
/turf/dmm_suite/clear_turf,
/area/dmm_suite/clear_area)
"b" = (
/turf/simulated/wall/wood/brown,
/area/mission/prefab/misc/rng_shrine)
"c" = (
/obj/structure/interactive/lighting/candle,
/obj/structure/table/wood,
/turf/simulated/floor/wood/brown,
/area/mission/prefab/misc/rng_shrine)
"d" = (
/obj/item/dice/d00,
/obj/structure/table/wood,
/turf/simulated/floor/wood/brown,
/area/mission/prefab/misc/rng_shrine)
"e" = (
/turf/dmm_suite/no_wall,
/area/dmm_suite/clear_area)
"f" = (
/turf/simulated/floor/wood/brown,
/area/mission/prefab/misc/rng_shrine)
"g" = (
/turf/simulated/floor/grass,
/area/mission/prefab/misc/rng_shrine)
"h" = (
/obj/marker/objective_spawn,
/turf/simulated/floor/grass,
/area/mission/prefab/misc/rng_shrine)
"i" = (
/obj/item/dice/d20,
/obj/structure/table/wood,
/turf/simulated/floor/wood/brown,
/area/mission/prefab/misc/rng_shrine)
"j" = (
/obj/structure/interactive/lighting/candle,
/turf/simulated/floor/grass,
/area/mission/prefab/misc/rng_shrine)
"k" = (
/obj/item/dice/d20/cursed,
/obj/structure/table/fancy,
/turf/simulated/floor/grass,
/area/mission/prefab/misc/rng_shrine)
"l" = (
/obj/item/dice/d12,
/obj/structure/table/wood,
/turf/simulated/floor/wood/brown,
/area/mission/prefab/misc/rng_shrine)
"m" = (
/obj/item/dice/d10,
/obj/structure/table/wood,
/turf/simulated/floor/wood/brown,
/area/mission/prefab/misc/rng_shrine)
"n" = (
/obj/item/dice/d8,
/obj/structure/table/wood,
/turf/simulated/floor/wood/brown,
/area/mission/prefab/misc/rng_shrine)
"o" = (
/obj/marker/map_node/x3,
/turf/simulated/floor/wood/brown,
/area/mission/prefab/misc/rng_shrine)
"p" = (
/obj/item/dice/d6,
/obj/structure/table/wood,
/turf/simulated/floor/wood/brown,
/area/mission/prefab/misc/rng_shrine)
"q" = (
/obj/item/dice/d4,
/obj/structure/table/wood,
/turf/simulated/floor/wood/brown,
/area/mission/prefab/misc/rng_shrine)
"r" = (
/obj/item/dice/d2,
/obj/structure/table/wood,
/turf/simulated/floor/wood/brown,
/area/mission/prefab/misc/rng_shrine)
"s" = (
/obj/marker/map_node,
/turf/simulated/floor/wood/brown,
/area/mission/prefab/misc/rng_shrine)
"t" = (
/obj/structure/interactive/door/wood,
/turf/simulated/floor/wood/brown,
/area/mission/prefab/misc/rng_shrine)
"u" = (
/obj/marker/map_node/x2,
/turf/dmm_suite/no_wall,
/area/dmm_suite/clear_area)
"v" = (
/obj/marker/smart_clear_turf,
/turf/simulated/floor/wood/brown,
/area/mission/prefab/misc/rng_shrine)

(1,1,1) = {"
a
a
a
a
a
a
a
a
a
a
a
a
a
a
a
a
a
a
a
a
a
a
a
a
a
a
a
a
a
a
a
a
"}
(2,1,1) = {"
a
a
a
a
a
a
a
a
a
a
a
a
a
a
a
a
a
a
a
a
a
a
a
a
a
a
a
a
a
a
a
a
"}
(3,1,1) = {"
a
a
a
a
a
a
a
a
a
a
a
a
a
a
a
a
a
a
a
a
a
a
a
a
a
a
a
a
a
a
a
a
"}
(4,1,1) = {"
a
a
a
a
a
a
a
a
a
a
a
a
a
a
a
a
a
a
a
a
a
a
a
a
a
a
a
a
a
a
a
a
"}
(5,1,1) = {"
a
a
a
a
a
a
a
a
a
a
a
a
a
a
a
a
a
a
a
a
e
e
e
e
a
a
a
a
a
a
a
a
"}
(6,1,1) = {"
a
a
a
a
a
a
b
b
b
b
b
b
b
b
b
b
f
a
a
a
e
e
e
e
e
a
a
a
a
a
a
a
"}
(7,1,1) = {"
a
a
a
a
a
a
b
c
c
c
c
c
c
c
c
b
f
e
a
e
e
e
e
e
e
e
a
e
e
a
a
a
"}
(8,1,1) = {"
a
a
a
a
a
a
b
d
i
l
m
n
p
q
r
b
f
e
e
e
e
e
e
e
e
e
e
e
e
e
e
e
"}
(9,1,1) = {"
a
a
a
a
a
a
b
f
f
f
f
f
f
f
f
b
f
e
e
e
e
e
e
e
u
e
e
e
e
e
u
e
"}
(10,1,1) = {"
a
a
a
a
a
a
b
g
j
g
f
f
f
f
f
b
v
e
e
e
e
e
e
e
e
e
e
e
e
e
e
e
"}
(11,1,1) = {"
a
a
a
a
a
a
b
h
k
g
f
o
f
f
s
t
s
e
u
e
e
e
e
e
e
e
e
e
e
e
e
e
"}
(12,1,1) = {"
a
a
a
a
a
a
b
g
j
g
f
f
f
f
f
b
v
e
e
e
e
e
e
e
e
a
e
e
a
a
a
a
"}
(13,1,1) = {"
a
a
a
a
a
a
b
f
f
f
f
f
f
f
f
b
f
e
e
e
e
e
e
e
a
a
a
a
a
a
a
a
"}
(14,1,1) = {"
a
a
a
a
a
a
b
d
i
l
m
n
p
q
r
b
f
e
e
e
e
e
a
a
a
a
a
a
a
a
a
a
"}
(15,1,1) = {"
a
a
a
a
a
a
b
c
c
c
c
c
c
c
c
b
f
e
e
e
e
e
a
a
a
a
a
a
a
a
a
a
"}
(16,1,1) = {"
a
a
a
a
a
a
b
b
b
b
b
b
b
b
b
b
f
e
e
e
e
a
a
a
a
a
a
a
a
a
a
a
"}
(17,1,1) = {"
a
a
a
a
a
a
a
a
a
a
a
a
e
e
e
e
e
e
e
e
a
a
a
a
a
a
a
a
a
a
a
a
"}
(18,1,1) = {"
a
a
a
a
a
a
a
a
a
a
a
a
a
e
e
e
e
e
e
a
a
a
a
a
a
a
a
a
a
a
a
a
"}
(19,1,1) = {"
a
a
a
a
a
a
a
a
a
a
a
a
a
a
a
a
a
a
a
a
a
a
a
a
a
a
a
a
a
a
a
a
"}
(20,1,1) = {"
a
a
a
a
a
a
a
a
a
a
a
a
a
a
a
a
a
a
a
a
a
a
a
a
a
a
a
a
a
a
a
a
"}
(21,1,1) = {"
a
a
a
a
a
a
a
a
a
a
a
a
a
a
a
a
a
a
a
a
a
a
a
a
a
a
a
a
a
a
a
a
"}
(22,1,1) = {"
a
a
a
a
a
a
a
a
a
a
a
a
a
a
a
a
a
a
a
a
a
a
a
a
a
a
a
a
a
a
a
a
"}
(23,1,1) = {"
a
a
a
a
a
a
a
a
a
a
a
a
a
a
a
a
a
a
a
a
a
a
a
a
a
a
a
a
a
a
a
a
"}
(24,1,1) = {"
a
a
a
a
a
a
a
a
a
a
a
a
a
a
a
a
a
a
a
a
a
a
a
a
a
a
a
a
a
a
a
a
"}
(25,1,1) = {"
a
a
a
a
a
a
a
a
a
a
a
a
a
a
a
a
a
a
a
a
a
a
a
a
a
a
a
a
a
a
a
a
"}
(26,1,1) = {"
a
a
a
a
a
a
a
a
a
a
a
a
a
a
a
a
a
a
a
a
a
a
a
a
a
a
a
a
a
a
a
a
"}
(27,1,1) = {"
a
a
a
a
a
a
a
a
a
a
a
a
a
a
a
a
a
a
a
a
a
a
a
a
a
a
a
a
a
a
a
a
"}
(28,1,1) = {"
a
a
a
a
a
a
a
a
a
a
a
a
a
a
a
a
a
a
a
a
a
a
a
a
a
a
a
a
a
a
a
a
"}
(29,1,1) = {"
a
a
a
a
a
a
a
a
a
a
a
a
a
a
a
a
a
a
a
a
a
a
a
a
a
a
a
a
a
a
a
a
"}
(30,1,1) = {"
a
a
a
a
a
a
a
a
a
a
a
a
a
a
a
a
a
a
a
a
a
a
a
a
a
a
a
a
a
a
a
a
"}
(31,1,1) = {"
a
a
a
a
a
a
a
a
a
a
a
a
a
a
a
a
a
a
a
a
a
a
a
a
a
a
a
a
a
a
a
a
"}
(32,1,1) = {"
a
a
a
a
a
a
a
a
a
a
a
a
a
a
a
a
a
a
a
a
a
a
a
a
a
a
a
a
a
a
a
a
"}
