"a" = (/turf/dmm_suite/clear_turf,/area/dmm_suite/clear_area)
"b" = (/turf/simulated/wall/wood/brown,/area/mission/prefab/misc/rng_shrine)
"c" = (/obj/structure/interactive/lighting/candle,/obj/structure/table/wood,/turf/simulated/floor/wood/brown,/area/mission/prefab/misc/rng_shrine)
"d" = (/obj/item/dice/d00,/obj/structure/table/wood,/turf/simulated/floor/wood/brown,/area/mission/prefab/misc/rng_shrine)
"e" = (/turf/dmm_suite/no_wall,/area/dmm_suite/clear_area)
"f" = (/turf/simulated/floor/wood/brown,/area/mission/prefab/misc/rng_shrine)
"g" = (/turf/simulated/floor/grass,/area/mission/prefab/misc/rng_shrine)
"h" = (/obj/marker/objective_spawn,/turf/simulated/floor/grass,/area/mission/prefab/misc/rng_shrine)
"i" = (/obj/item/dice/d20,/obj/structure/table/wood,/turf/simulated/floor/wood/brown,/area/mission/prefab/misc/rng_shrine)
"j" = (/obj/structure/interactive/lighting/candle,/turf/simulated/floor/grass,/area/mission/prefab/misc/rng_shrine)
"k" = (/obj/item/dice/d20/cursed,/obj/structure/table/fancy,/turf/simulated/floor/grass,/area/mission/prefab/misc/rng_shrine)
"l" = (/obj/item/dice/d12,/obj/structure/table/wood,/turf/simulated/floor/wood/brown,/area/mission/prefab/misc/rng_shrine)
"m" = (/obj/item/dice/d10,/obj/structure/table/wood,/turf/simulated/floor/wood/brown,/area/mission/prefab/misc/rng_shrine)
"n" = (/obj/item/dice/d8,/obj/structure/table/wood,/turf/simulated/floor/wood/brown,/area/mission/prefab/misc/rng_shrine)
"o" = (/obj/marker/map_node/x3,/turf/simulated/floor/wood/brown,/area/mission/prefab/misc/rng_shrine)
"p" = (/obj/item/dice/d6,/obj/structure/table/wood,/turf/simulated/floor/wood/brown,/area/mission/prefab/misc/rng_shrine)
"q" = (/obj/item/dice/d4,/obj/structure/table/wood,/turf/simulated/floor/wood/brown,/area/mission/prefab/misc/rng_shrine)
"r" = (/obj/item/dice/d2,/obj/structure/table/wood,/turf/simulated/floor/wood/brown,/area/mission/prefab/misc/rng_shrine)
"s" = (/obj/marker/map_node,/turf/simulated/floor/wood/brown,/area/mission/prefab/misc/rng_shrine)
"t" = (/obj/structure/interactive/door/wood,/turf/simulated/floor/wood/brown,/area/mission/prefab/misc/rng_shrine)
"u" = (/obj/marker/map_node/x2,/turf/dmm_suite/no_wall,/area/dmm_suite/clear_area)
"v" = (/obj/marker/smart_clear_turf,/turf/simulated/floor/wood/brown,/area/mission/prefab/misc/rng_shrine)

(1,1,1) = {"
aaaaaaaaaaaaaaaaaaaaaaaaaaaaaaaa
aaaaaaaaaaaaaaaaaaaaaaaaaaaaaaaa
aaaaaaaaaaaaaaaaaaaaaaaaaaaaaaaa
aaaaaaaaaaaaaaaaaaaaaaaaaaaaaaaa
aaaaaaaaaaaaaaaaaaaaaaaaaaaaaaaa
aaaaaaaaaaaaaaaaaaaaaaaaaaaaaaaa
aaaaabbbbbbbbbbbaaaaaaaaaaaaaaaa
aaaaabcdfghgfdcbaaaaaaaaaaaaaaaa
aaaaabcifjkjficbaaaaaaaaaaaaaaaa
aaaaabclfgggflcbaaaaaaaaaaaaaaaa
aaaaabcmfffffmcbaaaaaaaaaaaaaaaa
aaaaabcnffoffncbaaaaaaaaaaaaaaaa
aaaaabcpfffffpcbeaaaaaaaaaaaaaaa
aaaaabcqfffffqcbeeaaaaaaaaaaaaaa
aaaaabcrffsffrcbeeaaaaaaaaaaaaaa
aaaaabbbbbtbbbbbeeaaaaaaaaaaaaaa
aaaaaffffvsvffffeeaaaaaaaaaaaaaa
aaaaaaeeeeeeeeeeeeaaaaaaaaaaaaaa
aaaaaaaeeeueeeeeeeaaaaaaaaaaaaaa
aaaaaaeeeeeeeeeeeaaaaaaaaaaaaaaa
aaaaeeeeeeeeeeeeaaaaaaaaaaaaaaaa
aaaaeeeeeeeeeeeaaaaaaaaaaaaaaaaa
aaaaeeeeeeeeeaaaaaaaaaaaaaaaaaaa
aaaaeeeeeeeeeaaaaaaaaaaaaaaaaaaa
aaaaaeeeueeeaaaaaaaaaaaaaaaaaaaa
aaaaaaeeeeeaaaaaaaaaaaaaaaaaaaaa
aaaaaaaeeeeeaaaaaaaaaaaaaaaaaaaa
aaaaaaeeeeeeaaaaaaaaaaaaaaaaaaaa
aaaaaaeeeeeaaaaaaaaaaaaaaaaaaaaa
aaaaaaaeeeeaaaaaaaaaaaaaaaaaaaaa
aaaaaaaeueeaaaaaaaaaaaaaaaaaaaaa
aaaaaaaeeeeaaaaaaaaaaaaaaaaaaaaa
"}
