"a" = (/turf/dmm_suite/clear_turf,/area/dmm_suite/clear_area)
"b" = (/turf/simulated/wall/wood,/area/dmm_suite/clear_area)
"c" = (/turf/simulated/floor/wood/brown,/area/dmm_suite/clear_area)
"d" = (/obj/structure/interactive/door/wood,/turf/simulated/floor/wood/brown,/area/dmm_suite/clear_area)
"e" = (/turf/dmm_suite/no_wall,/area/dmm_suite/clear_area)
"g" = (/obj/structure/interactive/lighting/candle,/obj/structure/table/wood,/turf/simulated/floor/wood/brown,/area/dmm_suite/clear_area)
"h" = (/turf/simulated/floor/grass,/area/dmm_suite/clear_area)
"i" = (/obj/structure/interactive/lighting/candle,/turf/simulated/floor/grass,/area/dmm_suite/clear_area)
"j" = (/obj/item/dice/d00,/obj/structure/table/wood,/turf/simulated/floor/wood/brown,/area/dmm_suite/clear_area)
"k" = (/obj/item/dice/d20,/obj/structure/table/wood,/turf/simulated/floor/wood/brown,/area/dmm_suite/clear_area)
"l" = (/obj/item/dice/d12,/obj/structure/table/wood,/turf/simulated/floor/wood/brown,/area/dmm_suite/clear_area)
"m" = (/obj/item/dice/d10,/obj/structure/table/wood,/turf/simulated/floor/wood/brown,/area/dmm_suite/clear_area)
"n" = (/obj/item/dice/d8,/obj/structure/table/wood,/turf/simulated/floor/wood/brown,/area/dmm_suite/clear_area)
"o" = (/obj/item/dice/d6,/obj/structure/table/wood,/turf/simulated/floor/wood/brown,/area/dmm_suite/clear_area)
"p" = (/obj/item/dice/d4,/obj/structure/table/wood,/turf/simulated/floor/wood/brown,/area/dmm_suite/clear_area)
"q" = (/obj/item/dice/d2,/obj/structure/table/wood,/turf/simulated/floor/wood/brown,/area/dmm_suite/clear_area)
"r" = (/obj/item/dice/d20/cursed,/obj/structure/table/fancy,/turf/simulated/floor/grass,/area/dmm_suite/clear_area)
"s" = (/obj/marker/objective_spawn,/turf/simulated/floor/grass,/area/dmm_suite/clear_area)

(1,1,1) = {"
aaaaaaaaaaaaaaaaaaaaaaaaaaaaaaaa
aaaaaaaaaaaaaaaaaaaaaaaaaaaaaaaa
aaaaaaaaaaaaaaaaaaaaaaaaaaaaaaaa
aaaaaaaaaaaaaaaaaaaaaaaaaaaaaaaa
aaaaaaaaaaaaaaaaaaaaaaaaaaaaaaaa
aaaaaaaaaaaaaaaaaaaaaaaaaaaaaaaa
aaaaabbbbbbbbbbbaaaaaaaaaaaaaaaa
aaaaabgjchshcjgbaaaaaaaaaaaaaaaa
aaaaabgkcirickgbaaaaaaaaaaaaaaaa
aaaaabglchhhclgbaaaaaaaaaaaaaaaa
aaaaabgmcccccmgbaaaaaaaaaaaaaaaa
aaaaabgncccccngbaaaaaaaaaaaaaaaa
aaaaabgocccccogbeaaaaaaaaaaaaaaa
aaaaabgpcccccpgbeeaaaaaaaaaaaaaa
aaaaabgqcccccqgbeeaaaaaaaaaaaaaa
aaaaabbbbbdbbbbbeeaaaaaaaaaaaaaa
aaaaaccccccccccceeaaaaaaaaaaaaaa
aaaaaaeeeeeeeeeeeeaaaaaaaaaaaaaa
aaaaaaaeeeeeeeeeeeaaaaaaaaaaaaaa
aaaaaaeeeeeeeeeeeaaaaaaaaaaaaaaa
aaaaeeeeeeeeeeeeaaaaaaaaaaaaaaaa
aaaaeeeeeeeeeeeaaaaaaaaaaaaaaaaa
aaaaeeeeeeeeeaaaaaaaaaaaaaaaaaaa
aaaaeeeeeeeeeaaaaaaaaaaaaaaaaaaa
aaaaaeeeeeeeaaaaaaaaaaaaaaaaaaaa
aaaaaaeeeeeaaaaaaaaaaaaaaaaaaaaa
aaaaaaaeeeeeaaaaaaaaaaaaaaaaaaaa
aaaaaaeeeeeeaaaaaaaaaaaaaaaaaaaa
aaaaaaeeeaaaaaaaaaaaaaaaaaaaaaaa
aaaaaaaaaaaaaaaaaaaaaaaaaaaaaaaa
aaaaaaaaaaaaaaaaaaaaaaaaaaaaaaaa
aaaaaaaaaaaaaaaaaaaaaaaaaaaaaaaa
"}
