//MAP CONVERTED BY dmm2tgm.py THIS HEADER COMMENT PREVENTS RECONVERSION, DO NOT REMOVE
"a" = (
/turf/simulated/floor/sidewalk,
/area/dmm_suite/clear_area)
"b" = (
/obj/decal/road_marking/solid_line,
/turf/simulated/floor/road,
/area/dmm_suite/clear_area)
"c" = (
/turf/simulated/floor/road,
/area/dmm_suite/clear_area)
"d" = (
/obj/decal/road_marking/dotted_line,
/turf/simulated/floor/road,
/area/dmm_suite/clear_area)
"e" = (
/turf/dmm_suite/clear_turf,
/area/dmm_suite/clear_area)
"f" = (
/obj/decal/road_marking/solid_line{
	icon_state = "1";
	dir = 6
	},
/turf/simulated/floor/road,
/area/dmm_suite/clear_area)
"g" = (
/obj/decal/road_marking/solid_line{
	icon_state = "1";
	dir = 4
	},
/turf/simulated/floor/road,
/area/dmm_suite/clear_area)
"h" = (
/obj/decal/road_marking/solid_line{
	icon_state = "1";
	dir = 9
	},
/turf/simulated/floor/road,
/area/dmm_suite/clear_area)
"i" = (
/turf/simulated/wall/brick/red,
/area/dmm_suite/clear_area)
"j" = (
/turf/simulated/floor/colored/dirt/path,
/area/dmm_suite/clear_area)
"k" = (
/obj/marker/prefab/city/store{
	icon_state = "";
	dir = 1
	},
/turf/dmm_suite/clear_turf,
/area/dmm_suite/clear_area)
"l" = (
/obj/decal/road_marking/solid_line{
	icon_state = "1";
	dir = 8
	},
/turf/simulated/floor/road,
/area/dmm_suite/clear_area)
"m" = (
/obj/marker/prefab/alley{
	icon_state = "alley";
	dir = 4
	},
/turf/dmm_suite/clear_turf,
/area/dmm_suite/clear_area)
"n" = (
/obj/marker/prefab/alley{
	icon_state = "alley";
	dir = 10
	},
/turf/dmm_suite/clear_turf,
/area/dmm_suite/clear_area)
"o" = (
/turf/dmm_suite/no_wall,
/area/dmm_suite/clear_area)
"p" = (
/obj/structure/interactive/lighting/roadlamp{
	icon_state = "lamp";
	dir = 4
	},
/turf/simulated/floor/sidewalk,
/area/dmm_suite/clear_area)
"q" = (
/obj/marker/prefab/alley,
/turf/dmm_suite/clear_turf,
/area/dmm_suite/clear_area)
"r" = (
/obj/decal/road_marking/solid_line/yellow,
/turf/simulated/floor/road,
/area/dmm_suite/clear_area)
"s" = (
/obj/structure/interactive/lighting/roadlamp{
	icon_state = "lamp";
	dir = 8
	},
/turf/simulated/floor/sidewalk,
/area/dmm_suite/clear_area)
"t" = (
/obj/marker/prefab/house,
/turf/dmm_suite/clear_turf,
/area/dmm_suite/clear_area)
"u" = (
/obj/structure/interactive/stopsign{
	icon_state = "sign";
	dir = 1
	},
/turf/simulated/floor/sidewalk,
/area/dmm_suite/clear_area)
"v" = (
/obj/marker/prefab/city/store,
/turf/dmm_suite/clear_turf,
/area/dmm_suite/clear_area)
"w" = (
/obj/decal/road_marking/solid_stop{
	icon_state = "1";
	dir = 1
	},
/turf/simulated/floor/road,
/area/dmm_suite/clear_area)
"x" = (
/obj/decal/road_marking/solid_cross,
/turf/simulated/floor/road,
/area/dmm_suite/clear_area)
"y" = (
/obj/structure/interactive/lighting/roadlamp,
/turf/simulated/floor/sidewalk,
/area/dmm_suite/clear_area)
"z" = (
/obj/decal/road_marking/solid_line{
	icon_state = "1";
	dir = 10
	},
/turf/simulated/floor/road,
/area/dmm_suite/clear_area)
"A" = (
/obj/structure/interactive/lighting/roadlamp{
	icon_state = "lamp";
	dir = 1
	},
/turf/simulated/floor/sidewalk,
/area/dmm_suite/clear_area)
"B" = (
/obj/structure/interactive/stopsign{
	icon_state = "sign";
	dir = 8
	},
/turf/simulated/floor/sidewalk,
/area/dmm_suite/clear_area)
"C" = (
/obj/marker/prefab/yard,
/turf/dmm_suite/clear_turf,
/area/dmm_suite/clear_area)
"D" = (
/obj/marker/prefab/alley{
	icon_state = "alley";
	dir = 5
	},
/turf/dmm_suite/clear_turf,
/area/dmm_suite/clear_area)
"E" = (
/obj/structure/interactive/stopsign{
	icon_state = "sign";
	dir = 4
	},
/turf/simulated/floor/sidewalk,
/area/dmm_suite/clear_area)
"F" = (
/obj/decal/road_marking/solid_cross{
	icon_state = "1";
	dir = 4
	},
/turf/simulated/floor/road,
/area/dmm_suite/clear_area)
"G" = (
/obj/decal/road_marking/solid_stop{
	icon_state = "1";
	dir = 4
	},
/turf/simulated/floor/road,
/area/dmm_suite/clear_area)
"I" = (
/obj/marker/prefab/small,
/turf/dmm_suite/clear_turf,
/area/dmm_suite/clear_area)

(1,1,1) = {"
a
a
a
a
a
a
a
a
a
a
p
a
a
a
a
a
a
a
a
a
a
a
a
a
a
a
u
p
a
g
c
c
c
c
g
a
e
e
e
e
e
e
e
e
e
e
e
e
e
e
e
e
e
e
e
e
e
e
e
e
e
e
e
e
"}
(2,1,1) = {"
a
f
b
b
b
b
b
b
b
b
b
b
b
b
b
b
b
b
b
b
b
b
b
b
b
b
b
w
x
c
c
c
c
c
g
a
e
e
e
e
e
e
e
e
e
e
e
e
e
e
e
e
e
e
e
e
e
e
e
e
e
e
e
e
"}
(3,1,1) = {"
a
g
c
c
c
c
c
c
c
c
c
c
c
c
c
c
c
c
c
c
c
c
c
c
c
c
c
w
x
c
c
c
c
c
g
a
e
e
e
e
e
e
e
e
e
e
o
o
o
o
o
o
o
o
o
o
o
o
o
o
o
o
o
e
"}
(4,1,1) = {"
a
g
c
c
c
c
c
c
c
c
c
c
c
c
c
c
c
c
c
c
c
c
c
c
c
c
c
w
x
c
c
c
c
c
g
a
e
i
e
e
e
e
e
e
e
D
o
e
e
e
e
e
e
e
e
e
e
e
e
e
e
I
o
e
"}
(5,1,1) = {"
a
g
c
c
c
d
d
d
d
d
d
d
d
d
d
d
d
d
r
r
r
r
r
r
r
r
r
w
x
c
c
c
c
c
g
a
e
j
e
e
e
e
e
e
e
e
o
e
e
e
e
e
e
e
e
e
e
e
e
e
e
e
o
e
"}
(6,1,1) = {"
a
g
c
c
c
c
c
c
c
c
c
c
c
c
c
c
c
c
c
c
c
c
c
c
c
c
c
c
x
c
c
c
c
c
g
a
e
j
e
e
e
e
e
e
e
e
o
e
e
e
e
e
e
e
e
e
e
e
e
e
e
e
o
e
"}
(7,1,1) = {"
a
g
c
c
c
c
f
b
b
b
b
b
b
b
b
b
b
b
b
b
b
b
b
b
b
b
b
b
x
c
c
c
c
c
g
a
e
j
e
e
e
e
e
e
e
e
o
e
e
e
e
e
e
e
e
e
e
e
e
e
e
e
o
e
"}
(8,1,1) = {"
a
g
c
c
c
c
g
a
a
a
a
a
a
a
a
a
a
a
a
s
a
a
a
a
a
a
a
a
a
g
c
c
c
c
g
a
e
j
e
e
e
e
e
e
e
e
o
e
e
e
e
e
e
e
e
e
e
e
e
e
e
e
o
e
"}
(9,1,1) = {"
a
g
c
c
c
c
g
a
e
e
e
e
e
e
e
e
e
e
e
e
e
e
e
e
e
e
e
e
a
g
c
c
c
c
g
a
e
j
e
e
e
e
e
e
e
e
o
e
e
e
e
e
e
e
e
e
e
e
e
e
e
e
o
e
"}
(10,1,1) = {"
a
g
c
c
c
c
g
a
e
o
o
o
o
o
o
o
o
o
o
o
o
o
o
o
o
o
e
e
a
g
c
c
c
c
g
a
e
j
e
e
e
e
e
e
e
e
o
e
e
e
e
e
e
e
e
e
e
e
e
e
e
e
o
e
"}
(11,1,1) = {"
a
g
c
c
c
c
g
a
e
e
e
e
e
e
e
e
e
e
e
e
e
e
e
e
k
o
e
e
a
g
c
c
c
c
g
a
e
i
e
e
e
e
e
e
e
e
o
e
e
e
e
e
e
e
e
e
e
e
e
e
e
e
o
e
"}
(12,1,1) = {"
a
g
c
c
c
c
g
a
e
e
e
e
e
e
e
e
e
e
e
e
e
e
e
e
e
o
e
e
a
g
c
c
c
c
g
A
e
e
e
e
e
e
e
e
e
m
o
e
e
e
e
e
e
e
e
e
e
e
e
e
e
e
o
e
"}
(13,1,1) = {"
a
g
c
c
c
c
g
a
e
e
e
e
e
e
e
e
e
e
e
e
e
e
e
e
e
o
e
e
a
g
c
c
c
c
g
a
e
e
e
e
e
e
e
e
e
e
o
e
e
e
e
e
e
e
e
e
e
e
e
e
e
e
o
e
"}
(14,1,1) = {"
a
g
c
c
c
c
g
a
e
e
e
e
e
e
e
e
e
e
e
e
e
e
e
e
e
o
e
e
a
g
c
c
c
c
g
a
e
e
e
e
e
e
e
e
e
e
o
e
e
e
e
e
e
e
e
e
e
e
e
e
e
e
o
e
"}
(15,1,1) = {"
a
g
c
c
c
c
g
a
e
e
e
e
e
e
e
e
e
e
e
e
e
e
e
e
e
o
e
e
a
g
c
c
c
c
g
a
e
e
e
e
e
e
e
e
e
e
o
e
e
e
e
e
e
e
e
e
e
e
e
e
e
e
o
e
"}
(16,1,1) = {"
a
g
c
c
c
c
g
a
e
e
e
e
e
e
e
e
e
e
e
e
e
e
e
e
e
o
e
e
a
g
c
c
c
c
g
a
e
e
e
e
e
e
e
e
e
e
o
e
e
e
e
e
e
e
e
e
e
e
e
e
e
e
o
e
"}
(17,1,1) = {"
a
g
c
c
c
c
g
a
e
e
e
e
e
e
e
e
e
e
e
e
e
e
e
e
e
o
e
e
a
g
c
c
c
c
g
a
e
e
e
e
e
e
e
e
e
e
o
e
e
e
e
e
e
e
e
e
e
e
e
e
e
e
o
e
"}
(18,1,1) = {"
a
g
c
c
c
c
g
a
e
e
e
e
e
e
e
e
e
e
e
e
e
e
e
e
e
o
e
e
a
g
c
c
c
c
g
a
e
e
e
e
e
e
e
e
e
e
o
e
e
e
e
e
e
e
e
e
e
e
e
e
e
e
o
e
"}
(19,1,1) = {"
a
g
c
c
c
c
g
a
e
e
e
e
e
e
e
e
e
e
e
e
e
e
e
e
e
o
e
e
a
g
c
c
c
c
g
a
e
e
e
e
e
e
e
e
e
e
o
o
o
o
o
o
o
o
o
o
o
o
o
o
o
o
o
e
"}
(20,1,1) = {"
a
g
c
c
c
c
g
a
e
e
e
e
e
e
e
e
e
e
e
e
e
e
e
e
e
o
e
e
y
g
c
c
c
c
g
a
e
e
e
e
e
e
e
e
e
n
e
e
e
e
e
e
e
q
e
e
e
e
e
e
e
D
e
e
"}
(21,1,1) = {"
a
g
c
c
c
c
g
a
e
e
e
e
e
e
e
e
e
e
e
e
e
e
e
e
e
o
e
e
a
g
c
c
c
c
g
a
e
e
e
e
e
e
e
e
e
e
e
e
e
e
e
e
e
e
e
e
e
e
e
e
e
e
e
e
"}
(22,1,1) = {"
a
g
c
c
c
c
g
a
e
e
e
e
e
e
e
e
e
e
e
e
e
e
e
e
e
o
e
e
a
g
c
c
c
c
g
a
e
e
e
e
e
e
e
e
e
e
e
e
e
e
e
e
e
e
e
e
e
e
e
e
e
e
e
e
"}
(23,1,1) = {"
a
g
c
c
c
c
g
a
e
e
e
e
e
e
e
e
e
e
e
e
e
e
e
e
e
o
e
e
a
g
c
c
c
c
g
a
e
e
e
e
e
e
e
e
e
e
e
e
e
e
e
e
e
e
e
e
e
e
e
e
e
e
e
e
"}
(24,1,1) = {"
a
g
c
c
c
c
g
a
e
e
e
e
e
e
e
e
e
e
e
e
e
e
e
e
e
o
e
e
a
g
c
c
c
c
g
a
e
e
e
e
e
e
e
e
e
e
e
e
e
e
e
e
e
e
e
e
e
e
e
e
e
e
e
e
"}
(25,1,1) = {"
a
g
c
c
c
c
g
a
e
e
e
e
e
e
e
e
e
e
e
e
e
e
e
e
e
o
e
e
a
g
c
c
c
c
g
a
e
e
e
e
e
e
e
e
e
e
e
e
e
e
e
e
e
e
e
e
e
e
e
e
e
e
e
e
"}
(26,1,1) = {"
a
g
c
c
c
c
g
a
e
e
e
e
e
e
e
e
e
e
e
e
e
e
e
e
e
o
e
e
a
g
c
c
c
c
g
a
e
e
e
e
e
e
e
e
e
e
e
e
e
e
e
e
e
e
e
e
e
e
e
e
e
e
e
e
"}
(27,1,1) = {"
a
g
c
c
c
c
g
a
e
o
o
o
o
o
o
o
o
o
o
o
o
o
o
o
o
o
e
e
a
g
c
c
c
c
g
B
e
e
e
e
e
e
e
e
e
e
e
e
e
e
e
e
e
e
e
e
e
e
e
e
e
e
e
e
"}
(28,1,1) = {"
a
g
c
c
c
c
g
a
e
e
e
e
e
e
e
e
e
e
e
e
e
e
e
e
e
e
e
e
a
g
c
c
c
c
g
A
e
e
e
e
e
e
e
e
e
e
e
e
e
e
e
e
e
e
i
j
j
j
j
j
j
i
e
e
"}
(29,1,1) = {"
a
g
c
c
c
c
g
a
e
e
e
e
e
e
e
q
i
i
i
i
e
e
e
e
e
e
e
q
a
g
c
c
c
c
g
a
a
a
a
a
a
a
a
a
a
p
a
a
a
a
a
a
a
a
a
a
a
a
a
a
a
a
a
a
"}
(30,1,1) = {"
b
h
c
c
c
c
l
a
e
e
e
e
e
e
e
e
j
j
j
j
e
e
e
e
e
e
e
e
a
g
c
c
c
c
z
b
b
b
b
b
b
b
b
b
b
b
b
b
b
b
b
b
b
b
b
b
b
b
b
b
b
b
b
b
"}
(31,1,1) = {"
c
c
c
c
c
c
l
a
e
e
e
e
e
e
e
e
j
j
j
j
e
e
e
e
e
e
e
e
a
g
c
c
c
c
c
c
c
c
c
c
c
c
c
c
c
c
c
c
c
c
c
c
c
c
c
c
c
c
c
c
c
c
c
c
"}
(32,1,1) = {"
c
c
c
c
c
c
l
a
e
e
e
e
e
e
e
e
j
j
j
j
e
e
e
e
e
e
e
e
a
g
c
c
c
c
c
c
c
c
c
c
c
c
c
c
c
c
c
c
c
c
c
c
c
c
c
c
c
c
c
c
c
c
c
c
"}
(33,1,1) = {"
c
c
c
c
c
c
l
a
e
e
e
e
e
e
e
e
j
j
j
j
e
e
e
e
e
e
e
e
a
g
c
c
c
c
c
c
c
c
c
c
c
c
c
c
c
c
c
c
c
c
c
c
c
c
c
c
c
c
c
c
c
c
c
c
"}
(34,1,1) = {"
c
c
c
c
c
c
l
a
e
e
e
e
e
e
e
e
j
j
j
j
e
e
e
e
e
e
e
e
a
g
c
c
c
c
c
c
c
c
c
c
c
c
c
c
c
c
c
c
c
c
c
c
c
c
c
c
c
c
c
c
c
c
c
c
"}
(35,1,1) = {"
b
b
b
b
b
b
h
a
e
e
e
e
e
e
e
e
j
j
j
j
e
e
e
e
e
e
e
e
a
z
b
b
b
b
b
b
b
b
b
b
b
b
b
b
b
b
b
b
b
b
b
b
b
b
b
b
b
c
c
c
c
c
c
b
"}
(36,1,1) = {"
a
a
a
a
a
a
a
a
e
e
e
e
e
e
e
e
i
i
i
i
e
e
e
e
e
e
e
e
a
a
a
a
a
a
a
a
a
s
a
a
a
a
a
a
a
a
a
a
a
a
a
a
a
s
a
a
a
F
F
F
F
F
F
a
"}
(37,1,1) = {"
e
e
e
e
e
e
e
e
m
e
e
e
e
e
e
e
e
e
e
e
e
e
e
e
e
e
e
e
e
e
e
e
e
e
e
e
e
e
e
e
e
e
e
e
e
e
e
e
e
e
e
e
e
e
e
e
y
G
G
G
c
c
g
a
"}
(38,1,1) = {"
e
e
e
e
e
e
e
e
e
e
o
o
o
o
o
o
o
o
o
o
o
o
o
o
o
o
o
o
j
j
i
i
i
i
i
i
i
i
i
o
o
o
o
o
o
o
o
o
o
o
o
o
o
o
o
e
E
g
c
c
c
c
g
a
"}
(39,1,1) = {"
e
e
e
e
e
e
e
e
e
e
o
e
e
e
e
e
e
e
e
e
e
e
e
e
e
e
t
o
j
j
i
e
e
e
e
e
e
e
C
e
e
e
e
e
e
e
e
e
e
e
e
e
e
e
v
e
a
g
c
c
c
c
g
a
"}
(40,1,1) = {"
e
e
e
e
e
e
e
e
e
e
o
e
e
e
e
e
e
e
e
e
e
e
e
e
e
e
e
j
j
j
i
e
e
e
e
e
e
e
e
e
e
e
e
e
e
e
e
e
e
e
e
e
e
e
e
e
a
g
c
c
c
c
g
a
"}
(41,1,1) = {"
e
e
e
e
e
e
e
e
e
e
o
e
e
e
e
e
e
e
e
e
e
e
e
e
e
e
e
j
j
e
i
e
e
e
e
e
e
e
e
e
e
e
e
e
e
e
e
e
e
e
e
e
e
e
e
e
a
g
c
c
c
c
g
a
"}
(42,1,1) = {"
e
e
e
e
e
e
e
e
e
e
o
e
e
e
e
e
e
e
e
e
e
e
e
e
e
e
e
j
j
e
i
e
e
e
e
e
e
e
e
e
e
e
e
e
e
e
e
e
e
e
e
e
e
e
e
e
a
g
c
c
c
c
g
a
"}
(43,1,1) = {"
e
e
e
e
e
e
e
e
e
e
o
e
e
e
e
e
e
e
e
e
e
e
e
e
e
e
e
j
j
e
i
e
e
e
e
e
e
e
e
e
e
e
e
e
e
e
e
e
e
e
e
e
e
e
e
e
a
g
c
c
c
c
g
a
"}
(44,1,1) = {"
e
e
e
e
e
e
e
e
e
e
o
e
e
e
e
e
e
e
e
e
e
e
e
e
e
e
e
j
j
e
i
e
e
e
e
e
e
e
e
e
e
e
e
e
e
e
e
e
e
e
e
e
e
e
e
e
a
g
c
c
c
c
g
a
"}
(45,1,1) = {"
e
e
e
e
e
e
e
e
m
e
o
e
e
e
e
e
e
e
e
e
e
e
e
e
e
e
e
j
j
e
i
e
e
e
e
e
e
e
e
e
e
e
e
e
e
e
e
e
e
e
e
e
e
e
e
e
a
g
c
c
c
c
g
A
"}
(46,1,1) = {"
e
e
e
e
e
e
e
e
e
e
o
e
e
e
e
e
e
e
e
e
e
e
e
e
e
e
e
j
j
j
i
e
e
e
e
e
e
e
e
e
e
e
e
e
e
e
e
e
e
e
e
e
e
e
e
e
a
g
c
c
c
c
g
a
"}
(47,1,1) = {"
e
e
e
e
e
e
e
e
e
e
o
e
e
e
e
e
e
e
e
e
e
e
e
e
e
e
e
o
j
j
i
e
e
e
e
e
e
e
C
e
e
e
e
e
e
e
e
e
e
e
e
e
e
e
e
e
a
g
c
c
c
c
g
a
"}
(48,1,1) = {"
e
e
e
e
e
e
e
e
e
e
o
e
e
e
e
e
e
e
e
e
e
e
e
e
e
e
e
o
j
j
i
e
e
e
e
e
e
e
e
e
e
e
e
e
e
e
e
e
e
e
e
e
e
e
e
e
a
g
c
c
c
c
g
a
"}
(49,1,1) = {"
e
e
e
e
e
e
e
e
e
e
o
e
e
e
e
e
e
e
e
e
e
e
e
e
e
e
e
o
j
j
i
e
e
e
e
e
e
e
e
e
e
e
e
e
e
e
e
e
e
e
e
e
e
e
e
e
a
g
c
c
c
c
g
a
"}
(50,1,1) = {"
e
e
e
e
e
e
e
e
e
e
o
e
e
e
e
e
e
e
e
e
e
e
e
e
e
e
e
o
j
j
i
e
e
e
e
e
e
e
e
e
e
e
e
e
e
e
e
e
e
e
e
e
e
e
e
e
a
g
c
c
c
c
g
a
"}
(51,1,1) = {"
e
e
e
e
e
e
e
e
e
e
o
e
e
e
e
e
e
e
e
e
e
e
e
e
e
e
e
o
e
j
i
e
e
e
e
e
e
e
e
e
e
e
e
e
e
e
e
e
e
e
e
e
e
e
e
e
a
g
c
c
c
c
g
a
"}
(52,1,1) = {"
e
e
e
e
e
e
e
e
e
e
o
e
e
e
e
e
e
e
e
e
e
e
e
e
e
e
e
o
e
j
i
e
e
e
e
e
e
e
e
e
e
e
e
e
e
e
e
e
e
e
e
e
e
e
e
e
a
g
c
c
c
c
g
a
"}
(53,1,1) = {"
e
i
j
j
j
j
j
j
i
e
o
e
e
e
e
e
e
e
e
e
e
e
e
e
e
e
e
o
e
j
i
e
e
e
e
e
e
e
e
e
e
e
e
e
e
e
e
e
e
e
e
e
e
e
e
e
a
g
c
c
c
c
g
a
"}
(54,1,1) = {"
e
i
j
j
j
j
j
j
i
e
o
e
e
e
e
e
e
e
e
e
e
e
e
e
e
e
e
o
e
j
i
e
e
e
e
e
e
e
e
e
e
e
e
e
e
e
e
e
e
e
e
e
e
e
e
e
y
g
c
c
c
c
g
a
"}
(55,1,1) = {"
e
i
j
j
j
j
j
j
i
e
o
o
o
o
o
o
o
o
o
o
o
o
o
o
o
o
o
o
e
j
i
i
i
i
i
i
i
i
i
o
o
o
o
o
o
o
o
o
o
o
o
o
o
o
o
e
a
g
c
c
c
c
g
a
"}
(56,1,1) = {"
e
i
j
j
j
j
j
j
i
e
e
e
e
e
e
e
e
e
e
e
e
e
e
e
e
e
e
e
e
e
e
e
e
e
e
e
e
e
e
e
e
e
e
e
e
e
e
e
e
e
e
e
e
e
e
e
a
g
c
c
c
c
g
a
"}
(57,1,1) = {"
e
e
e
e
e
e
e
e
n
e
e
e
e
e
e
e
q
e
e
e
e
e
e
e
q
i
i
i
a
a
a
a
a
a
a
a
a
a
a
a
a
a
a
a
a
a
a
a
a
a
a
a
a
a
a
a
a
g
c
c
c
c
g
a
"}
(58,1,1) = {"
e
e
e
e
e
e
e
e
e
e
e
e
e
e
e
e
e
e
e
e
e
e
e
e
e
j
j
j
a
f
b
b
b
b
b
b
b
b
b
b
b
b
b
b
b
b
b
b
b
b
b
b
b
b
b
b
b
h
c
c
c
c
g
a
"}
(59,1,1) = {"
e
e
e
e
e
e
e
e
e
e
e
e
e
e
e
e
e
e
e
e
e
e
e
e
e
j
j
j
a
l
c
c
c
c
c
c
c
c
c
c
c
c
c
c
c
c
c
c
c
c
c
c
c
c
c
c
c
c
c
c
c
c
g
a
"}
(60,1,1) = {"
e
e
e
e
e
e
e
e
e
e
e
e
e
e
e
e
e
e
e
e
e
e
e
e
e
j
j
j
a
l
c
c
c
c
c
c
c
c
c
c
c
c
c
c
c
c
c
c
c
c
c
c
c
c
c
c
c
c
c
c
c
c
g
a
"}
(61,1,1) = {"
e
e
e
e
e
e
e
e
e
e
e
e
e
e
e
e
e
e
e
e
e
e
e
e
e
j
j
j
a
l
c
c
c
c
c
c
c
c
c
c
c
c
c
c
c
c
c
c
c
c
c
c
c
c
c
c
c
c
c
c
c
c
g
a
"}
(62,1,1) = {"
e
e
e
e
e
e
e
e
e
e
e
e
e
e
e
e
e
e
e
e
e
e
e
e
e
j
j
j
a
l
c
c
c
c
c
c
c
c
c
c
c
c
c
c
c
c
c
c
c
c
c
c
c
c
c
c
c
c
c
c
c
c
g
a
"}
(63,1,1) = {"
e
e
e
e
e
e
e
e
e
e
e
e
e
e
e
e
e
e
e
e
e
e
e
e
e
j
j
j
a
l
c
c
c
c
f
b
b
b
b
b
b
b
b
b
b
b
b
b
b
b
b
b
b
b
b
b
b
b
b
b
b
b
h
a
"}
(64,1,1) = {"
e
e
e
e
e
e
e
e
e
e
e
e
e
e
e
e
e
e
e
e
e
e
e
e
e
i
i
i
a
g
c
c
c
c
g
a
a
a
a
a
a
a
a
a
a
a
a
a
a
a
a
a
a
a
a
a
a
a
a
a
a
a
a
a
"}
