"a" = (/turf/simulated/floor/sidewalk,/area/dmm_suite/clear_area)
"b" = (/obj/decal/road_marking/solid_line,/turf/simulated/floor/road,/area/dmm_suite/clear_area)
"c" = (/turf/simulated/floor/road,/area/dmm_suite/clear_area)
"d" = (/obj/decal/road_marking/dotted_line,/turf/simulated/floor/road,/area/dmm_suite/clear_area)
"e" = (/turf/dmm_suite/clear_turf,/area/dmm_suite/clear_area)
"f" = (/obj/decal/road_marking/solid_line{icon_state = "1"; dir = 6},/turf/simulated/floor/road,/area/dmm_suite/clear_area)
"g" = (/obj/decal/road_marking/solid_line{icon_state = "1"; dir = 4},/turf/simulated/floor/road,/area/dmm_suite/clear_area)
"h" = (/obj/decal/road_marking/solid_line{icon_state = "1"; dir = 9},/turf/simulated/floor/road,/area/dmm_suite/clear_area)
"i" = (/turf/simulated/wall/brick/red,/area/dmm_suite/clear_area)
"j" = (/turf/simulated/floor/colored/dirt/path,/area/dmm_suite/clear_area)
"k" = (/obj/marker/prefab/city/store{icon_state = ""; dir = 1},/turf/dmm_suite/clear_turf,/area/dmm_suite/clear_area)
"l" = (/obj/decal/road_marking/solid_line{icon_state = "1"; dir = 8},/turf/simulated/floor/road,/area/dmm_suite/clear_area)
"m" = (/obj/marker/prefab/alley{icon_state = "alley"; dir = 4},/turf/dmm_suite/clear_turf,/area/dmm_suite/clear_area)
"n" = (/obj/marker/prefab/alley{icon_state = "alley"; dir = 10},/turf/dmm_suite/clear_turf,/area/dmm_suite/clear_area)
"o" = (/turf/dmm_suite/no_wall,/area/dmm_suite/clear_area)
"p" = (/obj/structure/interactive/lighting/roadlamp{icon_state = "lamp"; dir = 4},/turf/simulated/floor/sidewalk,/area/dmm_suite/clear_area)
"q" = (/obj/marker/prefab/alley,/turf/dmm_suite/clear_turf,/area/dmm_suite/clear_area)
"r" = (/obj/decal/road_marking/solid_line/yellow,/turf/simulated/floor/road,/area/dmm_suite/clear_area)
"s" = (/obj/structure/interactive/lighting/roadlamp{icon_state = "lamp"; dir = 8},/turf/simulated/floor/sidewalk,/area/dmm_suite/clear_area)
"t" = (/obj/marker/prefab/house,/turf/dmm_suite/clear_turf,/area/dmm_suite/clear_area)
"u" = (/obj/structure/interactive/stopsign{icon_state = "sign"; dir = 1},/turf/simulated/floor/sidewalk,/area/dmm_suite/clear_area)
"v" = (/obj/marker/prefab/city/store,/turf/dmm_suite/clear_turf,/area/dmm_suite/clear_area)
"w" = (/obj/decal/road_marking/solid_stop{icon_state = "1"; dir = 1},/turf/simulated/floor/road,/area/dmm_suite/clear_area)
"x" = (/obj/decal/road_marking/solid_cross,/turf/simulated/floor/road,/area/dmm_suite/clear_area)
"y" = (/obj/structure/interactive/lighting/roadlamp,/turf/simulated/floor/sidewalk,/area/dmm_suite/clear_area)
"z" = (/obj/decal/road_marking/solid_line{icon_state = "1"; dir = 10},/turf/simulated/floor/road,/area/dmm_suite/clear_area)
"A" = (/obj/structure/interactive/lighting/roadlamp{icon_state = "lamp"; dir = 1},/turf/simulated/floor/sidewalk,/area/dmm_suite/clear_area)
"B" = (/obj/structure/interactive/stopsign{icon_state = "sign"; dir = 8},/turf/simulated/floor/sidewalk,/area/dmm_suite/clear_area)
"C" = (/obj/marker/prefab/yard,/turf/dmm_suite/clear_turf,/area/dmm_suite/clear_area)
"D" = (/obj/marker/prefab/alley{icon_state = "alley"; dir = 5},/turf/dmm_suite/clear_turf,/area/dmm_suite/clear_area)
"E" = (/obj/structure/interactive/stopsign{icon_state = "sign"; dir = 4},/turf/simulated/floor/sidewalk,/area/dmm_suite/clear_area)
"F" = (/obj/decal/road_marking/solid_cross{icon_state = "1"; dir = 4},/turf/simulated/floor/road,/area/dmm_suite/clear_area)
"G" = (/obj/decal/road_marking/solid_stop{icon_state = "1"; dir = 4},/turf/simulated/floor/road,/area/dmm_suite/clear_area)
"H" = (/obj/marker/map_node/x4,/turf/simulated/floor/road,/area/dmm_suite/clear_area)
"I" = (/obj/marker/prefab/small,/turf/dmm_suite/clear_turf,/area/dmm_suite/clear_area)

(1,1,1) = {"
aaaaaaaaaaaaaaaaaaaaaaaaaaaaabccccbaeeeeeeeeeeeeeeeeeeeeeeeeeeee
afggggggggggggggggggggggggggghccccbaeeeeeeeeeeeeeeeeiiiieeeeeeee
abccccccccccccccccccccccccccccccccbaeeeeeeeeeeeeeeeejjjjeeeeeeee
abccccccccccccccccccccccccccccccHcbaeeeeeeeeeeeeeeeejjjjeeeeeeee
abcHccccccHccccccHccccccHccccccHccbaeeeeeeeeeeeeeeeejjjjeeeeeeee
abccdcccccccccccccccccccccccccccccbaeeeeeeeeeeeeeeeejjjjeeeeeeee
abccdcfgggggggggggggggggggggglllllhaeeeeeeeeeeeeeeeejjjjeeeeeeee
abccdcbaaaaaaaaaaaaaaaaaaaaaaaaaaaaaeeeeeeeeeeeeeeeejjjjeeeeeeee
abccdcbaeeeeeeeeeeeeeeeeeeeeeeeeeeeemeeeeeeemeeeeeeeiiiineeeeeee
abccdcbaeoeeeeeeeeeeeeeeeeoeeeeeeeeeeeeeeeeeeeeeeeeeeeeeeeeeeeee
pbccdcbaeoeeeeeeeeeeeeeeeeoeeeeeeeeeeooooooooooooooooooeeeeeeeee
abcHdcbaeoeeeeeeeeeeeeeeeeoeeeeeeeeeeoeeeeeeeeeeeeeeeeoeeeeeeeee
abccdcbaeoeeeeeeeeeeeeeeeeoeeeeeeeeeeoeeeeeeeeeeeeeeeeoeeeeeeeee
abccdcbaeoeeeeeeeeeeeeeeeeoeeeeeeeeeeoeeeeeeeeeeeeeeeeoeeeeeeeee
abccdcbaeoeeeeeeeeeeeeeeeeoeeeeeeeeeeoeeeeeeeeeeeeeeeeoeeeeeeeee
abccdcbaeoeeeeeeeeeeeeeeeeoeqeeeeeeeeoeeeeeeeeeeeeeeeeoeeeeeeeee
abccdcbaeoeeeeeeeeeeeeeeeeoeijjjjjjieoeeeeeeeeeeeeeeeeoeqeeeeeee
abccdcbaeoeeeeeeeeeeeeeeeeoeijjjjjjieoeeeeeeeeeeeeeeeeoeeeeeeeee
abcHrcbaeoeeeeeeeeeeeeeeeeoeijjjjjjieoeeeeeeeeeeeeeeeeoeeeeeeeee
abccrcbseoeeeeeeeeeeeeeeeeoeijjjjjjieoeeeeeeeeeeeeeeeeoeeeeeeeee
abccrcbaeoeeeeeeeeeeeeeeeeoeeeeeeeeeeoeeeeeeeeeeeeeeeeoeeeeeeeee
abccrcbaeoeeeeeeeeeeeeeeeeoeeeeeeeeeeoeeeeeeeeeeeeeeeeoeeeeeeeee
abccrcbaeoeeeeeeeeeeeeeeeeoeeeeeeeeeeoeeeeeeeeeeeeeeeeoeeeeeeeee
abccrcbaeoeeeeeeeeeeeeeeeeoeeeeeeeeeeoeeeeeeeeeeeeeeeeoeeeeeeeee
abccrcbaeokeeeeeeeeeeeeeeeoeeeeeeeeeeoeeeeeeeeeeeeeeeeoeqeeeeeee
abcHrcbaeooooooooooooooooooeeeeeeeeeeoeeeeeeeeeeeeeeeeoeijjjjjji
ubccrcbaeeeeeeeeeeeeeeeeeeeeeeeeeeeeeoteeeeeeeeeeeeeeeoeijjjjjji
pwwwwcbaeeeeeeeeeeeeeeeeeeeeqeeeeeeeeoojjjjjjjoooooooooeijjjjjji
axxxxxxaaaaaaaaaaaayaaaaaaaaaaaaaaaaejjjjjjjjjjjjjeeeeeeaaaaaaaa
gccccccgggggggggggggggggggggggggggzaejjjeeeeejjjjjjjjjjeaflllllg
ccccccccccccccccccccccccccccccccccbaeiiiiiiiiiiiiiiiiiieabcccccc
ccccccccccccccccccccccccccccccccccbaeieeeeeeeeeeeeeeeeieabccHccc
cccHccccccHccccccHccccccHccccccHccbaeieeeeeeeeeeeeeeeeieabcHcccc
ccccccccccccccccccccccccccccccccccbaeieeeeeeeeeeeeeeeeieabcccccc
gggggggggggggggggggggggggggggzccccbaeieeeeeeeeeeeeeeeeieabccccfg
aaaaaaaaaaaAaaaaaaaaaaaaaaBAabccccbaeieeeeeeeeeeeeeeeeieabccccba
eeeeeeeeeeeeeeeeeeeeeeeeeeeeabccccbaeieeeeeeeeeeeeeeeeieabccccba
eeeijjjjjjieeeeeeeeeeeeeeeeeabccccbseieeeeeeeeeeeeeeeeieabccccba
eeeeeeeeeeeeeeeeeeeeeeeeeeeeabccccbaeiCeeeeeeeCeeeeeeeieabccccba
eeeeeeeeeeeeeeeeeeeeeeeeeeeeabcHccbaeoeeeeeeeeeeeeeeeeoeabcHccba
eeeeeeeeeeeeeeeeeeeeeeeeeeeeabccccbaeoeeeeeeeeeeeeeeeeoeabccccba
eeeeeeeeeeeeeeeeeeeeeeeeeeeeabccccbaeoeeeeeeeeeeeeeeeeoeabccccba
eeeeeeeeeeeeeeeeeeeeeeeeeeeeabccccbaeoeeeeeeeeeeeeeeeeoeabccccba
eeeeeeeeeeeeeeeeeeeeeeeeeeeeabccccbaeoeeeeeeeeeeeeeeeeoeabccccba
eeeeeeeeeeeeeeeeeeeeeeeeeeeeabccccbaeoeeeeeeeeeeeeeeeeoeabccccba
eeeDeeeeeeemeeeeeeeneeeeeeeepbccccbaeoeeeeeeeeeeeeeeeeoeabccccba
eeoooooooooooooooooeeeeeeeeeabcHccbaeoeeeeeeeeeeeeeeeeoeabcHccba
eeoeeeeeeeeeeeeeeeoeeeeeeeeeabccccbaeoeeeeeeeeeeeeeeeeoeabccccba
eeoeeeeeeeeeeeeeeeoeeeeeeeeeabccccbaeoeeeeeeeeeeeeeeeeoeabccccba
eeoeeeeeeeeeeeeeeeoeeeeeeeeeabccccbaeoeeeeeeeeeeeeeeeeoeabccccba
eeoeeeeeeeeeeeeeeeoeeeeeeeeeabccccbaeoeeeeeeeeeeeeeeeeoeabccccba
eeoeeeeeeeeeeeeeeeoeeeeeeeeeabccccbaeoeeeeeeeeeeeeeeeeoeabccccba
eeoeeeeeeeeeeeeeeeoeeeeeeeeeabccccbaeoeeeeeeeeeeeeeeeeoeabccccba
eeoeeeeeeeeeeeeeeeoqeeeeeeeeabcHccbseoeeeeeeeeeeeeeeeeoeabcHccba
eeoeeeeeeeeeeeeeeeoeeeeeeeeiabccccbaeoveeeeeeeeeeeeeeeoeabccccba
eeoeeeeeeeeeeeeeeeoeeeeeeeejabccccbaeeeeeeeeeeeeeeeeeeeeabccccba
eeoeeeeeeeeeeeeeeeoeeeeeeeejabccccbayEaaaaaaaaaaaaaaayaaabccccba
eeoeeeeeeeeeeeeeeeoeeeeeeeejabcccccFGgggggggggggggggggggghccccba
eeoeeeeeeeeeeeeeeeoeeeeeeeejabcccccFGcccccccccccccccccccccccccba
eeoeeeeeeeeeeeeeeeoeeeeeeeejabcccccFGcccccccccccccccccccccccccba
eeoeeeeeeeeeeeeeeeoeeeeeeeejabcHcccFccHccccccHccccccHccccccHccba
eeoIeeeeeeeeeeeeeeoDeeeeeeeiabcccccFccccccccccccccccccccccccccba
eeoooooooooooooooooeeeeeeeeeabcccccFggggggggggggggggggggggggggha
eeeeeeeeeeeeeeeeeeeeeeeeeeeeabccccbaaaaaaaaaAaaaaaaaaaaaaaaaaaaa
"}
