"a" = (/turf/simulated/floor/sidewalk,/area/dmm_suite/clear_area)
"b" = (/obj/decal/road_marking/solid_line,/turf/simulated/floor/road,/area/dmm_suite/clear_area)
"c" = (/turf/simulated/floor/road,/area/dmm_suite/clear_area)
"d" = (/obj/decal/road_marking/dotted_line/half{icon_state = "1"; dir = 8},/obj/decal/road_marking/dotted_line/half{icon_state = "1"; dir = 1},/turf/simulated/floor/road,/area/dmm_suite/clear_area)
"e" = (/turf/dmm_suite/clear_turf,/area/dmm_suite/clear_area)
"f" = (/obj/decal/road_marking/solid_line{icon_state = "1"; dir = 6},/turf/simulated/floor/road,/area/dmm_suite/clear_area)
"g" = (/obj/decal/road_marking/solid_line{icon_state = "1"; dir = 9},/turf/simulated/floor/road,/area/dmm_suite/clear_area)
"h" = (/obj/marker/prefab/house{icon_state = ""; dir = 1},/turf/dmm_suite/clear_turf,/area/dmm_suite/clear_area)
"i" = (/obj/marker/prefab/city/parking{icon_state = "parking"; dir = 4},/turf/dmm_suite/clear_turf,/area/dmm_suite/clear_area)
"j" = (/obj/marker/prefab/house,/turf/dmm_suite/clear_turf,/area/dmm_suite/clear_area)
"k" = (/obj/marker/prefab/city/store{icon_state = ""; dir = 1},/turf/dmm_suite/clear_turf,/area/dmm_suite/clear_area)
"l" = (/obj/decal/road_marking/solid_line{icon_state = "1"; dir = 4},/turf/simulated/floor/road,/area/dmm_suite/clear_area)
"m" = (/obj/marker/map_node/x4,/obj/decal/road_marking/dotted_line/half,/turf/simulated/floor/road,/area/dmm_suite/clear_area)
"n" = (/obj/decal/road_marking/solid_line{icon_state = "1"; dir = 10},/turf/simulated/floor/road,/area/dmm_suite/clear_area)
"o" = (/obj/decal/road_marking/dotted_line,/turf/simulated/floor/road,/area/dmm_suite/clear_area)
"p" = (/obj/structure/interactive/lighting/roadlamp{icon_state = "lamp"; dir = 4},/turf/simulated/floor/sidewalk,/area/dmm_suite/clear_area)
"q" = (/obj/decal/road_marking/solid_line/offset/yellow{icon_state = "1"; dir = 4},/turf/simulated/floor/road,/area/dmm_suite/clear_area)
"r" = (/obj/marker/map_node/x4,/obj/decal/road_marking/dotted_line/half{icon_state = "1"; dir = 8},/turf/simulated/floor/road,/area/dmm_suite/clear_area)
"s" = (/obj/structure/interactive/lighting/roadlamp{icon_state = "lamp"; dir = 8},/turf/simulated/floor/sidewalk,/area/dmm_suite/clear_area)
"t" = (/obj/decal/road_marking/solid_line/offset/yellow{icon_state = "1"; dir = 1},/turf/simulated/floor/road,/area/dmm_suite/clear_area)
"u" = (/obj/structure/interactive/stopsign{icon_state = "sign"; dir = 1},/turf/simulated/floor/sidewalk,/area/dmm_suite/clear_area)
"v" = (/obj/marker/prefab/city/store,/turf/dmm_suite/clear_turf,/area/dmm_suite/clear_area)
"w" = (/obj/decal/road_marking/solid_stop{icon_state = "1"; dir = 1},/turf/simulated/floor/road,/area/dmm_suite/clear_area)
"x" = (/obj/decal/road_marking/solid_cross,/turf/simulated/floor/road,/area/dmm_suite/clear_area)
"y" = (/obj/structure/interactive/lighting/roadlamp,/turf/simulated/floor/sidewalk,/area/dmm_suite/clear_area)
"z" = (/obj/marker/map_node/x4,/obj/decal/road_marking/solid_line/offset/yellow{icon_state = "1"; dir = 1},/turf/simulated/floor/road,/area/dmm_suite/clear_area)
"A" = (/obj/structure/interactive/lighting/roadlamp{icon_state = "lamp"; dir = 1},/turf/simulated/floor/sidewalk,/area/dmm_suite/clear_area)
"B" = (/obj/structure/interactive/stopsign{icon_state = "sign"; dir = 8},/turf/simulated/floor/sidewalk,/area/dmm_suite/clear_area)
"C" = (/turf/simulated/wall/brick/city,/area/dmm_suite/clear_area)
"D" = (/obj/marker/blob,/turf/simulated/floor/sidewalk,/area/dmm_suite/clear_area)
"E" = (/obj/structure/interactive/stopsign{icon_state = "sign"; dir = 4},/turf/simulated/floor/sidewalk,/area/dmm_suite/clear_area)
"F" = (/obj/decal/road_marking/solid_cross{icon_state = "1"; dir = 4},/turf/simulated/floor/road,/area/dmm_suite/clear_area)
"G" = (/obj/decal/road_marking/solid_stop{icon_state = "1"; dir = 4},/turf/simulated/floor/road,/area/dmm_suite/clear_area)
"H" = (/obj/decal/road_marking/solid_line{icon_state = "1"; dir = 8},/turf/simulated/floor/road,/area/dmm_suite/clear_area)
"J" = (/obj/marker/map_node/x4,/obj/decal/road_marking/dotted_line/half{icon_state = "1"; dir = 4},/turf/simulated/floor/road,/area/dmm_suite/clear_area)
"K" = (/obj/decal/road_marking/dotted_line/half{icon_state = "1"; dir = 8},/turf/simulated/floor/road,/area/dmm_suite/clear_area)
"L" = (/obj/decal/road_marking/dotted_line/half{icon_state = "1"; dir = 4},/turf/simulated/floor/road,/area/dmm_suite/clear_area)
"M" = (/obj/decal/road_marking/dotted_line/half,/turf/simulated/floor/road,/area/dmm_suite/clear_area)
"N" = (/obj/decal/road_marking/dotted_line/half{icon_state = "1"; dir = 1},/turf/simulated/floor/road,/area/dmm_suite/clear_area)
"O" = (/obj/marker/map_node/x4,/obj/decal/road_marking/dotted_line/half{icon_state = "1"; dir = 1},/turf/simulated/floor/road,/area/dmm_suite/clear_area)
"P" = (/obj/decal/road_marking/dotted_line/half,/obj/decal/road_marking/dotted_line/half{icon_state = "1"; dir = 4},/turf/simulated/floor/road,/area/dmm_suite/clear_area)
"Q" = (/obj/marker/map_node/x4,/obj/decal/road_marking/dotted_line/half{icon_state = "1"; dir = 4},/obj/decal/road_marking/dotted_line/half{icon_state = "1"; dir = 1},/turf/simulated/floor/road,/area/dmm_suite/clear_area)
"Y" = (/obj/marker/prefab/city/parking{icon_state = "parking"; dir = 4},/turf/simulated/floor/sidewalk,/area/dmm_suite/clear_area)

(1,1,1) = {"
eeeeeeeeeeeeeeeeeeeeeeeeeeeeabcLKcbaCeeeeeeeeeeeeeeeeeeeeeeeeeee
eaaaaaaaaaaaaaaaaaaaaaaaaaaaabcLKcbaCeeeeeeeeeeeeeeeeeeeeeeeeeee
eafllllllllllllllllllllllllllgcLKcbaCeeeeeeeeeeeeeeeeeeeeeeeeeee
eabccccccccccccccccccccccccccccLrcbaCeeeeeeeeeeeeeeeeeeeeeeeeeee
eabccMMMMMMMMMMMMMMMMMMMMMMMMMMPKcbaCeeeeeeeeeeeeeeeeeeeeeeeeeee
eabcJdNNNNONNNNNNONNNNNNONNNNNNOccbaCeeeeeeeeeeeeeeeeeeeeeeeeeee
eabcLKccccccccccccccccccccccccccccbaCeeeeeeeeeeeeeeeeeeeeeeeeeee
eabcLKcflllllllllllllllllllllHHHHHgaCCCCCCCCCCCCCCCCCCCCCCCCeeee
eabcLKcbaaaaaaaaaaaaaaaaaaaaaaaaaaaaCeeeeeeeeeeeeeeeeeeeeeeCeeee
eabcLKcbaCCCCCCCCCCCCCCCCCCCCCCCCCCCCeeeeeeeeeeeeeeeeeeeeeeCeeee
epbcLKcbaeeeeeeeeeeeeeeeeeeeeeeeeeeeeeeeeeeeeeeeeeeeeeeeeeeCeeee
eabcJKcbaeeeeeeeeeeeeeeeeeeeeeeeeeeeeeeeeeeeeeeeeeeeeeeeeeeCeeee
eabcLKcbaeeeeeeeeeeeeeeeeeeeeeeeeeeeeeeeeeeeeeeeeeeeeeeeeeeCeeee
eabcLKcbaeeeeeeeeeeeeeeeeeeeeeeeeeeeeeeeeeeeeeeeeeeeeeeeeeeCeeee
eabcLKcbaeeeeeeeeeeeeeeeeeeeeeeeeeeeeeeeeeeeeeeeeeeeeeeeeeeCeeee
eabcLKcbaeeeeeeeeeeeeeeeeeeeeeeeeeeeeeeeeeeeeeeeeeeeeeeeeeeCeeee
eabcLKcbaeeeeeeeeeeeeeeeeeeeeeeeeeeeeeeeeeeeeeeeeeeeeeeeeeeCeeee
eabcLKcbaeeeeeeeeeeeeeeeeeeeeeeeeeeeeeeeeeeeeeeeeeeeeeeeeeeCeeee
eabcJKcbaeeeeeeeeeeeeeeeeeeeeeeeeeeeeeeeeeeeeeeeeeeeeeeeeeeCeeee
eabcLKcbseeeeeeeeeeeeeeeeeeeeeeeeeeeeeeeeeeeeeeeeeeeeeeeeeeCeeee
eabctKcbaeeeeeeeeeeeeeeeeeeeeeeeeeeeeeeeeeeeeeeeeeeeeeeeeeeCeeee
eabctKcbaeeeeeeeeeeeeeeeeeeeeeeeeeeeeeeeeeeeeeeeeeeeeeeeeeeCeeee
eabctKcbaeeeeeeeeeeeeeeeeeeeeeeeeeeeeeeeeeeeeeeeeeeeeeeeeeeCeeee
eabctKcbaeeeeeeeeeeeeeeeeeeeeeeeeeeeeeeeeeeeeeeeeeeeeeeeeeeCeeee
eabctKcbaeeeeeeeeeeeeeeeeeeeeeeeeeeeeeeeeeeeeeeeeeeeeeeeeeeCeeee
eabczKcbaeeeeeeeeeeeeeeeeeeeeeeeeeeeeeeeeeeeeeeeeeeeeeeeeeeCeeee
eubctKcbaeeeeeeeeeeeeeeeeeveeeeeeeeeeeeeeeveeeeeeeeeeeeeeeeCeeee
epwwwccbajeeeeeeeeeeeeeeeeeeeeeeeeeeeeeeeeeeeeeeeeeeeeeeeeeCCCCC
aaxxxxxxaaaaaaaaaaayaaaaaaaaaaaaaaaeeeeeeeeeeeeeeeeeeeeaaaaaaaaa
lcccccccllllllllllllllllllllllllllneeeeeeeeeeaeeeeeeeeeafHHHHHll
ccccccccccccccccccccccccccccccccccoeeeeeeeeeeceeeeeeeeeaoccccccc
MMMMMMMMMMMMMMMMMMMMMMMMMMMMMMMMccoeeeeeeeeeeceeeeeeeeeaoccmMMMM
NNNONNNNNNONNNNNNONNNNNNONNNNNNQKcoeeeeeeeeeeceeeeeeeeeaocJdNNNN
cccccccccccccccccccccccccccccccLKcoeeeeeeeeeeceeeeeeeeeaocLKcccc
lllllllllllllllllllllllllllllncLKcbeeeeeeeeeeaeeeeeeeeeabcLKcfll
aaaaaaaaaaaAaaaaaaaaaaaaaaBAabcLKcbeeeeeeeeeeeeeeeeeeeeabcLKcbaa
CCeeeeeeeeeeeeeeeeeeeeeeeeeeabcLKcbYeeeeeeeeeeieeeeeeeeabcLKcbae
eCeeeeeeeeeeeeeeeeeeeeeeeeeeabcLKcbsCeeeeeeeeeeeeeeeeeeabcLKcbae
eCeeeeeeeeeeeeeeeeeeeeeeeeeeabcLKcbaCeeeeeeeeeeeeeeeeeeabcLKcbae
eCeeeeeeeeeeeeeeeeeeeeeeeeeeabcJKcbaCeeeeeeeeeeeeeeeeeeabcJKcbae
eCeeeeeeeeeeeeeeeeeeeeeeeeeeabcLKcbaCeeeeeeeeeeeeeeeeeeabcLKcbae
eCeeeeeeeeeeeeeeeeeeeeeeeeeeabcLKcbaCeeeeeeeeeeeeeeeeeeabcLKcbae
eCeeeeeeeeeeeeeeeeeeeeeeeeeeabcLKcbaCeeeeeeeeeeeeeeeeeeabcLKcbae
eCeeeeeeeeeeeeeeeeeeeeeeeeeeabcLKcbaCeeeeeeeeeeeeeeeeeeabcLKcbae
eCeeeeeeeeeeeeeeeeeeeeeeeeeeabcLKcbaCeeeeeeeeeeeeeeeeeeabcLKcbae
eCeeeeeeeeeeeeeeeeeeeeeeeeeepbcLKcbaCeeeeeeeeeeeeeeeeeeabcLKcbae
eCeeeeeeeeeeeeeeeeeeeeeeeeeeabcJKcbaCeeeeeeeeeeeeeeeeeeabcJKcbae
eCeeeeeeeeeeeeeeeeeeeeeeeeeeDbcLKcbaCeeeeeeeeeeeeeeeeeeabcLKcbae
eCeeeeeeeeeeeeeeeeeeeeeeeeeeabcLKcbaCeeeeeeeeeeeeeeeeeeabcLKcbae
eCeeeeeeeeeeeeeeeeeeeeeeeeeeabcLKcbaCeeeeeeeeeeeeeeeeeeabcLKcbae
eCeeeeeeeeeeeeeeeeeeeeeeeeeeabcLKcbaCeeeeeeeeeeeeeeeeeeabcLKcbae
eCeheeeeeeeeeeeeeeeeeeeeeeeeabcLKcbaCeeeeeeeeeeeeeeeeeeabcLKcbae
eCeeeeeeeeeeeeeeeeeeeeeeeeeeabcLKcbaCekeeeeeeeeeeeeeeeeabcLKcbae
eCCCCCCCCCCCCCCCCCCCCCCCCCCCabcJKcbsCeeeeeeeeeeeeeeeeeeabcJKcbae
eeeeeeeeeeeeeeeeeeeeeeeeeeeCabcLKcbaCCCCCCCCCCCCCCCCCCCabcLKcbae
eeeeeeeeeeeeeeeeeeeeeeeeeeeCabcLKcbayEaaaaaaaaaaaaaaayaabcLKcbae
eeeeeeeeeeeeeeeeeeeeeeeeeeeCabcLKcbFGlllllllllllllllllllgcLKcbae
eeeeeeeeeeeeeeeeeeeeeeeeeeeCabcLKccFGcccccccccccccccccccccLKcbae
eeeeeeeeeeeeeeeeeeeeeeeeeeeCabcLKccFGqqqqqqqqMMMMMMMMMMMMMPKcbae
eeeeeeeeeeeeeeeeeeeeeeeeeeeCabcLKccFcNONNNNNNONNNNNNONNNNNOccbae
eeeeeeeeeeeeeeeeeeeeeeeeeeeCabcJKccFcccccccccccccccccccccccccbae
eeeeeeeeeeeeeeeeeeeeeeeeeeeCabcLKccFlllllllllllllllllllllllllgae
eeeeeeeeeeeeeeeeeeeeeeeeeeeCabcLKccaaaaaaaaaAaaaaaaaaaaaaaaaaaae
eeeeeeeeeeeeeeeeeeeeeeeeeeeCabcLKcbaeeeeeeeeeeeeeeeeeeeeeeeeeeee
"}
