//MAP CONVERTED BY dmm2tgm.py THIS HEADER COMMENT PREVENTS RECONVERSION, DO NOT REMOVE
"a" = (
/turf/simulated/floor/sidewalk,
/area/dmm_suite/clear_area)
"b" = (
/obj/decal/road_marking/solid_line,
/turf/simulated/floor/road,
/area/dmm_suite/clear_area)
"c" = (
/turf/simulated/floor/road,
/area/dmm_suite/clear_area)
"d" = (
/obj/decal/road_marking/dotted_line/half{
	icon_state = "1";
	dir = 8
	},
/obj/decal/road_marking/dotted_line/half{
	icon_state = "1";
	dir = 1
	},
/turf/simulated/floor/road,
/area/dmm_suite/clear_area)
"e" = (
/turf/dmm_suite/clear_turf,
/area/dmm_suite/clear_area)
"f" = (
/obj/decal/road_marking/solid_line{
	icon_state = "1";
	dir = 6
	},
/turf/simulated/floor/road,
/area/dmm_suite/clear_area)
"g" = (
/obj/decal/road_marking/solid_line{
	icon_state = "1";
	dir = 9
	},
/turf/simulated/floor/road,
/area/dmm_suite/clear_area)
"i" = (
/obj/marker/prefab/city/parking{
	icon_state = "parking";
	dir = 4
	},
/turf/dmm_suite/clear_turf,
/area/dmm_suite/clear_area)
"k" = (
/obj/marker/prefab/city/store{
	icon_state = "";
	dir = 1
	},
/turf/dmm_suite/clear_turf,
/area/dmm_suite/clear_area)
"l" = (
/obj/decal/road_marking/solid_line{
	icon_state = "1";
	dir = 4
	},
/turf/simulated/floor/road,
/area/dmm_suite/clear_area)
"n" = (
/obj/decal/road_marking/solid_line{
	icon_state = "1";
	dir = 10
	},
/turf/simulated/floor/road,
/area/dmm_suite/clear_area)
"o" = (
/obj/decal/road_marking/dotted_line,
/turf/simulated/floor/road,
/area/dmm_suite/clear_area)
"p" = (
/obj/structure/interactive/lighting/roadlamp{
	icon_state = "lamp";
	dir = 4
	},
/turf/simulated/floor/sidewalk,
/area/dmm_suite/clear_area)
"q" = (
/obj/decal/road_marking/solid_line/offset/yellow{
	icon_state = "1";
	dir = 4
	},
/turf/simulated/floor/road,
/area/dmm_suite/clear_area)
"r" = (
/obj/marker/prefab/landing,
/turf/dmm_suite/clear_turf,
/area/dmm_suite/clear_area)
"s" = (
/obj/structure/interactive/lighting/roadlamp{
	icon_state = "lamp";
	dir = 8
	},
/turf/simulated/floor/sidewalk,
/area/dmm_suite/clear_area)
"t" = (
/obj/decal/road_marking/solid_line/offset/yellow{
	icon_state = "1";
	dir = 1
	},
/turf/simulated/floor/road,
/area/dmm_suite/clear_area)
"u" = (
/obj/structure/interactive/stopsign{
	icon_state = "sign";
	dir = 1
	},
/turf/simulated/floor/sidewalk,
/area/dmm_suite/clear_area)
"v" = (
/obj/marker/prefab/city/store,
/turf/dmm_suite/clear_turf,
/area/dmm_suite/clear_area)
"w" = (
/obj/decal/road_marking/solid_stop{
	icon_state = "1";
	dir = 1
	},
/turf/simulated/floor/road,
/area/dmm_suite/clear_area)
"x" = (
/obj/decal/road_marking/solid_cross,
/turf/simulated/floor/road,
/area/dmm_suite/clear_area)
"y" = (
/obj/structure/interactive/lighting/roadlamp,
/turf/simulated/floor/sidewalk,
/area/dmm_suite/clear_area)
"A" = (
/obj/structure/interactive/lighting/roadlamp{
	icon_state = "lamp";
	dir = 1
	},
/turf/simulated/floor/sidewalk,
/area/dmm_suite/clear_area)
"B" = (
/obj/structure/interactive/stopsign{
	icon_state = "sign";
	dir = 8
	},
/turf/simulated/floor/sidewalk,
/area/dmm_suite/clear_area)
"D" = (
/obj/marker/blob,
/turf/simulated/floor/sidewalk,
/area/dmm_suite/clear_area)
"E" = (
/obj/structure/interactive/stopsign{
	icon_state = "sign";
	dir = 4
	},
/turf/simulated/floor/sidewalk,
/area/dmm_suite/clear_area)
"F" = (
/obj/decal/road_marking/solid_cross{
	icon_state = "1";
	dir = 4
	},
/turf/simulated/floor/road,
/area/dmm_suite/clear_area)
"G" = (
/obj/decal/road_marking/solid_stop{
	icon_state = "1";
	dir = 4
	},
/turf/simulated/floor/road,
/area/dmm_suite/clear_area)
"H" = (
/obj/decal/road_marking/solid_line{
	icon_state = "1";
	dir = 8
	},
/turf/simulated/floor/road,
/area/dmm_suite/clear_area)
"K" = (
/obj/decal/road_marking/dotted_line/half{
	icon_state = "1";
	dir = 8
	},
/turf/simulated/floor/road,
/area/dmm_suite/clear_area)
"L" = (
/obj/decal/road_marking/dotted_line/half{
	icon_state = "1";
	dir = 4
	},
/turf/simulated/floor/road,
/area/dmm_suite/clear_area)
"M" = (
/obj/decal/road_marking/dotted_line/half,
/turf/simulated/floor/road,
/area/dmm_suite/clear_area)
"N" = (
/obj/decal/road_marking/dotted_line/half{
	icon_state = "1";
	dir = 1
	},
/turf/simulated/floor/road,
/area/dmm_suite/clear_area)
"P" = (
/obj/decal/road_marking/dotted_line/half,
/obj/decal/road_marking/dotted_line/half{
	icon_state = "1";
	dir = 4
	},
/turf/simulated/floor/road,
/area/dmm_suite/clear_area)
"Q" = (
/obj/decal/road_marking/dotted_line/half{
	icon_state = "1";
	dir = 4
	},
/obj/decal/road_marking/dotted_line/half{
	icon_state = "1";
	dir = 1
	},
/turf/simulated/floor/road,
/area/dmm_suite/clear_area)

(1,1,1) = {"
e
e
e
e
e
e
e
e
e
e
e
e
e
e
e
e
e
e
e
e
e
e
e
e
e
e
e
e
a
l
c
M
N
c
l
a
e
e
e
e
e
e
e
e
e
e
e
e
e
e
e
e
e
e
e
e
e
e
e
e
e
e
e
e
"}
(2,1,1) = {"
e
a
a
a
a
a
a
a
a
a
p
a
a
a
a
a
a
a
a
a
a
a
a
a
a
a
u
p
a
c
c
M
N
c
l
a
e
e
e
e
e
e
e
e
e
e
e
e
e
e
e
e
e
e
e
e
e
e
e
e
e
e
e
e
"}
(3,1,1) = {"
e
a
f
b
b
b
b
b
b
b
b
b
b
b
b
b
b
b
b
b
b
b
b
b
b
b
b
w
x
c
c
M
N
c
l
a
e
e
e
e
e
e
e
e
e
e
e
e
e
e
e
e
e
e
e
e
e
e
e
e
e
e
e
e
"}
(4,1,1) = {"
e
a
l
c
c
c
c
c
c
c
c
c
c
c
c
c
c
c
c
c
c
c
c
c
c
c
c
w
x
c
c
M
N
c
l
a
e
e
e
e
e
e
e
e
e
e
e
e
e
e
e
e
e
e
e
e
e
e
e
e
e
e
e
e
"}
(5,1,1) = {"
e
a
l
c
c
L
L
L
L
L
L
L
L
L
L
L
L
L
L
L
t
t
t
t
t
t
t
w
x
c
c
M
N
c
l
a
e
e
e
e
e
e
e
e
e
e
e
e
e
e
e
e
e
e
e
e
e
e
e
e
e
e
e
e
"}
(6,1,1) = {"
e
a
l
c
M
d
K
K
K
K
K
K
K
K
K
K
K
K
K
K
K
K
K
K
K
K
K
c
x
c
c
M
N
c
l
a
e
e
e
e
e
e
e
e
e
e
e
e
e
e
e
e
e
e
e
e
e
e
e
e
e
e
e
e
"}
(7,1,1) = {"
e
a
l
c
M
N
c
c
c
c
c
c
c
c
c
c
c
c
c
c
c
c
c
c
c
c
c
c
x
c
c
M
N
c
l
a
e
e
e
e
e
e
e
e
e
e
e
e
e
e
e
e
e
e
e
e
e
e
e
e
e
e
e
e
"}
(8,1,1) = {"
e
a
l
c
M
N
c
f
b
b
b
b
b
b
b
b
b
b
b
b
b
b
b
b
b
b
b
b
x
c
c
M
N
c
l
a
e
e
e
e
e
e
e
e
e
e
e
e
e
e
e
e
e
e
e
e
e
e
e
e
e
e
e
e
"}
(9,1,1) = {"
e
a
l
c
M
N
c
l
a
a
a
a
a
a
a
a
a
a
a
s
a
a
a
a
a
a
a
a
a
l
c
M
N
c
l
a
e
e
e
e
e
e
e
e
e
e
e
e
e
e
e
e
e
e
e
e
e
e
e
e
e
e
e
e
"}
(10,1,1) = {"
e
a
l
c
M
N
c
l
a
e
e
e
e
e
e
e
e
e
e
e
e
e
e
e
e
e
e
e
a
l
c
M
N
c
l
a
e
e
e
e
e
e
e
e
e
e
e
e
e
e
e
e
e
e
e
e
e
e
e
e
e
e
e
e
"}
(11,1,1) = {"
e
a
l
c
M
N
c
l
a
e
e
e
e
e
e
e
e
e
e
e
e
e
e
e
e
e
r
e
a
l
c
M
N
c
l
a
e
e
e
e
e
e
e
e
e
e
e
e
e
e
e
e
e
e
e
e
e
e
e
e
e
e
e
e
"}
(12,1,1) = {"
e
a
l
c
M
N
c
l
a
e
e
e
e
e
e
e
e
e
e
e
e
e
e
e
e
e
e
e
a
l
c
M
N
c
l
A
e
e
e
e
e
e
e
e
e
e
e
e
e
e
e
e
e
e
e
e
e
e
e
e
e
e
e
e
"}
(13,1,1) = {"
e
a
l
c
M
N
c
l
a
e
e
e
e
e
e
e
e
e
e
e
e
e
e
e
e
e
e
e
a
l
c
M
N
c
l
a
e
e
e
e
e
e
e
e
e
e
e
e
e
e
e
e
e
e
e
e
e
e
e
e
e
e
e
e
"}
(14,1,1) = {"
e
a
l
c
M
N
c
l
a
e
e
e
e
e
e
e
e
e
e
e
e
e
e
e
e
e
e
e
a
l
c
M
N
c
l
a
e
e
e
e
e
e
e
e
e
e
e
e
e
e
e
e
e
e
e
e
e
e
e
e
e
e
e
e
"}
(15,1,1) = {"
e
a
l
c
M
N
c
l
a
e
e
e
e
e
e
e
e
e
e
e
e
e
e
e
e
e
e
e
a
l
c
M
N
c
l
a
e
e
e
e
e
e
e
e
e
e
e
e
e
e
e
e
e
e
e
e
e
e
e
e
e
e
e
e
"}
(16,1,1) = {"
e
a
l
c
M
N
c
l
a
e
e
e
e
e
e
e
e
e
e
e
e
e
e
e
e
e
e
e
a
l
c
M
N
c
l
a
e
e
e
e
e
e
e
e
e
e
e
e
e
e
e
e
e
e
e
e
e
e
e
e
e
e
e
e
"}
(17,1,1) = {"
e
a
l
c
M
N
c
l
a
e
e
e
e
e
e
e
e
e
e
e
e
e
e
e
e
e
e
e
a
l
c
M
N
c
l
a
e
e
e
e
e
e
e
e
e
e
e
e
e
e
e
e
e
e
e
e
e
e
e
e
e
e
e
e
"}
(18,1,1) = {"
e
a
l
c
M
N
c
l
a
e
e
e
e
e
e
e
e
e
e
e
e
e
e
e
e
e
e
e
a
l
c
M
N
c
l
a
e
e
e
e
e
e
e
e
e
e
e
e
e
e
e
e
e
e
e
e
e
e
e
e
e
e
e
e
"}
(19,1,1) = {"
e
a
l
c
M
N
c
l
a
e
e
e
e
e
e
e
e
e
e
e
e
e
e
e
e
e
e
e
a
l
c
M
N
c
l
a
e
e
e
e
e
e
e
e
e
e
e
e
e
e
e
e
e
e
e
e
e
e
e
e
e
e
e
e
"}
(20,1,1) = {"
e
a
l
c
M
N
c
l
a
e
e
e
e
e
e
e
e
e
e
e
e
e
e
e
e
e
e
e
y
l
c
M
N
c
l
a
e
e
e
e
e
e
e
e
e
e
e
e
e
e
e
e
e
e
e
e
e
e
e
e
e
e
e
e
"}
(21,1,1) = {"
e
a
l
c
M
N
c
l
a
e
e
e
e
e
e
e
e
e
e
e
e
e
e
e
e
e
e
e
a
l
c
M
N
c
l
a
e
e
e
e
e
e
e
e
e
e
e
e
e
e
e
e
e
e
e
e
e
e
e
e
e
e
e
e
"}
(22,1,1) = {"
e
a
l
c
M
N
c
l
a
e
e
e
e
e
e
e
e
e
e
e
e
e
e
e
e
e
e
e
a
l
c
M
N
c
l
a
e
e
e
e
e
e
e
e
e
e
e
e
e
e
e
e
e
e
e
e
e
e
e
e
e
e
e
e
"}
(23,1,1) = {"
e
a
l
c
M
N
c
l
a
e
e
e
e
e
e
e
e
e
e
e
e
e
e
e
e
e
e
e
a
l
c
M
N
c
l
a
e
e
e
e
e
e
e
e
e
e
e
e
e
e
e
e
e
e
e
e
e
e
e
e
e
e
e
e
"}
(24,1,1) = {"
e
a
l
c
M
N
c
l
a
e
e
e
e
e
e
e
e
e
e
e
e
e
e
e
e
e
e
e
a
l
c
M
N
c
l
a
e
e
e
e
e
e
e
e
e
e
e
e
e
e
e
e
e
e
e
e
e
e
e
e
e
e
e
e
"}
(25,1,1) = {"
e
a
l
c
M
N
c
l
a
e
e
e
e
e
e
e
e
e
e
e
e
e
e
e
e
e
e
e
a
l
c
M
N
c
l
a
e
e
e
e
e
e
e
e
e
e
e
e
e
e
e
e
e
e
e
e
e
e
e
e
e
e
e
e
"}
(26,1,1) = {"
e
a
l
c
M
N
c
l
a
e
e
e
e
e
e
e
e
e
e
e
e
e
e
e
e
e
e
e
a
l
c
M
N
c
l
a
e
e
e
e
e
e
e
e
e
e
e
e
e
e
e
e
e
e
e
e
e
e
e
e
e
e
e
e
"}
(27,1,1) = {"
e
a
l
c
M
N
c
l
a
e
e
e
e
e
e
e
e
e
e
e
e
e
e
e
e
e
e
e
a
l
c
M
N
c
l
B
e
e
e
e
e
e
e
e
e
e
e
e
e
e
e
e
e
e
e
e
e
e
e
e
e
e
e
e
"}
(28,1,1) = {"
e
a
l
c
M
N
c
l
a
e
e
e
e
e
e
e
e
e
e
e
e
e
e
e
e
e
e
e
a
l
c
M
N
c
l
A
e
e
e
e
e
e
e
e
e
e
e
e
e
e
e
e
e
e
e
e
e
e
e
e
e
e
e
e
"}
(29,1,1) = {"
a
a
l
c
M
N
c
l
a
e
e
e
e
e
e
e
e
e
e
e
e
e
e
e
e
e
e
e
a
l
c
M
N
c
l
a
a
a
a
a
a
a
a
a
a
p
a
D
a
a
a
a
a
a
a
a
a
a
a
a
a
a
a
a
"}
(30,1,1) = {"
b
b
g
c
M
N
c
H
a
e
e
e
e
e
e
e
e
e
e
e
e
e
e
e
e
e
v
e
a
l
c
M
N
c
n
b
b
b
b
b
b
b
b
b
b
b
b
b
b
b
b
b
b
b
b
b
b
b
b
b
b
b
b
b
"}
(31,1,1) = {"
c
c
c
c
M
N
c
H
a
e
e
e
e
e
e
e
e
e
e
e
e
e
e
e
e
e
e
e
a
l
c
M
N
c
c
c
c
c
c
c
c
c
c
c
c
c
c
c
c
c
c
c
c
c
c
c
c
c
c
c
c
c
c
c
"}
(32,1,1) = {"
L
L
L
L
P
N
c
H
a
e
e
e
e
e
e
e
e
e
e
e
e
e
e
e
e
e
e
e
a
l
c
M
Q
L
L
L
L
L
L
L
L
L
L
L
L
L
L
L
L
L
L
L
L
L
L
L
L
L
L
L
L
L
L
L
"}
(33,1,1) = {"
K
K
K
K
K
c
c
H
a
e
e
e
e
e
e
e
e
e
e
e
e
e
e
e
e
e
e
e
a
l
c
c
K
K
K
K
K
K
K
K
K
K
K
K
K
K
K
K
K
K
K
K
K
K
K
K
K
K
K
K
K
K
K
K
"}
(34,1,1) = {"
c
c
c
c
c
c
c
H
a
e
e
e
e
e
e
e
e
e
e
e
e
e
e
e
e
e
e
e
a
l
c
c
c
c
c
c
c
c
c
c
c
c
c
c
c
c
c
c
c
c
c
c
c
c
c
c
c
c
c
c
c
c
c
c
"}
(35,1,1) = {"
b
b
b
b
b
b
b
g
a
e
e
e
e
e
e
e
e
e
e
e
e
e
e
e
e
e
e
e
a
n
o
o
o
o
b
b
b
b
b
b
b
b
b
b
b
b
b
b
b
b
b
b
b
b
b
b
b
c
c
c
c
c
c
b
"}
(36,1,1) = {"
a
a
a
a
a
a
a
a
a
e
e
e
e
e
e
e
e
e
e
e
e
e
e
e
e
e
e
e
e
e
e
e
e
e
e
e
i
s
a
a
a
a
a
a
a
a
a
a
a
a
a
a
a
s
a
a
F
F
F
F
F
F
a
a
"}
(37,1,1) = {"
e
e
e
e
e
e
e
e
e
e
e
e
e
e
e
e
e
e
e
e
e
e
e
e
e
e
e
e
e
e
e
e
e
e
e
e
e
e
e
e
e
e
e
e
e
e
e
e
e
e
e
e
e
e
e
y
G
G
G
c
c
l
a
e
"}
(38,1,1) = {"
e
e
e
e
e
e
e
e
e
e
e
e
e
e
e
e
e
e
e
e
e
e
e
e
e
e
e
e
e
e
e
e
e
e
e
e
e
e
e
e
e
e
e
e
e
e
e
e
e
e
e
e
e
e
e
E
l
c
q
N
c
l
a
e
"}
(39,1,1) = {"
e
e
e
e
e
e
e
e
e
e
e
e
e
e
e
e
e
e
e
e
e
e
e
e
e
e
e
e
e
e
e
e
e
e
e
e
e
e
e
e
e
e
e
e
e
e
e
e
e
e
e
e
k
e
e
a
l
c
q
N
c
l
a
e
"}
(40,1,1) = {"
e
e
e
e
e
e
e
e
e
e
e
e
e
e
e
e
e
e
e
e
e
e
e
e
e
e
e
e
e
e
e
e
e
e
e
e
e
e
e
e
e
e
e
e
e
e
e
e
e
e
e
e
e
e
e
a
l
c
q
N
c
l
a
e
"}
(41,1,1) = {"
e
e
e
e
e
e
e
e
e
e
e
e
e
e
e
e
e
e
e
e
e
e
e
e
e
e
e
e
e
e
e
e
e
e
e
e
e
e
e
e
e
e
e
e
e
e
e
e
e
e
e
e
e
e
e
a
l
c
q
N
c
l
a
e
"}
(42,1,1) = {"
e
e
e
e
e
e
e
e
e
e
e
e
e
e
e
e
e
e
e
e
e
e
e
e
e
e
e
e
e
e
e
e
e
e
e
e
e
e
e
e
e
e
e
e
e
e
e
e
e
e
e
e
e
e
e
a
l
c
q
N
c
l
a
e
"}
(43,1,1) = {"
e
e
e
e
e
e
e
e
e
e
e
e
e
e
e
e
e
e
e
e
e
e
e
e
e
e
e
e
e
e
e
e
e
e
e
e
e
e
e
e
e
e
e
e
e
e
e
e
e
e
e
e
e
e
e
a
l
c
q
N
c
l
a
e
"}
(44,1,1) = {"
e
e
e
e
e
e
e
e
e
e
e
e
e
e
e
e
e
e
e
e
e
e
e
e
e
e
e
e
e
e
e
e
e
e
e
e
e
e
e
e
e
e
e
e
e
e
e
e
e
e
e
e
e
e
e
a
l
c
q
N
c
l
a
e
"}
(45,1,1) = {"
e
e
e
e
e
e
e
e
e
e
e
e
e
e
e
e
e
e
e
e
e
e
e
e
e
e
e
e
e
e
e
e
e
e
e
e
e
e
e
e
e
e
e
e
e
e
e
e
e
e
e
e
e
e
e
a
l
c
q
N
c
l
A
e
"}
(46,1,1) = {"
e
e
e
e
e
e
e
e
e
e
e
e
e
e
e
e
e
e
e
e
e
e
e
e
e
e
e
e
e
e
e
e
e
e
e
e
e
e
e
e
e
e
e
e
e
e
e
e
e
e
e
e
e
e
e
a
l
c
M
N
c
l
a
e
"}
(47,1,1) = {"
e
e
e
e
e
e
e
e
e
e
e
e
e
e
e
e
e
e
e
e
e
e
e
e
e
e
v
e
e
e
e
e
e
e
e
e
i
e
e
e
e
e
e
e
e
e
e
e
e
e
e
e
e
e
e
a
l
c
M
N
c
l
a
e
"}
(48,1,1) = {"
e
e
e
e
e
e
e
e
e
e
e
e
e
e
e
e
e
e
e
e
e
e
e
e
e
e
e
e
e
e
e
e
e
e
e
e
e
e
e
e
e
e
e
e
e
e
e
e
e
e
e
e
e
e
e
a
l
c
M
N
c
l
a
e
"}
(49,1,1) = {"
e
e
e
e
e
e
e
e
e
e
e
e
e
e
e
e
e
e
e
e
e
e
e
e
e
e
e
e
e
e
e
e
e
e
e
e
e
e
e
e
e
e
e
e
e
e
e
e
e
e
e
e
e
e
e
a
l
c
M
N
c
l
a
e
"}
(50,1,1) = {"
e
e
e
e
e
e
e
e
e
e
e
e
e
e
e
e
e
e
e
e
e
e
e
e
e
e
e
e
e
e
e
e
e
e
e
e
e
e
e
e
e
e
e
e
e
e
e
e
e
e
e
e
e
e
e
a
l
c
M
N
c
l
a
e
"}
(51,1,1) = {"
e
e
e
e
e
e
e
e
e
e
e
e
e
e
e
e
e
e
e
e
e
e
e
e
e
e
e
e
e
e
e
e
e
e
e
e
e
e
e
e
e
e
e
e
e
e
e
e
e
e
e
e
e
e
e
a
l
c
M
N
c
l
a
e
"}
(52,1,1) = {"
e
e
e
e
e
e
e
e
e
e
e
e
e
e
e
e
e
e
e
e
e
e
e
e
e
e
e
e
e
e
e
e
e
e
e
e
e
e
e
e
e
e
e
e
e
e
e
e
e
e
e
e
e
e
e
a
l
c
M
N
c
l
a
e
"}
(53,1,1) = {"
e
e
e
e
e
e
e
e
e
e
e
e
e
e
e
e
e
e
e
e
e
e
e
e
e
e
e
e
e
e
e
e
e
e
e
e
e
e
e
e
e
e
e
e
e
e
e
e
e
e
e
e
e
e
e
a
l
c
M
N
c
l
a
e
"}
(54,1,1) = {"
e
e
e
e
e
e
e
e
e
e
e
e
e
e
e
e
e
e
e
e
e
e
e
e
e
e
e
e
e
e
e
e
e
e
e
e
e
e
e
e
e
e
e
e
e
e
e
e
e
e
e
e
e
e
e
y
l
c
M
N
c
l
a
e
"}
(55,1,1) = {"
e
e
e
e
e
e
e
e
e
e
e
e
e
e
e
e
e
e
e
e
e
e
e
e
e
e
e
e
e
e
e
e
e
e
e
e
e
e
e
e
e
e
e
e
e
e
e
e
e
e
e
e
e
e
e
a
l
c
M
N
c
l
a
e
"}
(56,1,1) = {"
e
e
e
e
e
e
e
e
e
e
e
e
e
e
e
e
e
e
e
e
e
e
e
e
e
e
e
e
e
e
e
e
e
e
e
e
e
a
a
a
a
a
a
a
a
a
a
a
a
a
a
a
a
a
a
a
l
c
M
N
c
l
a
e
"}
(57,1,1) = {"
e
e
e
e
e
e
e
e
e
e
e
e
e
e
e
e
e
e
e
e
e
e
e
e
e
e
e
e
a
f
o
o
o
o
b
b
b
b
b
b
b
b
b
b
b
b
b
b
b
b
b
b
b
b
b
b
g
c
M
N
c
l
a
e
"}
(58,1,1) = {"
e
e
e
e
e
e
e
e
e
e
e
e
e
e
e
e
e
e
e
e
e
e
e
e
e
e
e
e
a
H
c
c
c
c
c
c
c
c
c
c
c
c
c
c
c
c
c
c
c
c
c
c
c
c
c
c
c
c
M
N
c
l
a
e
"}
(59,1,1) = {"
e
e
e
e
e
e
e
e
e
e
e
e
e
e
e
e
e
e
e
e
e
e
e
e
e
e
e
e
a
H
c
c
L
L
L
L
L
L
L
L
L
L
L
L
L
L
L
L
L
L
L
L
L
L
L
L
L
L
P
N
c
l
a
e
"}
(60,1,1) = {"
e
e
e
e
e
e
e
e
e
e
e
e
e
e
e
e
e
e
e
e
e
e
e
e
e
e
e
e
a
H
c
M
d
K
K
K
K
K
K
K
K
K
K
K
K
K
K
K
K
K
K
K
K
K
K
K
K
K
K
c
c
l
a
e
"}
(61,1,1) = {"
e
e
e
e
e
e
e
e
e
e
e
e
e
e
e
e
e
e
e
e
e
e
e
e
e
e
e
e
a
H
c
M
N
c
c
c
c
c
c
c
c
c
c
c
c
c
c
c
c
c
c
c
c
c
c
c
c
c
c
c
c
l
a
e
"}
(62,1,1) = {"
e
e
e
e
e
e
e
e
e
e
e
e
e
e
e
e
e
e
e
e
e
e
e
e
e
e
e
e
a
H
c
M
N
c
f
b
b
b
b
b
b
b
b
b
b
b
b
b
b
b
b
b
b
b
b
b
b
b
b
b
b
g
a
e
"}
(63,1,1) = {"
e
e
e
e
e
e
e
e
e
e
e
e
e
e
e
e
e
e
e
e
e
e
e
e
e
e
e
e
a
l
c
M
N
c
l
a
a
a
a
a
a
a
a
a
a
a
a
a
a
a
a
a
a
a
a
a
a
a
a
a
a
a
a
e
"}
(64,1,1) = {"
e
e
e
e
e
e
e
e
e
e
e
e
e
e
e
e
e
e
e
e
e
e
e
e
e
e
e
e
a
l
c
M
N
c
l
a
e
e
e
e
e
e
e
e
e
e
e
e
e
e
e
e
e
e
e
e
e
e
e
e
e
e
e
e
"}
