//MAP CONVERTED BY dmm2tgm.py THIS HEADER COMMENT PREVENTS RECONVERSION, DO NOT REMOVE
"a" = (
/turf/dmm_suite/clear_turf,
/area/dmm_suite/clear_area)
"b" = (
/turf/simulated/floor/sidewalk,
/area/dmm_suite/clear_area)
"c" = (
/obj/decal/road_marking/solid_line,
/turf/simulated/floor/road,
/area/dmm_suite/clear_area)
"d" = (
/turf/simulated/floor/road,
/area/dmm_suite/clear_area)
"e" = (
/obj/marker/prefab/city/store{
	icon_state = "";
	dir = 8
	},
/turf/dmm_suite/clear_turf,
/area/dmm_suite/clear_area)
"f" = (
/obj/marker/prefab/city/parking,
/turf/simulated/floor/sidewalk,
/area/dmm_suite/clear_area)
"g" = (
/turf/dmm_suite/no_wall,
/area/dmm_suite/clear_area)
"h" = (
/obj/marker/prefab/city/parking{
	icon_state = "parking";
	dir = 6
	},
/turf/dmm_suite/clear_turf,
/area/dmm_suite/clear_area)
"i" = (
/obj/marker/prefab/city/parking{
	icon_state = "parking";
	dir = 5
	},
/turf/dmm_suite/clear_turf,
/area/dmm_suite/clear_area)
"j" = (
/obj/marker/prefab/city/parking{
	icon_state = "parking";
	dir = 9
	},
/turf/dmm_suite/clear_turf,
/area/dmm_suite/clear_area)
"k" = (
/obj/structure/interactive/lighting/roadlamp{
	icon_state = "lamp";
	dir = 4
	},
/turf/simulated/floor/sidewalk,
/area/dmm_suite/clear_area)
"l" = (
/obj/marker/prefab/city/store{
	icon_state = "";
	dir = 4
	},
/turf/dmm_suite/clear_turf,
/area/dmm_suite/clear_area)
"m" = (
/obj/marker/prefab/city/parking,
/turf/dmm_suite/clear_turf,
/area/dmm_suite/clear_area)
"n" = (
/obj/structure/interactive/lighting/roadlamp{
	icon_state = "lamp";
	dir = 8
	},
/turf/simulated/floor/sidewalk,
/area/dmm_suite/clear_area)
"o" = (
/obj/marker/prefab/city/store{
	icon_state = "";
	dir = 1
	},
/turf/dmm_suite/clear_turf,
/area/dmm_suite/clear_area)
"p" = (
/obj/structure/interactive/stopsign{
	icon_state = "sign";
	dir = 1
	},
/turf/simulated/floor/sidewalk,
/area/dmm_suite/clear_area)
"q" = (
/obj/marker/map_node/x5,
/turf/simulated/floor/road,
/area/dmm_suite/clear_area)
"r" = (
/obj/decal/road_marking/solid_stop{
	icon_state = "1";
	dir = 1
	},
/turf/simulated/floor/road,
/area/dmm_suite/clear_area)
"s" = (
/obj/structure/interactive/lighting/roadlamp,
/turf/simulated/floor/sidewalk,
/area/dmm_suite/clear_area)
"t" = (
/obj/decal/road_marking/solid_cross,
/turf/simulated/floor/road,
/area/dmm_suite/clear_area)
"u" = (
/obj/structure/interactive/stopsign{
	icon_state = "sign";
	dir = 4
	},
/turf/simulated/floor/sidewalk,
/area/dmm_suite/clear_area)
"v" = (
/obj/decal/road_marking/solid_line{
	icon_state = "1";
	dir = 4
	},
/turf/simulated/floor/road,
/area/dmm_suite/clear_area)
"w" = (
/obj/decal/road_marking/solid_cross{
	icon_state = "1";
	dir = 4
	},
/turf/simulated/floor/road,
/area/dmm_suite/clear_area)
"x" = (
/obj/decal/road_marking/solid_stop{
	icon_state = "1";
	dir = 4
	},
/turf/simulated/floor/road,
/area/dmm_suite/clear_area)
"y" = (
/obj/marker/map_node/x5,
/obj/decal/road_marking/dotted_line/half{
	icon_state = "1";
	dir = 1
	},
/turf/simulated/floor/road,
/area/dmm_suite/clear_area)
"z" = (
/obj/decal/road_marking/dotted_line/half{
	icon_state = "1";
	dir = 4
	},
/turf/simulated/floor/road,
/area/dmm_suite/clear_area)
"A" = (
/obj/decal/road_marking/solid_stop{
	icon_state = "1";
	dir = 8
	},
/turf/simulated/floor/road,
/area/dmm_suite/clear_area)
"B" = (
/obj/structure/interactive/lighting/roadlamp{
	icon_state = "lamp";
	dir = 1
	},
/turf/simulated/floor/sidewalk,
/area/dmm_suite/clear_area)
"C" = (
/obj/structure/interactive/stopsign{
	icon_state = "sign";
	dir = 8
	},
/turf/simulated/floor/sidewalk,
/area/dmm_suite/clear_area)
"D" = (
/obj/decal/road_marking/solid_stop,
/turf/simulated/floor/road,
/area/dmm_suite/clear_area)
"E" = (
/obj/structure/interactive/stopsign,
/turf/simulated/floor/sidewalk,
/area/dmm_suite/clear_area)
"F" = (
/obj/decal/road_marking/dotted_line/half{
	icon_state = "1";
	dir = 8
	},
/turf/simulated/floor/road,
/area/dmm_suite/clear_area)
"G" = (
/obj/marker/prefab/city/parking{
	icon_state = "parking";
	dir = 10
	},
/turf/simulated/floor/sidewalk,
/area/dmm_suite/clear_area)
"J" = (
/obj/marker/map_node/x4,
/obj/decal/road_marking/dotted_line/half{
	icon_state = "1";
	dir = 4
	},
/turf/simulated/floor/road,
/area/dmm_suite/clear_area)
"K" = (
/obj/decal/road_marking/dotted_line/half,
/turf/simulated/floor/road,
/area/dmm_suite/clear_area)
"L" = (
/obj/marker/map_node/x4,
/obj/decal/road_marking/dotted_line/half,
/turf/simulated/floor/road,
/area/dmm_suite/clear_area)
"M" = (
/obj/decal/road_marking/dotted_line/half{
	icon_state = "1";
	dir = 1
	},
/turf/simulated/floor/road,
/area/dmm_suite/clear_area)
"N" = (
/obj/marker/map_node/x4,
/obj/decal/road_marking/dotted_line/half{
	icon_state = "1";
	dir = 1
	},
/turf/simulated/floor/road,
/area/dmm_suite/clear_area)

(1,1,1) = {"
a
a
a
a
a
a
a
a
a
a
a
a
a
a
a
a
a
a
a
a
a
a
a
a
a
a
a
a
b
v
d
K
M
d
v
b
a
a
a
a
a
a
a
a
i
a
a
a
a
a
a
a
a
a
a
a
a
a
a
a
a
a
a
a
"}
(2,1,1) = {"
a
a
a
a
a
a
a
a
a
a
a
a
a
a
a
a
a
a
a
a
a
a
a
a
a
a
a
a
b
v
d
K
M
d
v
b
a
a
a
a
a
a
a
a
a
g
g
g
g
g
g
g
g
g
g
g
g
g
g
g
g
g
a
a
"}
(3,1,1) = {"
a
a
a
a
a
a
a
a
a
a
a
g
g
g
g
g
g
g
g
g
g
g
g
g
g
g
g
g
b
v
d
K
M
d
v
b
a
a
a
a
a
a
a
a
a
a
a
a
a
a
a
a
a
a
a
a
a
a
a
a
o
g
a
a
"}
(4,1,1) = {"
a
a
a
a
a
a
a
a
a
a
a
g
a
a
a
a
a
a
a
a
a
a
a
a
a
a
a
l
b
v
d
K
M
d
v
b
a
a
a
a
a
a
a
a
a
a
a
a
a
a
a
a
a
a
a
a
a
a
a
a
a
g
a
a
"}
(5,1,1) = {"
a
a
a
a
a
a
a
a
a
a
a
g
a
a
a
a
a
a
a
a
a
a
a
a
a
a
a
a
b
v
d
K
y
d
v
b
a
a
a
a
a
a
a
a
a
a
a
a
a
a
a
a
a
a
a
a
a
a
a
a
a
g
a
a
"}
(6,1,1) = {"
a
a
a
a
a
a
a
a
a
a
a
g
a
a
a
a
a
a
a
a
a
a
a
a
a
a
a
a
b
v
d
K
M
d
v
b
a
a
a
a
a
a
a
a
a
a
a
a
a
a
a
a
a
a
a
a
a
a
a
a
a
g
a
a
"}
(7,1,1) = {"
a
a
a
a
a
a
a
a
a
a
a
g
a
a
a
a
a
a
a
a
a
a
a
a
a
a
a
a
b
v
d
K
M
d
v
b
a
a
a
a
a
a
a
a
a
a
a
a
a
a
a
a
a
a
a
a
a
a
a
a
a
g
a
a
"}
(8,1,1) = {"
a
a
a
a
a
a
a
a
a
a
a
g
a
a
a
a
a
a
a
a
a
a
a
a
a
a
a
a
b
v
d
K
M
d
v
b
a
a
a
a
a
a
a
a
a
a
a
a
a
a
a
a
a
a
a
a
a
a
a
a
a
g
a
a
"}
(9,1,1) = {"
a
a
a
a
a
a
a
a
a
a
a
g
a
a
a
a
a
a
a
a
a
a
a
a
a
a
a
a
b
v
d
K
M
d
v
b
a
a
a
a
a
a
a
a
a
a
a
a
a
a
a
a
a
a
a
a
a
a
a
a
a
g
a
a
"}
(10,1,1) = {"
a
a
a
a
a
a
a
a
a
a
a
g
a
a
a
a
a
a
a
a
a
a
a
a
a
a
a
a
b
v
d
K
M
d
v
b
a
a
a
a
a
a
a
a
a
a
a
a
a
a
a
a
a
a
a
a
a
a
a
a
a
g
a
a
"}
(11,1,1) = {"
a
a
a
a
a
a
a
a
a
a
a
g
a
a
a
a
a
a
a
a
a
a
a
a
a
a
a
a
b
v
d
K
M
d
v
b
a
a
a
a
a
a
a
a
j
a
a
a
a
a
a
a
a
a
a
a
a
a
a
a
a
g
a
a
"}
(12,1,1) = {"
a
a
a
a
a
a
a
a
a
a
a
g
a
a
a
a
a
a
a
a
a
a
a
a
a
a
a
a
b
v
d
K
M
d
v
B
a
a
a
a
a
a
a
a
a
a
a
a
a
a
a
a
a
a
a
a
a
a
a
a
a
g
a
a
"}
(13,1,1) = {"
a
a
a
a
a
a
a
a
a
a
a
g
a
a
a
a
a
a
a
a
a
a
a
a
a
a
a
a
b
v
d
K
M
d
v
b
a
a
a
a
a
a
a
a
a
a
a
a
a
a
a
a
a
a
a
a
a
a
a
a
a
g
a
a
"}
(14,1,1) = {"
a
a
a
a
a
a
a
a
a
a
a
g
a
a
a
a
a
a
a
a
a
a
a
a
a
a
a
a
b
v
d
K
y
d
v
b
a
a
a
a
a
a
a
a
a
a
a
a
a
a
a
a
a
a
a
a
a
a
a
a
a
g
a
a
"}
(15,1,1) = {"
a
a
a
a
a
a
a
a
a
a
a
g
a
a
a
a
a
a
a
a
a
a
a
a
a
a
a
a
b
v
d
K
M
d
v
b
a
a
a
a
a
a
a
a
a
a
a
a
a
a
a
a
a
a
a
a
a
a
a
a
a
g
a
a
"}
(16,1,1) = {"
a
a
a
a
a
a
a
a
a
a
a
g
a
a
a
a
a
a
a
a
a
a
a
a
a
a
a
a
b
v
d
K
M
d
v
b
a
a
a
a
a
a
a
a
a
a
a
a
a
a
a
a
a
a
a
a
a
a
a
a
a
g
a
a
"}
(17,1,1) = {"
a
a
a
a
a
a
a
a
a
a
a
g
a
a
a
a
a
a
a
a
a
a
a
a
a
a
a
a
b
v
d
K
M
d
v
b
a
a
a
a
a
a
a
a
a
a
a
a
a
a
a
a
a
a
a
a
a
a
a
a
a
g
a
a
"}
(18,1,1) = {"
a
a
a
a
a
a
a
a
a
a
a
g
a
a
a
a
a
a
a
a
a
a
a
a
a
a
a
a
b
v
d
K
M
d
v
b
a
a
a
a
a
a
a
a
a
a
a
a
a
a
a
a
a
a
a
a
a
a
a
a
a
g
a
a
"}
(19,1,1) = {"
a
a
a
a
a
a
a
a
a
a
a
g
a
a
a
a
a
a
a
a
a
a
a
a
a
a
a
a
b
v
d
K
M
d
v
b
a
a
a
a
a
a
a
a
a
g
g
g
g
g
g
g
g
g
g
g
g
g
g
g
g
g
a
a
"}
(20,1,1) = {"
a
a
a
a
a
a
a
a
a
a
a
a
a
a
a
a
a
a
a
h
a
a
a
a
a
a
a
a
f
v
d
K
M
d
v
b
a
a
a
a
a
a
a
a
a
a
a
a
a
a
a
a
a
a
a
a
a
a
a
a
a
a
a
a
"}
(21,1,1) = {"
a
a
a
a
a
a
a
a
a
a
a
a
a
a
a
a
a
a
a
a
a
a
a
a
a
a
a
a
b
v
d
K
M
d
v
b
a
a
a
a
a
a
a
a
a
a
a
a
a
a
a
a
a
a
a
a
a
a
a
a
a
a
a
a
"}
(22,1,1) = {"
a
a
a
a
a
a
a
a
a
a
a
a
a
a
a
a
a
a
a
a
a
a
a
a
a
a
a
a
b
v
d
K
N
d
v
b
a
a
a
a
a
a
a
a
a
a
a
a
a
a
a
a
a
a
a
a
a
a
a
a
a
a
a
a
"}
(23,1,1) = {"
a
a
a
a
a
a
a
a
a
a
a
a
a
a
a
a
a
a
a
a
a
a
a
a
a
a
a
a
b
v
d
K
M
d
v
b
a
a
a
a
a
a
a
a
a
a
a
a
a
a
a
a
a
a
a
a
a
a
a
a
a
a
a
a
"}
(24,1,1) = {"
a
a
a
a
a
a
a
a
a
a
a
a
a
a
a
a
a
a
a
a
a
a
a
a
a
a
a
a
b
v
d
K
M
d
v
b
a
a
a
a
a
a
a
a
a
a
a
a
a
a
a
a
a
a
a
a
a
a
a
a
a
a
a
a
"}
(25,1,1) = {"
a
a
a
a
a
a
a
a
a
a
a
a
a
a
a
a
a
a
a
a
a
a
a
a
a
a
a
a
b
v
d
K
M
d
v
b
a
a
a
a
a
a
a
a
a
a
a
a
a
a
a
a
a
a
a
a
a
a
a
a
a
a
a
a
"}
(26,1,1) = {"
a
a
a
a
a
a
a
a
a
a
a
a
a
a
a
a
a
a
a
a
a
a
a
a
a
a
a
a
b
v
d
K
M
d
v
b
a
a
a
a
a
a
a
a
a
a
a
a
a
a
a
a
a
a
a
a
a
a
a
a
a
a
a
a
"}
(27,1,1) = {"
a
a
a
a
a
a
a
a
a
a
a
a
a
a
a
a
a
a
a
a
a
a
a
a
a
a
a
a
b
v
d
K
N
d
v
C
a
a
a
a
a
a
a
a
a
a
a
a
a
a
a
a
a
a
a
a
a
a
a
a
a
a
a
a
"}
(28,1,1) = {"
a
a
a
a
a
a
a
a
a
a
a
a
a
a
a
a
a
a
a
a
a
a
a
a
a
a
a
a
b
v
d
d
A
A
A
B
a
a
a
a
a
a
a
a
a
a
a
a
a
a
a
a
a
a
a
a
a
a
a
a
a
a
a
a
"}
(29,1,1) = {"
b
b
b
b
b
b
b
b
b
b
b
k
b
b
b
b
b
b
b
b
b
b
b
b
b
b
p
k
b
w
w
w
w
w
w
b
b
b
b
b
b
b
b
b
b
k
b
b
b
b
b
b
b
b
b
b
b
b
b
b
b
b
b
b
"}
(30,1,1) = {"
c
c
c
c
c
c
c
c
c
c
c
c
c
c
c
c
c
c
c
c
c
c
c
c
c
c
c
r
t
d
d
d
d
d
d
t
c
c
c
c
c
c
c
c
c
c
c
c
c
c
c
c
c
c
c
c
c
c
c
c
c
c
c
c
"}
(31,1,1) = {"
d
d
d
d
d
d
d
d
d
d
d
d
d
d
d
d
d
d
d
d
d
d
d
d
d
d
d
r
t
d
d
d
d
d
d
t
d
d
d
d
d
d
d
d
d
d
d
d
d
d
d
d
d
d
d
d
d
d
d
d
d
d
d
d
"}
(32,1,1) = {"
z
z
z
J
z
z
z
z
z
z
J
z
z
z
z
z
z
J
z
z
z
z
z
z
J
z
z
r
t
d
d
d
q
d
d
t
d
z
z
z
J
z
z
z
z
z
z
J
z
z
z
z
z
z
J
z
z
z
z
z
J
z
z
z
"}
(33,1,1) = {"
F
F
F
F
F
F
F
F
F
F
F
F
F
F
F
F
F
F
F
F
F
F
F
F
F
F
F
d
t
d
d
d
d
d
d
t
D
F
F
F
F
F
F
F
F
F
F
F
F
F
F
F
F
F
F
F
F
F
F
F
F
F
F
F
"}
(34,1,1) = {"
d
d
d
d
d
d
d
d
d
d
d
d
d
d
d
d
d
d
d
d
d
d
d
d
d
d
d
d
t
d
d
d
d
d
d
t
D
d
d
d
d
d
d
d
d
d
d
d
d
d
d
d
d
d
d
d
d
d
d
d
d
d
d
d
"}
(35,1,1) = {"
c
c
c
c
c
c
c
c
c
c
c
c
c
c
c
c
c
c
c
c
c
c
c
c
c
c
c
c
t
d
d
d
d
d
d
t
D
c
c
c
c
c
c
c
c
c
c
c
c
c
c
c
c
c
c
d
d
d
d
d
d
c
c
c
"}
(36,1,1) = {"
b
b
b
b
b
b
b
b
b
b
b
b
b
b
b
b
b
b
b
n
b
b
b
b
b
b
b
b
b
w
w
w
w
w
w
b
n
E
b
b
b
b
b
b
b
b
b
b
b
b
b
b
b
n
b
d
d
d
d
d
d
b
b
b
"}
(37,1,1) = {"
a
a
a
a
a
a
a
a
a
g
g
g
g
g
g
g
g
g
g
g
g
g
g
g
g
g
g
g
s
x
x
x
d
d
v
b
g
g
g
g
g
g
g
g
g
g
g
g
g
g
g
g
g
g
b
d
d
d
d
d
d
b
a
a
"}
(38,1,1) = {"
a
a
a
a
a
a
a
a
a
g
a
a
a
a
a
a
a
a
a
a
a
a
a
a
a
e
g
g
u
v
d
K
M
d
v
b
g
a
a
a
a
a
a
a
a
a
a
a
a
a
a
a
e
g
b
d
d
d
d
d
d
b
a
a
"}
(39,1,1) = {"
a
a
a
a
a
a
a
a
a
g
a
a
a
a
a
a
a
a
a
a
a
a
a
a
a
a
g
g
b
v
d
K
M
d
v
b
g
a
a
a
a
a
a
a
a
a
a
a
a
a
a
a
a
g
b
d
d
d
d
d
d
b
a
a
"}
(40,1,1) = {"
a
a
a
a
a
a
a
a
a
g
a
a
a
a
a
a
a
a
a
a
a
a
a
a
a
a
g
g
b
v
d
L
M
d
v
b
g
a
a
a
a
a
a
a
a
a
a
a
a
a
a
a
a
g
b
d
d
d
d
d
d
b
a
a
"}
(41,1,1) = {"
a
a
a
a
a
a
a
a
a
g
a
a
a
a
a
a
a
a
a
a
a
a
a
a
a
a
g
g
b
v
d
K
M
d
v
b
g
a
a
a
a
a
a
a
a
a
a
a
a
a
a
a
a
g
b
d
d
d
d
d
d
b
a
a
"}
(42,1,1) = {"
a
a
a
a
a
a
a
a
a
g
a
a
a
a
a
a
a
a
a
a
a
a
a
a
a
a
g
g
b
v
d
K
M
d
v
b
g
a
a
a
a
a
a
a
a
a
a
a
a
a
a
a
a
g
b
d
d
d
d
d
d
b
a
a
"}
(43,1,1) = {"
a
a
a
a
a
a
a
a
a
g
a
a
a
a
a
a
a
a
a
a
a
a
a
a
a
a
g
g
b
v
d
K
M
d
v
b
g
a
a
a
a
a
a
a
a
a
a
a
a
a
a
a
a
g
b
d
d
d
d
d
d
b
a
a
"}
(44,1,1) = {"
a
a
a
a
a
a
a
a
a
g
a
a
a
a
a
a
a
a
a
a
a
a
a
a
a
a
g
g
b
v
d
K
M
d
v
b
g
a
a
a
a
a
a
a
a
a
a
a
a
a
a
a
a
g
b
d
d
d
d
d
d
b
a
a
"}
(45,1,1) = {"
a
a
a
a
a
a
a
a
a
g
a
a
a
a
a
a
a
a
a
a
a
a
a
a
a
a
g
g
b
v
d
K
M
d
v
b
g
a
a
a
a
a
a
a
a
a
a
a
a
a
a
a
a
g
b
d
d
d
d
d
d
b
a
a
"}
(46,1,1) = {"
a
a
a
a
a
a
a
a
a
g
a
a
a
a
a
a
a
a
a
a
a
a
a
a
a
a
g
g
b
v
d
K
M
d
v
B
g
a
a
a
a
a
a
a
a
a
a
a
a
a
a
a
a
g
b
d
d
d
d
d
d
b
a
a
"}
(47,1,1) = {"
a
a
a
a
a
a
a
a
a
g
a
a
a
a
a
a
a
a
a
a
a
a
a
a
a
a
g
g
b
v
d
L
M
d
v
b
g
a
a
a
a
a
a
a
a
a
a
a
a
a
a
a
a
g
b
d
d
d
d
d
d
b
a
a
"}
(48,1,1) = {"
a
a
a
a
a
a
a
a
a
g
a
a
a
a
a
a
a
a
a
a
a
a
a
a
a
a
g
g
b
v
d
K
M
d
v
b
g
a
a
a
a
a
a
a
a
a
a
a
a
a
a
a
a
g
b
d
d
d
d
d
d
b
a
a
"}
(49,1,1) = {"
a
a
a
a
a
a
a
a
a
g
a
a
a
a
a
a
a
a
a
a
a
a
a
a
a
a
g
g
b
v
d
K
M
d
v
b
g
a
a
a
a
a
a
a
a
a
a
a
a
a
a
a
a
g
b
d
d
d
d
d
d
b
a
a
"}
(50,1,1) = {"
a
a
a
a
a
a
a
a
a
g
a
a
a
a
a
a
a
a
a
a
a
a
a
a
a
a
g
g
b
v
d
K
M
d
v
b
g
a
a
a
a
a
a
a
a
a
a
a
a
a
a
a
a
g
b
d
d
d
d
d
d
b
a
a
"}
(51,1,1) = {"
a
a
a
a
a
a
a
a
a
g
a
a
a
a
a
a
a
a
a
a
a
a
a
a
a
a
g
g
b
v
d
K
M
d
v
b
g
a
a
a
a
a
a
a
a
a
a
a
a
a
a
a
a
g
b
d
d
d
d
d
d
b
a
a
"}
(52,1,1) = {"
a
a
a
a
a
a
a
a
a
g
a
a
a
a
a
a
a
a
a
a
a
a
a
a
a
a
g
g
b
v
d
K
M
d
v
b
g
a
a
a
a
a
a
a
a
a
a
a
a
a
a
a
a
g
b
d
d
d
d
d
d
b
a
a
"}
(53,1,1) = {"
a
a
a
a
a
a
a
a
a
g
a
a
a
a
a
a
a
a
a
a
a
a
a
a
a
a
g
g
b
v
d
K
M
d
v
b
g
a
a
a
a
a
a
a
a
a
a
a
a
a
a
a
a
g
b
d
d
d
d
d
d
b
a
a
"}
(54,1,1) = {"
a
a
a
a
a
a
a
a
a
g
g
g
g
g
g
g
g
g
g
g
g
g
g
g
g
g
g
g
s
v
d
L
M
d
v
b
g
g
g
g
g
g
g
g
g
g
g
g
g
g
g
g
g
g
b
d
d
d
d
d
d
b
a
a
"}
(55,1,1) = {"
a
a
a
a
a
a
a
a
a
a
a
a
a
a
a
a
a
a
a
a
a
a
a
a
a
a
a
a
G
v
d
K
M
d
v
b
a
a
a
a
a
a
a
a
m
a
a
a
a
a
a
a
a
m
a
a
a
a
a
a
a
a
j
a
"}
(56,1,1) = {"
a
a
a
a
a
a
a
a
a
a
a
a
a
a
a
a
a
a
a
a
a
a
a
a
a
a
a
a
b
v
d
K
M
d
v
b
a
a
a
a
a
a
a
a
a
a
a
a
a
a
a
a
a
a
a
a
a
a
a
a
a
a
a
a
"}
(57,1,1) = {"
a
a
a
a
a
a
a
a
a
a
a
a
a
a
a
a
a
a
a
a
a
a
a
a
a
a
a
a
b
v
d
K
M
d
v
b
a
a
a
a
a
a
a
a
a
a
a
a
a
a
a
a
a
a
a
a
a
a
a
a
a
a
a
a
"}
(58,1,1) = {"
a
a
a
a
a
a
a
a
a
a
a
a
a
a
a
a
a
a
a
a
a
a
a
a
a
a
a
a
b
v
d
K
M
d
v
b
a
a
a
a
a
a
a
a
a
a
a
a
a
a
a
a
a
a
a
a
a
a
a
a
a
a
a
a
"}
(59,1,1) = {"
a
a
a
a
a
a
a
a
a
a
a
a
a
a
a
a
a
a
a
a
a
a
a
a
a
a
a
a
b
v
d
K
M
d
v
b
a
a
a
a
a
a
a
a
a
a
a
a
a
a
a
a
a
a
a
a
a
a
a
a
a
a
a
a
"}
(60,1,1) = {"
a
a
a
a
a
a
a
a
a
a
a
a
a
a
a
a
a
a
a
a
a
a
a
a
a
a
a
a
b
v
d
K
M
d
v
b
a
a
a
a
a
a
a
a
a
a
a
a
a
a
a
a
a
a
a
a
a
a
a
a
a
a
a
a
"}
(61,1,1) = {"
a
a
a
a
a
a
a
a
a
a
a
a
a
a
a
a
a
a
a
a
a
a
a
a
a
a
a
a
b
v
d
L
M
d
v
b
a
a
a
a
a
a
a
a
a
a
a
a
a
a
a
a
a
a
a
a
a
a
a
a
a
a
a
a
"}
(62,1,1) = {"
a
a
a
a
a
a
a
a
a
a
a
a
a
a
a
a
a
a
a
a
a
a
a
a
a
a
a
a
b
v
d
K
M
d
v
b
a
a
a
a
a
a
a
a
a
a
a
a
a
a
a
a
a
a
a
a
a
a
a
a
a
a
a
a
"}
(63,1,1) = {"
a
a
a
a
a
a
a
a
a
a
a
a
a
a
a
a
a
a
a
a
a
a
a
a
a
a
a
a
b
v
d
K
M
d
v
b
a
a
a
a
a
a
a
a
a
a
a
a
a
a
a
a
a
a
a
a
a
a
a
a
a
a
a
a
"}
(64,1,1) = {"
a
a
a
a
a
a
a
a
a
a
a
a
a
a
a
a
a
a
a
a
a
a
a
a
a
a
a
a
b
v
d
K
M
d
v
b
a
a
a
a
a
a
a
a
a
a
a
a
a
a
a
a
a
a
a
a
a
a
a
a
a
a
a
a
"}
