"a" = (/turf/dmm_suite/clear_turf,/area/dmm_suite/clear_area)
"b" = (/turf/simulated/floor/sidewalk,/area/dmm_suite/clear_area)
"c" = (/obj/decal/road_marking/solid_line,/turf/simulated/floor/road,/area/dmm_suite/clear_area)
"d" = (/turf/simulated/floor/road,/area/dmm_suite/clear_area)
"e" = (/obj/marker/prefab/city/store{icon_state = ""; dir = 4},/turf/dmm_suite/clear_turf,/area/dmm_suite/clear_area)
"f" = (/turf/simulated/wall/brick/red,/area/dmm_suite/clear_area)
"g" = (/turf/dmm_suite/no_wall,/area/dmm_suite/clear_area)
"h" = (/obj/marker/prefab/yard,/turf/dmm_suite/clear_turf,/area/dmm_suite/clear_area)
"i" = (/obj/structure/interactive/lighting/roadlamp{icon_state = "lamp"; dir = 4},/turf/simulated/floor/sidewalk,/area/dmm_suite/clear_area)
"j" = (/obj/marker/prefab/alley_end,/turf/dmm_suite/clear_turf,/area/dmm_suite/clear_area)
"k" = (/obj/marker/prefab/city/store,/turf/dmm_suite/clear_turf,/area/dmm_suite/clear_area)
"l" = (/obj/marker/prefab/city/store{icon_state = ""; dir = 1},/turf/dmm_suite/clear_turf,/area/dmm_suite/clear_area)
"m" = (/obj/structure/interactive/lighting/roadlamp{icon_state = "lamp"; dir = 8},/turf/simulated/floor/sidewalk,/area/dmm_suite/clear_area)
"n" = (/obj/marker/prefab/alley,/turf/dmm_suite/clear_turf,/area/dmm_suite/clear_area)
"o" = (/obj/structure/interactive/stopsign{icon_state = "sign"; dir = 1},/turf/simulated/floor/sidewalk,/area/dmm_suite/clear_area)
"p" = (/obj/marker/prefab/alley{icon_state = "alley"; dir = 6},/turf/dmm_suite/clear_turf,/area/dmm_suite/clear_area)
"q" = (/obj/marker/prefab/alley{icon_state = "alley"; dir = 4},/turf/dmm_suite/clear_turf,/area/dmm_suite/clear_area)
"r" = (/obj/marker/prefab/alley{icon_state = "alley"; dir = 10},/turf/dmm_suite/clear_turf,/area/dmm_suite/clear_area)
"s" = (/obj/decal/road_marking/solid_stop{icon_state = "1"; dir = 1},/turf/simulated/floor/road,/area/dmm_suite/clear_area)
"t" = (/obj/structure/interactive/lighting/roadlamp,/turf/simulated/floor/sidewalk,/area/dmm_suite/clear_area)
"u" = (/obj/decal/road_marking/solid_cross,/turf/simulated/floor/road,/area/dmm_suite/clear_area)
"v" = (/obj/structure/interactive/stopsign{icon_state = "sign"; dir = 4},/turf/simulated/floor/sidewalk,/area/dmm_suite/clear_area)
"w" = (/obj/decal/road_marking/solid_line{icon_state = "1"; dir = 4},/turf/simulated/floor/road,/area/dmm_suite/clear_area)
"x" = (/obj/decal/road_marking/solid_cross{icon_state = "1"; dir = 4},/turf/simulated/floor/road,/area/dmm_suite/clear_area)
"y" = (/obj/decal/road_marking/solid_stop{icon_state = "1"; dir = 4},/turf/simulated/floor/road,/area/dmm_suite/clear_area)
"z" = (/obj/marker/map_node/x4,/turf/simulated/floor/road,/area/dmm_suite/clear_area)
"A" = (/obj/marker/map_node/x5,/turf/simulated/floor/road,/area/dmm_suite/clear_area)
"B" = (/obj/decal/road_marking/solid_stop{icon_state = "1"; dir = 8},/turf/simulated/floor/road,/area/dmm_suite/clear_area)
"C" = (/obj/structure/interactive/lighting/roadlamp{icon_state = "lamp"; dir = 1},/turf/simulated/floor/sidewalk,/area/dmm_suite/clear_area)
"D" = (/obj/structure/interactive/stopsign{icon_state = "sign"; dir = 8},/turf/simulated/floor/sidewalk,/area/dmm_suite/clear_area)
"E" = (/obj/decal/road_marking/solid_stop,/turf/simulated/floor/road,/area/dmm_suite/clear_area)
"F" = (/obj/structure/interactive/stopsign,/turf/simulated/floor/sidewalk,/area/dmm_suite/clear_area)
"G" = (/obj/decal/road_marking/dotted_line/half{icon_state = "1"; dir = 8},/turf/simulated/floor/road,/area/dmm_suite/clear_area)
"H" = (/obj/decal/road_marking/solid_line{icon_state = "1"; dir = 6},/turf/simulated/floor/road,/area/dmm_suite/clear_area)
"I" = (/obj/decal/road_marking/solid_line{icon_state = "1"; dir = 9},/turf/simulated/floor/road,/area/dmm_suite/clear_area)
"J" = (/obj/marker/prefab/alley_end{icon_state = "alley_end"; dir = 4},/turf/dmm_suite/clear_turf,/area/dmm_suite/clear_area)
"K" = (/obj/marker/map_node/x5,/obj/decal/road_marking/dotted_line/half{icon_state = "1"; dir = 8},/turf/simulated/floor/road,/area/dmm_suite/clear_area)
"L" = (/obj/decal/road_marking/dotted_line/half{icon_state = "1"; dir = 4},/turf/simulated/floor/road,/area/dmm_suite/clear_area)
"M" = (/obj/decal/road_marking/dotted_line/half,/turf/simulated/floor/road,/area/dmm_suite/clear_area)
"N" = (/obj/decal/road_marking/dotted_line/half{icon_state = "1"; dir = 1},/turf/simulated/floor/road,/area/dmm_suite/clear_area)
"O" = (/obj/marker/map_node/x5,/obj/decal/road_marking/dotted_line/half{icon_state = "1"; dir = 1},/turf/simulated/floor/road,/area/dmm_suite/clear_area)

(1,1,1) = {"
aaaaaaaaaaaaaaaaaaaaaaaaaaaabcdLGdcbaaaaaaaaaaaaaaaaaaaaaaaaaaaa
aaaffffffffffgggggggggggggggbcdLGdcbaaaaaaaaaaaaaaaaaaaaaaaaaaaa
aaafaaaaaaaaaaaaaaaaaaaaaaaabcdLGdcbaaaaaaaaaaaaaaaaaaaaaaaaaaaa
aaafaaaaaaaaaaaaaaaaaaaaaaaabcdLGdcbafffffffffffffffffffaaaaaaaa
aaafaaaaaaaaaaaaaaaaaaaaaaaabcdLKdcbaaaaaaaaaaaaaaaaaaaaaaaaaaaa
aaafaaaaaaaaaaaaaaaaaaaaaaaabcdLGdcbaaaaaaaaaaaaaaaaaaaaaaaaaaaa
aaafaaaaaaaaaaaaaaaaaaaaaaaabcdLGdcbaaaaaaaaaaaaaaaaaaaaaaaaaaaa
aaafaaaaaaaaaaaaaaaaaaaaaaaabcdLGdcbaaaaaaaaaaaaaaaaaaaaaaaaaaaa
aaafaaaaaaaaaaaaaaaaaaaaaaaabcdLGdcbaaaaaaaaaaaaaaaaaaaaaaaaaaaa
aaafhaaaaaaaaaaaaaaaaaaaaaaabcdLGdcbaaaaaaaaaaaaaaaaaaaaaaaaaaaa
aaafaaaaaaaaaaaaaaaaaaaaaaaabcdLGdcbaaaaaaaaaaaaaaaaaaaaaaaaaaaa
aaafaaaaaaaaaaaaaaaaaaaaaaaaicdLGdcbahaaaaaaahaaaaaaagajaaaaaaaa
aaafaaaaaaaaaaaaaaaaaaaaaaaabcdLGdcbaaaaaaaaaaaaaaaaagaaaaaaaaaa
aaafaaaaaaaaaaaaaaaaaaaaaaaabcdLGdcbaaaaaaaaaaaaaaaaagaaaaaaaaaa
aaafaaaaaaaaaaaaaaaaaaaaaaaabcdLKdcbaaaaaaaaaaaaaaaaagaaaaaaaaaa
aaafaaaaaaaaaaaaaaaaaaaaaaaabcdLGdcbaaaaaaaaaaaaaaaaagaaaaaaaaaa
aaafaaaaaaaaaaaaaaaaaaaaaaaabcdLGdcbaaaaaaaaaaaaaaaaagaaaaaaaaaa
aaafhaaaaaaaeaaaaaaaaaaaaaaabcdLGdcbaaaaaaaaaaaaaaaaagaaaaaaaaaa
aaaffaaaaaaaggggggggggggggggbcdLGdcbaaaaaaaaaaaaaaaaagaaaaaaaaaa
aaaafaaaaaaaaaaaaaaaaaaaaaaabcdLGdcmaaaaaaaaaaaaaaaaaganaaaaaaaa
aaaaaaaaaaaaaaaaaaaaaaaaaaaabcdLGdcbaaaaaaaaaaaaaaaaagaaaaaaaaaa
aaaaaaaaaaaaaaaaaaaaaaaaaaaabcdLGdcbaaaaaaaaaaaaaaaaagaaaaaaaaaa
aaaaaaaaaaaaaaaaaaaaaaaaaaaabcdLGdcbaaaaaaaaaaaaaaaaagaaaaaaaaaa
aaaaaaaaaaaaaaaaaaaaaaaaaaaabcdLKdcbaaaaaaaaaaaaaaaaagaaaaaaaaaa
aaaaaaaaaaaaaaaaaaaaaaaaaaaabcdLGdcbaaaaaaaaaaaaaaaaagaaaaaaaaaa
aaaaaaaaaaaaaaaaaaaaaaaaaaaabcdLGdcbaaaaaaaaaaaaaaaaagaaaaaaaaaa
aaaaaaaaaaaaaaaaaaaaaaaaaaaaocdLGdcbaaaaaaaaaaaaaaaaagaaaaaaaaaa
aaaapaaaaaaaqaaaaaaaraaaaaaaisssddcbakaaaaaaaaaaaaaaaganaaaaaaaa
bbbbbbbbbbbbbbbbbbbtbbbbbbbbbuuuuuubbtvbbbbbbbbbbbbbbtbbbbbbbbbb
wwwwwwwwwwwwwwwwwwwwwwwwwwwwxddddddxywwwwwwwwwwwwwwwwwwwwwwwwwww
ddddddddddddddddddddddddddddxddddddxyddddddddddddddddddddddddddd
MMMMMMMMMMMMMMMMMMMMMMMMMMMdxddddddxyMMMMMMMMMMMMMMMMMMMMMMMMMMM
NNNNNNNONNNNNONNNNNNNNONNNNBxddAdddxdNNNONNNNNNNNONNNNNNNNOONNNN
dddddddddddddddddddddddddddBxddddddxdddddddddddddddddddddddddddd
wwwwwwwwwwwwwwwwwwwwwwwwwwwBxddddddxwwwwwwwwwwwwwwwwwwwwddddddww
bbbbbbbbbbbCbbbbbbbbbbbbbbDCbbbbbbbbbbbbbbbbbCbbbbbbbbbbuuuuuubb
aaaaaaaaaaaaaaaaaaaaaaaaaaaaaaaaaaaaaaaaaaaaaaaaaaaaaaabcddEEEma
aaafffffffffaaaaaaaaaaaaaaaagaaaaaaaagaaaaaaaaaaaaaaaaabcddddcFa
aaafaaaaaaaaaaaaaaaaaaaaaaaagaaaaaaaagaaaaaaaaaaaaaaaaabcddddcba
aaafaaaaaaaaaaaaaaaaaaaaaaaagaaaaaaaagaaaaaaaaaaaaaaaaabcddddcba
aaafaaaaaaaaaaaaaaaaaaaaaaaagaaaaaaaagaaaaaaaaaaaaaaaaabcdAddcba
aaafaaaaaaaaaaaaaaaaaaaaaaaagaaaaaaaagaaaaaaaaaaaaaaaaabcddddcba
aaafaaaaaaaaaaaaaaaaaaaaaaaagaaaaaaaagaaaaaaaaaaaaaaaaabcddddcba
aaafaaaaaaaaaaaaaaaaaaaaaaaagaaaaaaaagaaaaaaaaaaaaaaaaabcddddcba
aaafaaaaaaaaaaaaaaaaaaaaaaaagnaaaaaaagaaaaaaaaaaaaaaaaabcddddcba
aaafhaaaaaaaaaaaaaaaaaaaaaaagaaaaaaaagaaaaaaaaaaaaaaaaaicddddcba
aaafaaaaaaaaaaaaaaaaaaaaaaaagaaaaaaaagaaaaaaaaaaaaaaaaabcddddcba
aaafaaaaaaaaaaaaaaaaaaaaaaaagaaaaaaaagaaaaaaaaaaaaaaaaabcddddcba
aaafaaaaaaaaaaaaaaaaaaaaaaaagaaaaaaaagaaaaaaaaaaaaaaaaabcddddcba
aaafaaaaaaaaaaaaaaaaaaaaaaaagaaaaaaaagaaaaaaaaaaaaaaaaabcdAddcba
aaafaaaaaaaaaaaaaaaaaaaaaaaagaaaaaaaagaaaaaaaaaaaaaaaaabcddddcba
aaafaaaaaaaaaaaaaaaaaaaaaaaagaaaaaaaagaaaaaaaaaaaaaaaaabcddddcba
aaafaaaaaaaalaaaaaaaaaaaaaaagnaaaaaaaglaaaaaaaaaaaaaaaabcddddcba
aaafhaaaaaaaggggggggggggggggbbbbbbbbbbbbbbbbbbbbbbbbbbbbcddddcba
aaafaaaaaaaaaaaaaaaaaaaaaaaabHwwwwwwwwwwwwwwwwwwwwwwwwwwIddddcba
aaafaaaaaaaaaaaaaaaaaaaaaaaabcdddddddddddddddddddddddddddddddcba
aaafaaaaaaaaaaaaaaaaaaaaaaaabcdddddddddddddddddddddddddddddddcba
aaafaaaaaaaaaaaaaaaaaaaaaaaabcddzddddddzddddddzddddddzdddddzdcba
aaafaaaaaaaaaaaaaaaaaaaaaaaabcdddddddddddddddddddddddddddddddcba
aaafaaaaaaaaaaaaaaaaaaaaaaaabcddddHwwwwwwwwwwwwwwwwwwwwwwwwwwIba
aaafaaaaaaaaaaaaaaaaaaaaaaaabcddddcbbbbbbbbbbbbbbbbbbbbbbbbbbbba
aaafhaaaaaaahaaaaaaaJaaaaaaabcddzdcbaaaaaaaaaaaaaaaaaaaaaaaaaaaa
aaaffffffffffffffffffaaaaaaabcddddcbaaaaaaaaaaaaaaaaaaaaaaaaaaaa
aaaaaaaaaaaaaaaaaaaaaaaaaaaabcddddcbaaaaaaaaaaaaaaaaaaaaaaaaaaaa
"}
