"a" = (/turf/dmm_suite/clear_turf,/area/dmm_suite/clear_area)
"b" = (/turf/simulated/floor/sidewalk,/area/dmm_suite/clear_area)
"c" = (/obj/decal/road_marking/solid_line,/turf/simulated/floor/road,/area/dmm_suite/clear_area)
"d" = (/turf/simulated/floor/road,/area/dmm_suite/clear_area)
"e" = (/obj/marker/prefab/city/store{icon_state = "";dir = 8},/turf/dmm_suite/clear_turf,/area/dmm_suite/clear_area)
"f" = (/obj/marker/prefab/city/parking,/turf/simulated/floor/sidewalk,/area/dmm_suite/clear_area)
"g" = (/turf/dmm_suite/no_wall,/area/dmm_suite/clear_area)
"h" = (/obj/marker/prefab/city/parking{icon_state = "parking";dir = 6},/turf/dmm_suite/clear_turf,/area/dmm_suite/clear_area)
"i" = (/obj/marker/prefab/city/parking{icon_state = "parking";dir = 5},/turf/dmm_suite/clear_turf,/area/dmm_suite/clear_area)
"j" = (/obj/marker/prefab/city/parking{icon_state = "parking";dir = 9},/turf/dmm_suite/clear_turf,/area/dmm_suite/clear_area)
"k" = (/obj/structure/interactive/lighting/roadlamp{icon_state = "lamp";dir = 4},/turf/simulated/floor/sidewalk,/area/dmm_suite/clear_area)
"l" = (/obj/marker/prefab/city/store{icon_state = "";dir = 4},/turf/dmm_suite/clear_turf,/area/dmm_suite/clear_area)
"m" = (/obj/marker/prefab/city/parking,/turf/dmm_suite/clear_turf,/area/dmm_suite/clear_area)
"n" = (/obj/structure/interactive/lighting/roadlamp{icon_state = "lamp";dir = 8},/turf/simulated/floor/sidewalk,/area/dmm_suite/clear_area)
"o" = (/obj/marker/prefab/city/store{icon_state = "";dir = 1},/turf/dmm_suite/clear_turf,/area/dmm_suite/clear_area)
"p" = (/obj/structure/interactive/stopsign{icon_state = "sign";dir = 1},/turf/simulated/floor/sidewalk,/area/dmm_suite/clear_area)
"q" = (/obj/marker/map_node/x5,/turf/simulated/floor/road,/area/dmm_suite/clear_area)
"r" = (/obj/decal/road_marking/solid_stop{icon_state = "1";dir = 1},/turf/simulated/floor/road,/area/dmm_suite/clear_area)
"s" = (/obj/structure/interactive/lighting/roadlamp,/turf/simulated/floor/sidewalk,/area/dmm_suite/clear_area)
"t" = (/obj/decal/road_marking/solid_cross,/turf/simulated/floor/road,/area/dmm_suite/clear_area)
"u" = (/obj/structure/interactive/stopsign{icon_state = "sign";dir = 4},/turf/simulated/floor/sidewalk,/area/dmm_suite/clear_area)
"v" = (/obj/decal/road_marking/solid_line{icon_state = "1";dir = 4},/turf/simulated/floor/road,/area/dmm_suite/clear_area)
"w" = (/obj/decal/road_marking/solid_cross{icon_state = "1";dir = 4},/turf/simulated/floor/road,/area/dmm_suite/clear_area)
"x" = (/obj/decal/road_marking/solid_stop{icon_state = "1";dir = 4},/turf/simulated/floor/road,/area/dmm_suite/clear_area)
"y" = (/obj/marker/map_node/x5,/obj/decal/road_marking/dotted_line/half{icon_state = "1";dir = 1},/turf/simulated/floor/road,/area/dmm_suite/clear_area)
"z" = (/obj/decal/road_marking/dotted_line/half{icon_state = "1";dir = 4},/turf/simulated/floor/road,/area/dmm_suite/clear_area)
"A" = (/obj/decal/road_marking/solid_stop{icon_state = "1";dir = 8},/turf/simulated/floor/road,/area/dmm_suite/clear_area)
"B" = (/obj/structure/interactive/lighting/roadlamp{icon_state = "lamp";dir = 1},/turf/simulated/floor/sidewalk,/area/dmm_suite/clear_area)
"C" = (/obj/structure/interactive/stopsign{icon_state = "sign";dir = 8},/turf/simulated/floor/sidewalk,/area/dmm_suite/clear_area)
"D" = (/obj/decal/road_marking/solid_stop,/turf/simulated/floor/road,/area/dmm_suite/clear_area)
"E" = (/obj/structure/interactive/stopsign,/turf/simulated/floor/sidewalk,/area/dmm_suite/clear_area)
"F" = (/obj/decal/road_marking/dotted_line/half{icon_state = "1";dir = 8},/turf/simulated/floor/road,/area/dmm_suite/clear_area)
"G" = (/obj/marker/prefab/city/parking{icon_state = "parking";dir = 10},/turf/simulated/floor/sidewalk,/area/dmm_suite/clear_area)
"J" = (/obj/marker/map_node/x4,/obj/decal/road_marking/dotted_line/half{icon_state = "1";dir = 4},/turf/simulated/floor/road,/area/dmm_suite/clear_area)
"K" = (/obj/decal/road_marking/dotted_line/half,/turf/simulated/floor/road,/area/dmm_suite/clear_area)
"L" = (/obj/marker/map_node/x4,/obj/decal/road_marking/dotted_line/half,/turf/simulated/floor/road,/area/dmm_suite/clear_area)
"M" = (/obj/decal/road_marking/dotted_line/half{icon_state = "1";dir = 1},/turf/simulated/floor/road,/area/dmm_suite/clear_area)
"N" = (/obj/marker/map_node/x4,/obj/decal/road_marking/dotted_line/half{icon_state = "1";dir = 1},/turf/simulated/floor/road,/area/dmm_suite/clear_area)

(1,1,1) = {"
aaaaaaaaaaaaaaaaaaaaaaaaaaaabcdzFdcbaaaaaaaaaaaaaaaaaaaaaaaaaaaa
aaaaaaaaaaaaaaaaaaaaaaaaaaaabcdzFdcbaaaaaaaaaaaaaaaaaaaaaaaaaaaa
aaaaaaaaaaaaaaaaaaaaaaaaaaaabcdzFdcbaaaaaaaaaaaaaaaaaaaaaaaaaaaa
aaaaaaaaaaaaaaaaaaaaaaaaaaaabcdJFdcbaaaaaaaaaaaaaaaaaaaaaaaaaaaa
aaaaaaaaaaaaaaaaaaaaaaaaaaaabcdzFdcbaaaaaaaaaaaaaaaaaaaaaaaaaaaa
aaaaaaaaaaaaaaaaaaaaaaaaaaaabcdzFdcbaaaaaaaaaaaaaaaaaaaaaaaaaaaa
aaaaaaaaaaaaaaaaaaaaaaaaaaaabcdzFdcbaaaaaaaaaaaaaaaaaaaaaaaaaaaa
aaaaaaaaaaaaaaaaaaaaaaaaaaaabcdzFdcbaaaaaaaaaaaaaaaaaaaaaaaaaaaa
aaaaaaaaaaaaaaaaaaaaaaaaaaaabcdzFdcbaaaaaaaaaaaaaaaaaaaaaaaaaaaa
aaaaaaaaaaaaaaaaaaaaaaaaaaaabcdzFdcbggggggggggggggggggaaaaaaaaaa
aaaaaaaaaaaaaaaaaaaaaaaaaaaabcdJFdcbgaaaaaaaaaaaaaaaagaaaaaaaaaa
aagggggggggggggggggaaaaaaaaakcdzFdcbgaaaaaaaaaaaaaaaagaaaaaaaaaa
aagaaaaaaaaaaaaaaaaaaaaaaaaabcdzFdcbgaaaaaaaaaaaaaaaagaaaaaaaaaa
aagaaaaaaaaaaaaaaaaaaaaaaaaabcdzFdcbgaaaaaaaaaaaaaaaagaaaaaaaaaa
aagaaaaaaaaaaaaaaaaaaaaaaaaabcdzFdcbgaaaaaaaaaaaaaaaagaaaaaaaaaa
aagaaaaaaaaaaaaaaaaaaaaaaaaabcdzFdcbgaaaaaaaaaaaaaaaagaaaaaaaaaa
aagaaaaaaaaaaaaaaaaaaaaaaaaabcdzFdcbgaaaaaaaaaaaaaaaagaaaaaaaaaa
aagaaaaaaaaaaaaaaaaaaaaaaaaabcdJFdcbgaaaaaaaaaaaaaaaagaaaaaaaaaa
aagaaaaaaaaaaaaaaaaaaaaaaaaabcdzFdcbgaaaaaaaaaaaaaaaagaaaaaaaaaa
aagaaaaaaaaaaaaaaaahaaaaaaaabcdzFdcngaaaaaaaaaaaaaaaagaaaaaaaaaa
aagaaaaaaaaaaaaaaaaaaaaaaaaabcdzFdcbgaaaaaaaaaaaaaaaagaaaaaaaaaa
aagaaaaaaaaaaaaaaaaaaaaaaaaabcdzFdcbgaaaaaaaaaaaaaaaagaaaaaaaaaa
aagaaaaaaaaaaaaaaaaaaaaaaaaabcdzFdcbgaaaaaaaaaaaaaaaagaaaaaaaaaa
aagaaaaaaaaaaaaaaaaaaaaaaaaabcdzFdcbgaaaaaaaaaaaaaaaagaaaaaaaaaa
aagaaaaaaaaaaaaaaaaaaaaaaaaabcdJFdcbgaaaaaaaaaaaaaaaagaaaaaaaaaa
aagaaaaaaaaaaaaaaaaaaaaaaaaabcdzFdcbgeaaaaaaaaaaaaaaagaaaaaaaaaa
aagaaaaaaaaaaaaaaaaaaaaaaaaapcdzFdcbggggggggggggggggggaaaaaaaaaa
aaglaaaaaaaaaaaaaaaaaaaaaaaakrrrddcbggggggggggggggggggaaaaaaaaaa
bbbbbbbbbbbbbbbbbbbfbbbbbbbbbttttttbsubbbbbbbbbbbbbbbsGbbbbbbbbb
vvvvvvvvvvvvvvvvvvvvvvvvvvvvwddddddwxvvvvvvvvvvvvvvvvvvvvvvvvvvv
ddddddddddddddddddddddddddddwddddddwxddddddddddddddddddddddddddd
KKKKKKKKKKKKKKKKKKKKKKKKKKKdwddddddwxKKLKKKKKKLKKKKKKLKKKKKKLKKK
MMMMyMMMMMMMMyMMMMMMMNMMMMNAwddqdddwdMMMMMMMMMMMMMMMMMMMMMMMMMMM
dddddddddddddddddddddddddddAwddddddwdddddddddddddddddddddddddddd
vvvvvvvvvvvvvvvvvvvvvvvvvvvAwddddddwvvvvvvvvvvvvvvvvvvvvvvvvvvvv
bbbbbbbbbbbBbbbbbbbbbbbbbbCBbttttttbbbbbbbbbbBbbbbbbbbbbbbbbbbbb
aaaaaaaaaaaaaaaaaaaaaaaaaaaabcddDDDnggggggggggggggggggaaaaaaaaaa
aaaaaaaaaaaaaaaaaaaaaaaaaaaabcdzFdcEgaaaaaaaaaaaaaaaagaaaaaaaaaa
aaaaaaaaaaaaaaaaaaaaaaaaaaaabcdzFdcbgaaaaaaaaaaaaaaaagaaaaaaaaaa
aaaaaaaaaaaaaaaaaaaaaaaaaaaabcdzFdcbgaaaaaaaaaaaaaaaagaaaaaaaaaa
aaaaaaaaaaaaaaaaaaaaaaaaaaaabcdJFdcbgaaaaaaaaaaaaaaaagaaaaaaaaaa
aaaaaaaaaaaaaaaaaaaaaaaaaaaabcdzFdcbgaaaaaaaaaaaaaaaagaaaaaaaaaa
aaaaaaaaaaaaaaaaaaaaaaaaaaaabcdzFdcbgaaaaaaaaaaaaaaaagaaaaaaaaaa
aaaaaaaaaaaaaaaaaaaaaaaaaaaabcdzFdcbgaaaaaaaaaaaaaaaagaaaaaaaaaa
iaaaaaaaaajaaaaaaaaaaaaaaaaabcdzFdcbgaaaaaaaaaaaaaaaagmaaaaaaaaa
agaaaaaaaaaaaaaaaagaaaaaaaaakcdzFdcbgaaaaaaaaaaaaaaaagaaaaaaaaaa
agaaaaaaaaaaaaaaaagaaaaaaaaabcdzFdcbgaaaaaaaaaaaaaaaagaaaaaaaaaa
agaaaaaaaaaaaaaaaagaaaaaaaaabcdJFdcbgaaaaaaaaaaaaaaaagaaaaaaaaaa
agaaaaaaaaaaaaaaaagaaaaaaaaabcdzFdcbgaaaaaaaaaaaaaaaagaaaaaaaaaa
agaaaaaaaaaaaaaaaagaaaaaaaaabcdzFdcbgaaaaaaaaaaaaaaaagaaaaaaaaaa
agaaaaaaaaaaaaaaaagaaaaaaaaabcdzFdcbgaaaaaaaaaaaaaaaagaaaaaaaaaa
agaaaaaaaaaaaaaaaagaaaaaaaaabcdzFdcbgaaaaaaaaaaaaaaaagaaaaaaaaaa
agaaaaaaaaaaaaaaaagaaaaaaaaabcdzFdcbgeaaaaaaaaaaaaaaagaaaaaaaaaa
agaaaaaaaaaaaaaaaagaaaaaaaaabcdzFdcnggggggggggggggggggmaaaaaaaaa
agaaaaaaaaaaaaaaaagaaaaaaaaabcdJFdcbbbbbbbbbbbbbbbbbbbaaaaaaaaaa
agaaaaaaaaaaaaaaaagaaaaaaaaabcdzFdddddddddddddddddddddaaaaaaaaaa
agaaaaaaaaaaaaaaaagaaaaaaaaabcdzFdddddddddddddddddddddaaaaaaaaaa
agaaaaaaaaaaaaaaaagaaaaaaaaabcdzFdddddddddddddddddddddaaaaaaaaaa
agaaaaaaaaaaaaaaaagaaaaaaaaabcdzFdddddddddddddddddddddaaaaaaaaaa
agaaaaaaaaaaaaaaaagaaaaaaaaabcdzFdddddddddddddddddddddaaaaaaaaaa
agoaaaaaaaaaaaaaaagaaaaaaaaabcdJFdddddddddddddddddddddaaaaaaaaaa
aggggggggggggggggggaaaaaaaaabcdzFdcbbbbbbbbbbbbbbbbbbbaaaaaaaaaa
aaaaaaaaaaaaaaaaaaaaaaaaaaaabcdzFdcbaaaaaaaaaaaaaaaaaajaaaaaaaaa
aaaaaaaaaaaaaaaaaaaaaaaaaaaabcdzFdcbaaaaaaaaaaaaaaaaaaaaaaaaaaaa
"}
