//MAP CONVERTED BY dmm2tgm.py THIS HEADER COMMENT PREVENTS RECONVERSION, DO NOT REMOVE
"a" = (
/turf/dmm_suite/clear_turf,
/area/dmm_suite/clear_area)
"b" = (
/turf/simulated/floor/sidewalk,
/area/dmm_suite/clear_area)
"c" = (
/obj/decal/road_marking/solid_line,
/turf/simulated/floor/road,
/area/dmm_suite/clear_area)
"d" = (
/turf/simulated/floor/road,
/area/dmm_suite/clear_area)
"e" = (
/obj/marker/prefab/city/store{
	icon_state = "";
	dir = 4
	},
/turf/dmm_suite/clear_turf,
/area/dmm_suite/clear_area)
"f" = (
/turf/simulated/wall/brick/red,
/area/dmm_suite/clear_area)
"g" = (
/turf/dmm_suite/no_wall,
/area/dmm_suite/clear_area)
"h" = (
/obj/marker/prefab/yard,
/turf/dmm_suite/clear_turf,
/area/dmm_suite/clear_area)
"i" = (
/obj/structure/interactive/lighting/roadlamp{
	icon_state = "lamp";
	dir = 4
	},
/turf/simulated/floor/sidewalk,
/area/dmm_suite/clear_area)
"j" = (
/obj/marker/prefab/alley_end,
/turf/dmm_suite/clear_turf,
/area/dmm_suite/clear_area)
"k" = (
/obj/marker/prefab/city/store,
/turf/dmm_suite/clear_turf,
/area/dmm_suite/clear_area)
"l" = (
/obj/marker/prefab/city/store{
	icon_state = "";
	dir = 1
	},
/turf/dmm_suite/clear_turf,
/area/dmm_suite/clear_area)
"m" = (
/obj/structure/interactive/lighting/roadlamp{
	icon_state = "lamp";
	dir = 8
	},
/turf/simulated/floor/sidewalk,
/area/dmm_suite/clear_area)
"n" = (
/obj/marker/prefab/alley,
/turf/dmm_suite/clear_turf,
/area/dmm_suite/clear_area)
"o" = (
/obj/structure/interactive/stopsign{
	icon_state = "sign";
	dir = 1
	},
/turf/simulated/floor/sidewalk,
/area/dmm_suite/clear_area)
"p" = (
/obj/marker/prefab/alley{
	icon_state = "alley";
	dir = 6
	},
/turf/dmm_suite/clear_turf,
/area/dmm_suite/clear_area)
"q" = (
/obj/marker/prefab/alley{
	icon_state = "alley";
	dir = 4
	},
/turf/dmm_suite/clear_turf,
/area/dmm_suite/clear_area)
"r" = (
/obj/marker/prefab/alley{
	icon_state = "alley";
	dir = 10
	},
/turf/dmm_suite/clear_turf,
/area/dmm_suite/clear_area)
"s" = (
/obj/decal/road_marking/solid_stop{
	icon_state = "1";
	dir = 1
	},
/turf/simulated/floor/road,
/area/dmm_suite/clear_area)
"t" = (
/obj/structure/interactive/lighting/roadlamp,
/turf/simulated/floor/sidewalk,
/area/dmm_suite/clear_area)
"u" = (
/obj/decal/road_marking/solid_cross,
/turf/simulated/floor/road,
/area/dmm_suite/clear_area)
"v" = (
/obj/structure/interactive/stopsign{
	icon_state = "sign";
	dir = 4
	},
/turf/simulated/floor/sidewalk,
/area/dmm_suite/clear_area)
"w" = (
/obj/decal/road_marking/solid_line{
	icon_state = "1";
	dir = 4
	},
/turf/simulated/floor/road,
/area/dmm_suite/clear_area)
"x" = (
/obj/decal/road_marking/solid_cross{
	icon_state = "1";
	dir = 4
	},
/turf/simulated/floor/road,
/area/dmm_suite/clear_area)
"y" = (
/obj/decal/road_marking/solid_stop{
	icon_state = "1";
	dir = 4
	},
/turf/simulated/floor/road,
/area/dmm_suite/clear_area)
"z" = (
/obj/marker/map_node/x4,
/turf/simulated/floor/road,
/area/dmm_suite/clear_area)
"A" = (
/obj/marker/map_node/x5,
/turf/simulated/floor/road,
/area/dmm_suite/clear_area)
"B" = (
/obj/decal/road_marking/solid_stop{
	icon_state = "1";
	dir = 8
	},
/turf/simulated/floor/road,
/area/dmm_suite/clear_area)
"C" = (
/obj/structure/interactive/lighting/roadlamp{
	icon_state = "lamp";
	dir = 1
	},
/turf/simulated/floor/sidewalk,
/area/dmm_suite/clear_area)
"D" = (
/obj/structure/interactive/stopsign{
	icon_state = "sign";
	dir = 8
	},
/turf/simulated/floor/sidewalk,
/area/dmm_suite/clear_area)
"E" = (
/obj/decal/road_marking/solid_stop,
/turf/simulated/floor/road,
/area/dmm_suite/clear_area)
"F" = (
/obj/structure/interactive/stopsign,
/turf/simulated/floor/sidewalk,
/area/dmm_suite/clear_area)
"H" = (
/obj/decal/road_marking/solid_line{
	icon_state = "1";
	dir = 6
	},
/turf/simulated/floor/road,
/area/dmm_suite/clear_area)
"I" = (
/obj/decal/road_marking/solid_line{
	icon_state = "1";
	dir = 9
	},
/turf/simulated/floor/road,
/area/dmm_suite/clear_area)
"J" = (
/obj/marker/prefab/alley_end{
	icon_state = "alley_end";
	dir = 4
	},
/turf/dmm_suite/clear_turf,
/area/dmm_suite/clear_area)

(1,1,1) = {"
a
a
a
a
a
a
a
a
a
a
a
a
a
a
a
a
a
a
a
a
a
a
a
a
a
a
a
a
b
w
d
d
d
d
w
b
a
a
a
a
a
a
a
a
a
a
a
a
a
a
a
a
a
a
a
a
a
a
a
a
a
a
a
a
"}
(2,1,1) = {"
a
a
a
a
a
a
a
a
a
a
a
a
a
a
a
a
a
a
a
a
a
a
a
a
a
a
a
a
b
w
d
d
d
d
w
b
a
a
a
a
a
a
a
a
a
a
a
a
a
a
a
a
a
a
a
a
a
a
a
a
a
a
a
a
"}
(3,1,1) = {"
a
a
a
a
a
a
a
a
a
a
a
a
a
a
a
a
a
a
a
a
a
a
a
a
a
a
a
a
b
w
d
d
d
d
w
b
a
a
a
a
a
a
a
a
a
a
a
a
a
a
a
a
a
a
a
a
a
a
a
a
a
a
a
a
"}
(4,1,1) = {"
a
f
f
f
f
f
f
f
f
f
f
f
f
f
f
f
f
f
f
a
a
a
a
a
a
a
a
a
b
w
d
d
d
d
w
b
a
f
f
f
f
f
f
f
f
f
f
f
f
f
f
f
f
f
f
f
f
f
f
f
f
f
f
a
"}
(5,1,1) = {"
a
f
a
a
a
a
a
a
a
h
a
a
a
a
a
a
a
h
f
f
a
a
a
a
a
a
a
p
b
w
d
d
d
d
w
b
a
f
a
a
a
a
a
a
a
h
a
a
a
a
a
a
a
h
a
a
a
a
a
a
a
h
f
a
"}
(6,1,1) = {"
a
f
a
a
a
a
a
a
a
a
a
a
a
a
a
a
a
a
a
a
a
a
a
a
a
a
a
a
b
w
d
d
d
d
w
b
a
f
a
a
a
a
a
a
a
a
a
a
a
a
a
a
a
a
a
a
a
a
a
a
a
a
f
a
"}
(7,1,1) = {"
a
f
a
a
a
a
a
a
a
a
a
a
a
a
a
a
a
a
a
a
a
a
a
a
a
a
a
a
b
w
d
d
d
d
w
b
a
f
a
a
a
a
a
a
a
a
a
a
a
a
a
a
a
a
a
a
a
a
a
a
a
a
f
a
"}
(8,1,1) = {"
a
f
a
a
a
a
a
a
a
a
a
a
a
a
a
a
a
a
a
a
a
a
a
a
a
a
a
a
b
w
d
d
A
d
w
b
a
f
a
a
a
a
a
a
a
a
a
a
a
a
a
a
a
a
a
a
a
a
a
a
a
a
f
a
"}
(9,1,1) = {"
a
f
a
a
a
a
a
a
a
a
a
a
a
a
a
a
a
a
a
a
a
a
a
a
a
a
a
a
b
w
d
d
d
d
w
b
a
f
a
a
a
a
a
a
a
a
a
a
a
a
a
a
a
a
a
a
a
a
a
a
a
a
f
a
"}
(10,1,1) = {"
a
f
a
a
a
a
a
a
a
a
a
a
a
a
a
a
a
a
a
a
a
a
a
a
a
a
a
a
b
w
d
d
d
d
w
b
a
f
a
a
a
a
a
a
a
a
a
a
a
a
a
a
a
a
a
a
a
a
a
a
a
a
f
a
"}
(11,1,1) = {"
a
f
a
a
a
a
a
a
a
a
a
a
a
a
a
a
a
a
a
a
a
a
a
a
a
a
a
a
b
w
d
d
d
d
w
b
a
f
a
a
a
a
a
a
a
a
a
a
a
a
a
a
a
a
a
a
a
a
a
a
a
a
f
a
"}
(12,1,1) = {"
a
f
a
a
a
a
a
a
a
a
a
a
a
a
a
a
a
a
a
a
a
a
a
a
a
a
a
a
b
w
d
d
d
d
w
C
a
f
a
a
a
a
a
a
a
a
a
a
a
a
a
a
a
a
a
a
a
a
a
a
a
a
f
a
"}
(13,1,1) = {"
a
f
a
a
a
a
a
a
a
a
a
a
a
a
a
a
a
e
g
a
a
a
a
a
a
a
a
q
b
w
d
d
d
d
w
b
a
a
a
a
a
a
a
a
a
a
a
a
a
a
a
a
l
g
a
a
a
a
a
a
a
h
f
a
"}
(14,1,1) = {"
a
g
a
a
a
a
a
a
a
a
a
a
a
a
a
a
a
a
g
a
a
a
a
a
a
a
a
a
b
w
d
d
A
d
w
b
a
a
a
a
a
a
a
a
a
a
a
a
a
a
a
a
a
g
a
a
a
a
a
a
a
a
f
a
"}
(15,1,1) = {"
a
g
a
a
a
a
a
a
a
a
a
a
a
a
a
a
a
a
g
a
a
a
a
a
a
a
a
a
b
w
d
d
d
d
w
b
a
a
a
a
a
a
a
a
a
a
a
a
a
a
a
a
a
g
a
a
a
a
a
a
a
a
f
a
"}
(16,1,1) = {"
a
g
a
a
a
a
a
a
a
a
a
a
a
a
a
a
a
a
g
a
a
a
a
a
a
a
a
a
b
w
d
d
d
d
w
b
a
a
a
a
a
a
a
a
a
a
a
a
a
a
a
a
a
g
a
a
a
a
a
a
a
a
f
a
"}
(17,1,1) = {"
a
g
a
a
a
a
a
a
a
a
a
a
a
a
a
a
a
a
g
a
a
a
a
a
a
a
a
a
b
w
d
d
d
d
w
b
a
a
a
a
a
a
a
a
a
a
a
a
a
a
a
a
a
g
a
a
a
a
a
a
a
a
f
a
"}
(18,1,1) = {"
a
g
a
a
a
a
a
a
a
a
a
a
a
a
a
a
a
a
g
a
a
a
a
a
a
a
a
a
b
w
d
d
d
d
w
b
a
a
a
a
a
a
a
a
a
a
a
a
a
a
a
a
a
g
a
a
a
a
a
a
a
a
f
a
"}
(19,1,1) = {"
a
g
a
a
a
a
a
a
a
a
a
a
a
a
a
a
a
a
g
a
a
a
a
a
a
a
a
a
b
w
d
d
d
d
w
b
a
a
a
a
a
a
a
a
a
a
a
a
a
a
a
a
a
g
a
a
a
a
a
a
a
a
f
a
"}
(20,1,1) = {"
a
g
a
a
a
a
a
a
a
a
a
a
a
a
a
a
a
a
g
a
a
a
a
a
a
a
a
a
t
w
d
d
d
d
w
b
a
a
a
a
a
a
a
a
a
a
a
a
a
a
a
a
a
g
a
a
a
a
a
a
a
a
f
a
"}
(21,1,1) = {"
a
g
a
a
a
a
a
a
a
a
a
a
a
a
a
a
a
a
g
a
a
a
a
a
a
a
a
r
b
w
d
d
d
d
w
b
a
a
a
a
a
a
a
a
a
a
a
a
a
a
a
a
a
g
a
a
a
a
a
a
a
J
f
a
"}
(22,1,1) = {"
a
g
a
a
a
a
a
a
a
a
a
a
a
a
a
a
a
a
g
a
a
a
a
a
a
a
a
a
b
w
d
d
d
d
w
b
a
a
a
a
a
a
a
a
a
a
a
a
a
a
a
a
a
g
a
a
a
a
a
a
a
a
a
a
"}
(23,1,1) = {"
a
g
a
a
a
a
a
a
a
a
a
a
a
a
a
a
a
a
g
a
a
a
a
a
a
a
a
a
b
w
d
d
A
d
w
b
a
a
a
a
a
a
a
a
a
a
a
a
a
a
a
a
a
g
a
a
a
a
a
a
a
a
a
a
"}
(24,1,1) = {"
a
g
a
a
a
a
a
a
a
a
a
a
a
a
a
a
a
a
g
a
a
a
a
a
a
a
a
a
b
w
d
d
d
d
w
b
a
a
a
a
a
a
a
a
a
a
a
a
a
a
a
a
a
g
a
a
a
a
a
a
a
a
a
a
"}
(25,1,1) = {"
a
g
a
a
a
a
a
a
a
a
a
a
a
a
a
a
a
a
g
a
a
a
a
a
a
a
a
a
b
w
d
d
d
d
w
b
a
a
a
a
a
a
a
a
a
a
a
a
a
a
a
a
a
g
a
a
a
a
a
a
a
a
a
a
"}
(26,1,1) = {"
a
g
a
a
a
a
a
a
a
a
a
a
a
a
a
a
a
a
g
a
a
a
a
a
a
a
a
a
b
w
d
d
d
d
w
b
a
a
a
a
a
a
a
a
a
a
a
a
a
a
a
a
a
g
a
a
a
a
a
a
a
a
a
a
"}
(27,1,1) = {"
a
g
a
a
a
a
a
a
a
a
a
a
a
a
a
a
a
a
g
a
a
a
a
a
a
a
a
a
b
w
d
d
d
d
w
D
a
a
a
a
a
a
a
a
a
a
a
a
a
a
a
a
a
g
a
a
a
a
a
a
a
a
a
a
"}
(28,1,1) = {"
a
g
a
a
a
a
a
a
a
a
a
a
a
a
a
a
a
a
g
a
a
a
a
a
a
a
a
a
b
w
d
d
B
B
B
C
a
a
a
a
a
a
a
a
a
a
a
a
a
a
a
a
a
g
a
a
a
a
a
a
a
a
a
a
"}
(29,1,1) = {"
b
b
b
b
b
b
b
b
b
b
b
i
b
b
b
b
b
b
b
b
b
b
b
b
b
b
o
i
b
x
x
x
x
x
x
b
a
g
g
g
g
g
g
g
g
g
g
g
g
g
g
g
g
b
b
b
b
b
b
b
b
b
b
b
"}
(30,1,1) = {"
c
c
c
c
c
c
c
c
c
c
c
c
c
c
c
c
c
c
c
c
c
c
c
c
c
c
c
s
u
d
d
d
d
d
d
b
a
a
a
a
a
a
a
a
n
a
a
a
a
a
a
a
n
b
H
c
c
c
c
c
c
c
c
c
"}
(31,1,1) = {"
d
d
d
d
d
d
d
d
d
d
d
d
d
d
d
d
d
d
d
d
d
d
d
d
d
d
d
s
u
d
d
d
d
d
d
b
a
a
a
a
a
a
a
a
a
a
a
a
a
a
a
a
a
b
w
d
d
d
d
d
d
d
d
d
"}
(32,1,1) = {"
d
d
d
d
d
d
d
d
d
d
d
d
d
d
d
d
d
d
d
d
d
d
d
d
d
d
d
s
u
d
d
d
A
d
d
b
a
a
a
a
a
a
a
a
a
a
a
a
a
a
a
a
a
b
w
d
d
d
d
d
d
d
d
d
"}
(33,1,1) = {"
d
d
d
d
A
d
d
d
d
d
d
d
d
d
A
d
d
d
d
d
d
d
d
A
d
d
d
d
u
d
d
d
d
d
d
b
a
a
a
a
a
a
a
a
a
a
a
a
a
a
a
a
a
b
w
d
d
z
d
d
d
z
d
d
"}
(34,1,1) = {"
d
d
d
d
d
d
d
d
d
d
d
d
d
d
d
d
d
d
d
d
d
d
d
d
d
d
d
d
u
d
d
d
d
d
d
b
a
a
a
a
a
a
a
a
a
a
a
a
a
a
a
a
a
b
w
d
d
d
d
d
d
d
d
d
"}
(35,1,1) = {"
c
c
c
c
c
c
c
c
c
c
c
c
c
c
c
c
c
c
c
c
c
c
c
c
c
c
c
c
u
d
d
d
d
d
d
b
a
a
a
a
a
a
a
a
a
a
a
a
a
a
a
a
a
b
w
d
d
d
d
H
c
c
c
c
"}
(36,1,1) = {"
b
b
b
b
b
b
b
b
b
b
b
b
b
b
b
b
b
b
b
m
b
b
b
b
b
b
b
b
b
x
x
x
x
x
x
b
a
a
a
a
a
a
a
a
a
a
a
a
a
a
a
a
a
b
w
d
d
d
d
w
b
b
b
b
"}
(37,1,1) = {"
a
a
a
a
a
a
a
a
a
a
a
a
a
a
a
a
a
a
a
a
a
a
a
a
a
a
a
a
b
y
y
y
d
d
w
b
a
a
a
a
a
a
a
a
a
a
a
a
a
a
a
a
a
b
w
d
d
d
d
w
b
a
a
a
"}
(38,1,1) = {"
a
a
a
f
a
a
a
a
a
a
a
h
a
a
a
a
a
a
a
a
a
a
a
a
a
a
a
k
t
w
d
d
d
d
w
b
a
g
g
g
g
g
g
g
g
g
g
g
g
g
g
g
g
b
w
d
d
d
d
w
b
a
a
a
"}
(39,1,1) = {"
a
a
a
f
a
a
a
a
a
a
a
a
a
a
a
a
a
a
a
a
a
a
a
a
a
a
a
a
v
w
d
d
d
d
w
b
a
a
a
a
a
a
a
a
a
a
a
a
a
a
a
a
l
b
w
d
d
d
d
w
b
a
a
a
"}
(40,1,1) = {"
a
a
a
f
a
a
a
a
a
a
a
a
a
a
a
a
a
a
a
a
a
a
a
a
a
a
a
a
b
w
d
d
d
d
w
b
a
a
a
a
a
a
a
a
a
a
a
a
a
a
a
a
a
b
w
d
d
z
d
w
b
a
a
a
"}
(41,1,1) = {"
a
a
a
f
a
a
a
a
a
a
a
a
a
a
a
a
a
a
a
a
a
a
a
a
a
a
a
a
b
w
d
d
A
d
w
b
a
a
a
a
a
a
a
a
a
a
a
a
a
a
a
a
a
b
w
d
d
d
d
w
b
a
a
a
"}
(42,1,1) = {"
a
a
a
f
a
a
a
a
a
a
a
a
a
a
a
a
a
a
a
a
a
a
a
a
a
a
a
a
b
w
d
d
d
d
w
b
a
a
a
a
a
a
a
a
a
a
a
a
a
a
a
a
a
b
w
d
d
d
d
w
b
a
a
a
"}
(43,1,1) = {"
a
a
a
f
a
a
a
a
a
a
a
a
a
a
a
a
a
a
a
a
a
a
a
a
a
a
a
a
b
w
d
d
d
d
w
b
a
a
a
a
a
a
a
a
a
a
a
a
a
a
a
a
a
b
w
d
d
d
d
w
b
a
a
a
"}
(44,1,1) = {"
a
a
a
f
a
a
a
a
a
a
a
a
a
a
a
a
a
a
a
a
a
a
a
a
a
a
a
a
b
w
d
d
d
d
w
b
a
a
a
a
a
a
a
a
a
a
a
a
a
a
a
a
a
b
w
d
d
d
d
w
b
a
a
a
"}
(45,1,1) = {"
a
a
a
f
a
a
a
a
a
a
a
a
a
a
a
a
a
a
a
a
a
a
a
a
a
a
a
a
b
w
d
d
d
d
w
b
a
a
a
a
a
a
a
a
a
a
a
a
a
a
a
a
a
b
w
d
d
d
d
w
b
a
a
a
"}
(46,1,1) = {"
a
a
a
f
a
a
a
a
a
a
a
h
a
a
a
a
a
a
a
a
a
a
a
a
a
a
a
a
b
w
d
d
d
d
w
C
a
a
a
a
a
a
a
a
a
a
a
a
a
a
a
a
a
b
w
d
d
d
d
w
b
a
a
a
"}
(47,1,1) = {"
a
a
a
f
a
a
a
a
a
a
a
a
a
a
a
a
a
a
a
a
a
a
a
a
a
a
a
a
b
w
d
d
d
d
w
b
a
a
a
a
a
a
a
a
a
a
a
a
a
a
a
a
a
b
w
d
d
z
d
w
b
a
a
a
"}
(48,1,1) = {"
a
a
a
f
a
a
a
a
a
a
a
a
a
a
a
a
a
a
a
a
a
a
a
a
a
a
a
a
b
w
d
d
d
d
w
b
a
a
a
a
a
a
a
a
a
a
a
a
a
a
a
a
a
b
w
d
d
d
d
w
b
a
a
a
"}
(49,1,1) = {"
a
a
a
f
a
a
a
a
a
a
a
a
a
a
a
a
a
a
a
a
a
a
a
a
a
a
a
a
b
w
d
d
d
d
w
b
a
a
a
a
a
a
a
a
a
a
a
a
a
a
a
a
a
b
w
d
d
d
d
w
b
a
a
a
"}
(50,1,1) = {"
a
a
a
f
a
a
a
a
a
a
a
a
a
a
a
a
a
a
a
a
a
a
a
a
a
a
a
a
b
w
d
d
A
d
w
b
a
a
a
a
a
a
a
a
a
a
a
a
a
a
a
a
a
b
w
d
d
d
d
w
b
a
a
a
"}
(51,1,1) = {"
a
a
a
f
a
a
a
a
a
a
a
a
a
a
a
a
a
a
a
a
a
a
a
a
a
a
a
a
b
w
d
d
d
d
w
b
a
a
a
a
a
a
a
a
a
a
a
a
a
a
a
a
a
b
w
d
d
d
d
w
b
a
a
a
"}
(52,1,1) = {"
a
a
a
f
a
a
a
a
a
a
a
a
a
a
a
a
a
a
a
a
a
a
a
a
a
a
a
a
b
w
d
d
d
d
w
b
a
a
a
a
a
a
a
a
a
a
a
a
a
a
a
a
a
b
w
d
d
d
d
w
b
a
a
a
"}
(53,1,1) = {"
a
a
a
f
a
a
a
a
a
a
a
a
a
a
a
a
a
a
a
a
a
a
a
a
a
a
a
a
b
w
d
d
d
d
w
b
a
a
a
a
a
a
a
a
a
a
a
a
a
a
a
a
a
b
w
d
d
d
d
w
b
a
a
a
"}
(54,1,1) = {"
a
a
a
f
a
a
a
a
a
a
a
g
g
g
g
g
g
g
g
g
g
g
g
g
g
g
g
g
t
w
d
d
d
d
w
b
a
a
a
a
a
a
a
a
a
a
a
a
a
a
a
a
a
b
w
d
d
z
d
w
b
a
a
a
"}
(55,1,1) = {"
a
a
a
f
a
a
a
a
a
a
a
a
a
a
a
a
a
a
a
a
a
a
a
a
a
a
a
a
b
w
d
d
d
d
w
b
a
a
a
a
a
a
a
a
a
a
a
a
a
a
a
a
a
b
w
d
d
d
d
w
b
a
a
a
"}
(56,1,1) = {"
a
a
a
f
a
a
a
a
a
a
a
j
a
a
a
a
a
a
a
n
a
a
a
a
a
a
a
n
b
w
d
d
d
d
w
b
b
b
b
b
b
b
b
b
b
i
b
b
b
b
b
b
b
b
w
d
d
d
d
w
b
a
a
a
"}
(57,1,1) = {"
a
a
a
a
a
a
a
a
a
a
a
a
a
a
a
a
a
a
a
a
a
a
a
a
a
a
a
a
b
w
d
d
d
d
d
u
c
c
c
c
c
c
c
c
c
c
c
c
c
c
c
c
c
c
I
d
d
d
d
w
b
a
a
a
"}
(58,1,1) = {"
a
a
a
a
a
a
a
a
a
a
a
a
a
a
a
a
a
a
a
a
a
a
a
a
a
a
a
a
b
w
d
d
d
d
d
u
d
d
d
d
d
d
d
d
d
d
d
d
d
d
d
d
d
d
d
d
d
d
d
w
b
a
a
a
"}
(59,1,1) = {"
a
a
a
a
a
a
a
a
a
a
a
a
a
a
a
a
a
a
a
a
a
a
a
a
a
a
a
a
b
w
d
d
A
d
d
u
d
d
d
d
A
d
d
d
d
d
d
d
d
A
d
d
d
d
d
d
d
d
d
w
b
a
a
a
"}
(60,1,1) = {"
a
a
a
a
a
a
a
a
a
a
a
a
a
a
a
a
a
a
a
a
a
a
a
a
a
a
a
a
b
w
d
d
A
d
d
u
E
d
d
d
d
d
d
d
d
d
d
d
d
d
d
d
d
d
d
d
d
z
d
w
b
a
a
a
"}
(61,1,1) = {"
a
a
a
a
a
a
a
a
a
a
a
a
a
a
a
a
a
a
a
a
a
a
a
a
a
a
a
a
b
w
d
d
d
d
d
u
E
d
d
d
d
d
d
d
d
d
d
d
d
d
d
d
d
d
d
d
d
d
d
w
b
a
a
a
"}
(62,1,1) = {"
a
a
a
a
a
a
a
a
a
a
a
a
a
a
a
a
a
a
a
a
a
a
a
a
a
a
a
a
b
w
d
d
d
d
d
u
E
c
c
c
c
c
c
c
c
c
c
c
c
c
c
c
c
c
c
c
c
c
c
I
b
a
a
a
"}
(63,1,1) = {"
a
a
a
a
a
a
a
a
a
a
a
a
a
a
a
a
a
a
a
a
a
a
a
a
a
a
a
a
b
w
d
d
d
d
w
b
m
F
b
b
b
b
b
b
b
b
b
b
b
b
b
b
b
b
b
b
b
b
b
b
b
a
a
a
"}
(64,1,1) = {"
a
a
a
a
a
a
a
a
a
a
a
a
a
a
a
a
a
a
a
a
a
a
a
a
a
a
a
a
b
w
d
d
d
d
w
b
a
a
a
a
a
a
a
a
a
a
a
a
a
a
a
a
a
a
a
a
a
a
a
a
a
a
a
a
"}
