//MAP CONVERTED BY dmm2tgm.py THIS HEADER COMMENT PREVENTS RECONVERSION, DO NOT REMOVE
"a" = (
/turf/dmm_suite/clear_turf,
/area/dmm_suite/clear_area)
"b" = (
/turf/simulated/floor/sidewalk,
/area/dmm_suite/clear_area)
"c" = (
/obj/decal/road_marking/solid_line,
/turf/simulated/floor/road,
/area/dmm_suite/clear_area)
"d" = (
/turf/simulated/floor/road,
/area/dmm_suite/clear_area)
"e" = (
/obj/marker/prefab/city/store,
/turf/dmm_suite/clear_turf,
/area/dmm_suite/clear_area)
"f" = (
/turf/simulated/wall/brick/red,
/area/dmm_suite/clear_area)
"g" = (
/turf/simulated/floor/colored/dirt/path,
/area/dmm_suite/clear_area)
"h" = (
/obj/marker/prefab/alley_end{
	icon_state = "alley_end";
	dir = 4
	},
/turf/dmm_suite/clear_turf,
/area/dmm_suite/clear_area)
"i" = (
/obj/marker/prefab/alley{
	icon_state = "alley";
	dir = 4
	},
/turf/dmm_suite/clear_turf,
/area/dmm_suite/clear_area)
"j" = (
/obj/marker/prefab/alley{
	icon_state = "alley";
	dir = 8
	},
/turf/dmm_suite/clear_turf,
/area/dmm_suite/clear_area)
"k" = (
/obj/marker/prefab/alley{
	icon_state = "alley";
	dir = 10
	},
/turf/dmm_suite/clear_turf,
/area/dmm_suite/clear_area)
"l" = (
/obj/structure/interactive/lighting/roadlamp{
	icon_state = "lamp";
	dir = 4
	},
/turf/simulated/floor/sidewalk,
/area/dmm_suite/clear_area)
"m" = (
/obj/marker/prefab/yard,
/turf/dmm_suite/clear_turf,
/area/dmm_suite/clear_area)
"n" = (
/obj/marker/prefab/city/store{
	icon_state = "";
	dir = 4
	},
/turf/dmm_suite/clear_turf,
/area/dmm_suite/clear_area)
"o" = (
/obj/structure/interactive/lighting/roadlamp{
	icon_state = "lamp";
	dir = 8
	},
/turf/simulated/floor/sidewalk,
/area/dmm_suite/clear_area)
"p" = (
/obj/marker/prefab/alley,
/turf/dmm_suite/clear_turf,
/area/dmm_suite/clear_area)
"q" = (
/obj/structure/interactive/stopsign{
	icon_state = "sign";
	dir = 1
	},
/turf/simulated/floor/sidewalk,
/area/dmm_suite/clear_area)
"r" = (
/obj/marker/prefab/city/store{
	icon_state = "";
	dir = 8
	},
/turf/dmm_suite/clear_turf,
/area/dmm_suite/clear_area)
"s" = (
/obj/decal/road_marking/solid_stop{
	icon_state = "1";
	dir = 1
	},
/turf/simulated/floor/road,
/area/dmm_suite/clear_area)
"t" = (
/obj/structure/interactive/lighting/roadlamp,
/turf/simulated/floor/sidewalk,
/area/dmm_suite/clear_area)
"u" = (
/obj/decal/road_marking/solid_cross,
/turf/simulated/floor/road,
/area/dmm_suite/clear_area)
"v" = (
/obj/structure/interactive/stopsign{
	icon_state = "sign";
	dir = 4
	},
/turf/simulated/floor/sidewalk,
/area/dmm_suite/clear_area)
"w" = (
/obj/decal/road_marking/solid_cross{
	icon_state = "1";
	dir = 4
	},
/turf/simulated/floor/road,
/area/dmm_suite/clear_area)
"x" = (
/obj/decal/road_marking/solid_line{
	icon_state = "1";
	dir = 4
	},
/turf/simulated/floor/road,
/area/dmm_suite/clear_area)
"y" = (
/obj/structure/interactive/lighting/roadlamp{
	icon_state = "lamp";
	dir = 1
	},
/turf/simulated/floor/sidewalk,
/area/dmm_suite/clear_area)
"z" = (
/obj/decal/road_marking/solid_stop{
	icon_state = "1";
	dir = 4
	},
/turf/simulated/floor/road,
/area/dmm_suite/clear_area)
"A" = (
/obj/structure/interactive/stopsign{
	icon_state = "sign";
	dir = 8
	},
/turf/simulated/floor/sidewalk,
/area/dmm_suite/clear_area)
"B" = (
/obj/structure/interactive/stopsign,
/turf/simulated/floor/sidewalk,
/area/dmm_suite/clear_area)
"C" = (
/obj/decal/road_marking/solid_stop{
	icon_state = "1";
	dir = 8
	},
/turf/simulated/floor/road,
/area/dmm_suite/clear_area)
"D" = (
/obj/marker/map_node/x5,
/turf/simulated/floor/road,
/area/dmm_suite/clear_area)
"E" = (
/obj/marker/map_node/x4,
/turf/simulated/floor/road,
/area/dmm_suite/clear_area)
"F" = (
/obj/decal/road_marking/solid_stop,
/turf/simulated/floor/road,
/area/dmm_suite/clear_area)
"H" = (
/obj/marker/prefab/alley_end{
	icon_state = "alley_end";
	dir = 1
	},
/turf/dmm_suite/clear_turf,
/area/dmm_suite/clear_area)

(1,1,1) = {"
a
a
a
a
a
a
a
a
a
a
a
a
a
a
a
a
a
a
a
a
a
a
a
a
a
a
a
a
b
x
d
d
d
d
x
b
a
a
a
a
a
a
a
a
a
a
a
a
a
a
a
a
a
a
a
a
a
a
a
a
a
a
a
a
"}
(2,1,1) = {"
a
a
a
a
a
a
a
a
a
a
a
a
a
a
a
a
a
a
a
a
a
a
a
a
a
a
a
a
b
x
d
d
d
d
x
b
a
f
f
f
f
f
f
f
f
f
f
f
f
f
f
f
f
f
f
f
f
f
f
f
f
f
f
a
"}
(3,1,1) = {"
a
a
a
a
a
a
a
a
a
a
a
a
a
a
a
a
a
a
a
a
a
a
a
a
a
a
a
a
b
x
d
d
D
d
x
b
a
f
a
a
a
a
a
a
a
a
a
a
a
a
a
a
a
a
a
a
a
a
a
a
a
a
f
a
"}
(4,1,1) = {"
a
a
a
a
a
a
a
a
a
a
a
f
f
f
f
f
f
f
f
f
f
f
f
f
f
f
f
f
b
x
d
d
d
d
x
b
a
f
a
a
a
a
a
a
a
a
a
a
a
a
a
a
a
a
a
a
a
a
a
a
a
a
f
a
"}
(5,1,1) = {"
a
a
a
a
a
a
a
a
a
a
h
a
a
a
a
a
a
a
m
a
a
a
a
a
a
a
m
f
b
x
d
d
d
d
x
b
a
f
a
a
a
a
a
a
a
m
a
a
a
a
a
a
a
m
a
a
a
a
a
a
a
m
f
a
"}
(6,1,1) = {"
a
a
a
a
a
a
a
a
a
a
a
a
a
a
a
a
a
a
a
a
a
a
a
a
a
a
a
f
b
x
d
d
d
d
x
b
a
f
a
a
a
a
a
a
a
a
a
a
a
a
a
a
a
a
a
a
a
a
a
a
a
a
f
a
"}
(7,1,1) = {"
a
a
a
a
a
a
a
a
a
a
a
a
a
a
a
a
a
a
a
a
a
a
a
a
a
a
a
f
b
x
d
d
d
d
x
b
a
f
a
a
a
a
a
a
a
a
a
a
a
a
a
a
a
a
a
a
a
a
a
a
a
a
f
a
"}
(8,1,1) = {"
a
a
a
a
a
a
a
a
a
a
a
a
a
a
a
a
a
a
a
a
a
a
a
a
a
a
a
f
b
x
d
d
d
d
x
b
a
f
a
a
a
a
a
a
a
a
a
a
a
a
a
a
a
a
a
a
a
a
a
a
a
a
f
a
"}
(9,1,1) = {"
a
a
a
a
a
a
a
a
a
a
a
a
a
a
a
a
a
a
a
a
a
a
a
a
a
a
a
f
b
x
d
d
d
d
x
b
a
f
a
a
a
a
a
a
a
a
a
a
a
a
a
a
a
a
a
a
a
a
a
a
a
a
f
a
"}
(10,1,1) = {"
a
a
a
a
a
a
a
a
a
a
a
a
a
a
a
a
a
a
a
a
a
a
a
a
a
a
a
f
b
x
d
d
d
d
x
b
a
f
a
a
a
a
a
a
a
a
a
a
a
a
a
a
a
a
a
a
a
a
a
a
a
a
f
a
"}
(11,1,1) = {"
a
a
a
a
a
a
a
a
a
a
a
a
a
a
a
a
a
a
a
a
a
a
a
a
a
a
a
f
b
x
d
d
d
d
x
b
a
f
a
a
a
a
a
a
a
a
a
a
a
a
a
a
a
a
a
a
a
a
a
a
a
a
f
a
"}
(12,1,1) = {"
a
a
a
a
a
a
a
a
a
a
a
a
a
a
a
a
a
a
a
a
a
a
a
a
a
a
a
f
b
x
d
d
D
d
x
y
a
f
a
a
a
a
a
a
a
a
a
a
a
a
a
a
a
a
a
a
a
a
a
a
a
a
f
a
"}
(13,1,1) = {"
a
a
a
a
a
a
a
a
a
a
i
a
a
a
a
a
a
a
a
a
a
a
a
a
a
a
a
e
b
x
d
d
d
d
x
b
a
a
a
a
a
a
a
a
a
a
a
a
a
a
a
a
a
n
a
a
a
a
a
a
a
h
f
a
"}
(14,1,1) = {"
a
a
a
a
a
a
a
a
a
a
a
a
a
a
a
a
a
a
a
a
a
a
a
a
a
a
a
a
b
x
d
d
d
d
x
b
a
a
a
a
a
a
a
a
a
a
a
a
a
a
a
a
a
a
a
a
a
a
a
a
a
a
a
a
"}
(15,1,1) = {"
a
a
a
a
a
a
a
a
a
a
a
a
a
a
a
a
a
a
a
a
a
a
a
a
a
a
a
a
b
x
d
d
d
d
x
b
a
a
a
a
a
a
a
a
a
a
a
a
a
a
a
a
a
a
a
a
a
a
a
a
a
a
a
a
"}
(16,1,1) = {"
a
a
a
a
a
a
a
a
a
a
a
a
a
a
a
a
a
a
a
a
a
a
a
a
a
a
a
a
b
x
d
d
d
d
x
b
a
a
a
a
a
a
a
a
a
a
a
a
a
a
a
a
a
a
a
a
a
a
a
a
a
a
a
a
"}
(17,1,1) = {"
a
a
a
a
a
a
a
a
a
a
a
a
a
a
a
a
a
a
a
a
a
a
a
a
a
a
a
a
b
x
d
d
d
d
x
b
a
a
a
a
a
a
a
a
a
a
a
a
a
a
a
a
a
a
a
a
a
a
a
a
a
a
a
a
"}
(18,1,1) = {"
a
a
a
a
a
a
a
a
a
a
a
a
a
a
a
a
a
a
a
a
a
a
a
a
a
a
a
a
b
x
d
d
d
d
x
b
a
a
a
a
a
a
a
a
a
a
a
a
a
a
a
a
a
a
a
a
a
a
a
a
a
a
a
a
"}
(19,1,1) = {"
a
a
a
a
a
a
a
a
a
a
a
a
a
a
a
a
a
a
a
a
a
a
a
a
a
a
a
a
b
x
d
d
d
d
x
b
a
a
a
a
a
a
a
a
a
a
a
a
a
a
a
a
a
a
a
a
a
a
a
a
a
a
a
a
"}
(20,1,1) = {"
a
a
a
a
a
a
a
a
a
a
a
a
a
a
a
a
a
a
a
a
a
a
a
a
a
a
a
a
t
x
d
d
d
d
x
b
a
a
a
a
a
a
a
a
a
a
a
a
a
a
a
a
a
a
a
a
a
a
a
a
a
a
a
a
"}
(21,1,1) = {"
a
a
a
a
a
a
a
a
a
a
i
a
a
a
a
a
a
a
a
a
a
a
a
a
a
a
a
a
b
x
d
d
D
d
x
b
a
a
a
a
a
a
a
a
a
a
a
a
a
a
a
a
a
a
a
a
a
a
a
a
a
j
a
a
"}
(22,1,1) = {"
a
a
a
a
a
a
a
a
a
a
a
a
a
a
a
a
a
a
a
a
a
a
a
a
a
a
a
a
b
x
d
d
d
d
x
b
a
a
a
a
a
a
a
a
a
a
a
a
a
a
a
a
a
a
a
a
a
a
a
a
a
a
a
a
"}
(23,1,1) = {"
a
a
a
a
a
a
a
a
a
a
a
a
a
a
a
a
a
a
a
a
a
a
a
a
a
a
a
a
b
x
d
d
d
d
x
b
a
a
a
a
a
a
a
a
a
a
a
a
a
a
a
a
a
a
a
a
a
a
a
a
a
a
a
a
"}
(24,1,1) = {"
a
a
a
a
a
a
a
a
a
a
a
a
a
a
a
a
a
a
a
a
a
a
a
a
a
a
a
a
b
x
d
d
d
d
x
b
a
a
a
a
a
a
a
a
a
a
a
a
a
a
a
a
a
a
a
a
a
a
a
a
a
a
a
a
"}
(25,1,1) = {"
a
a
a
a
a
a
a
a
a
a
a
a
a
a
a
a
a
a
a
a
a
a
a
a
a
a
a
a
b
x
d
d
d
d
x
b
a
a
a
a
a
a
a
a
a
a
a
a
a
a
a
a
a
a
a
a
a
a
a
a
a
a
a
a
"}
(26,1,1) = {"
a
a
a
a
a
a
a
a
a
a
a
a
a
a
a
a
a
a
a
a
a
a
a
a
a
a
a
a
b
x
d
d
d
d
x
b
a
a
a
a
a
a
a
a
a
a
a
a
a
a
a
a
a
a
a
a
a
a
a
a
a
a
a
a
"}
(27,1,1) = {"
a
a
a
a
a
a
a
a
a
a
a
a
a
a
a
a
a
a
a
a
a
a
a
a
a
a
a
a
b
x
d
d
d
d
x
A
a
a
a
a
a
a
a
a
a
a
a
a
a
a
a
a
a
a
a
a
a
a
a
a
a
a
a
a
"}
(28,1,1) = {"
a
a
a
a
a
a
a
a
a
a
a
a
a
a
a
a
a
a
a
a
a
a
a
a
a
a
a
a
b
x
d
d
C
C
C
y
a
a
a
a
a
a
a
a
a
a
a
a
a
a
a
a
a
a
a
a
a
a
a
a
a
a
a
a
"}
(29,1,1) = {"
b
b
b
b
b
b
b
b
b
b
b
l
b
b
b
b
b
b
b
b
b
b
b
b
b
b
q
l
b
w
w
w
w
w
w
b
b
b
b
b
b
b
b
b
b
l
b
b
b
b
b
b
b
b
b
b
b
b
b
b
b
b
b
b
"}
(30,1,1) = {"
c
c
c
c
c
c
c
c
c
c
c
c
c
c
c
c
c
c
c
c
c
c
c
c
c
c
c
s
u
d
d
d
D
d
d
u
c
c
c
c
c
c
c
c
c
c
c
c
c
c
c
c
c
c
c
c
c
c
c
c
c
c
c
c
"}
(31,1,1) = {"
d
d
d
d
d
d
d
d
d
d
d
d
d
d
d
d
d
d
d
d
d
d
d
d
d
d
d
s
u
d
d
d
d
d
d
u
d
d
d
d
d
d
d
d
d
d
d
d
d
d
d
d
d
d
d
d
d
d
d
d
d
d
d
d
"}
(32,1,1) = {"
d
d
d
E
d
d
d
d
d
d
E
d
d
d
d
d
d
E
d
d
d
d
d
d
E
d
d
s
u
d
d
d
d
d
d
u
d
d
d
d
d
d
d
d
d
d
d
d
d
d
d
d
d
d
d
d
d
d
d
d
d
d
d
d
"}
(33,1,1) = {"
d
d
d
d
d
d
d
d
d
d
d
d
d
d
d
d
d
d
d
d
d
d
d
d
d
d
d
d
u
d
d
d
d
d
d
u
F
d
d
d
d
D
d
d
d
d
d
d
d
d
D
d
d
d
d
d
d
d
d
d
D
d
d
d
"}
(34,1,1) = {"
d
d
d
d
d
d
d
d
d
d
d
d
d
d
d
d
d
d
d
d
d
d
d
d
d
d
d
d
u
d
d
d
d
d
d
u
F
d
d
d
d
d
d
d
d
d
d
d
d
d
d
d
d
d
d
d
d
d
d
d
d
d
d
d
"}
(35,1,1) = {"
c
c
c
c
c
c
c
c
c
c
c
c
c
c
c
c
c
c
c
c
c
c
c
c
c
c
c
c
u
d
d
d
d
d
d
u
F
c
c
c
c
c
c
c
c
c
c
c
c
c
c
c
c
c
c
c
c
c
c
c
c
c
c
c
"}
(36,1,1) = {"
b
b
b
b
b
b
b
b
b
b
b
b
b
b
b
b
b
b
b
o
b
b
b
b
b
b
b
b
b
w
w
w
w
w
w
b
o
B
b
b
b
b
b
b
b
b
b
b
b
b
b
b
b
o
b
b
b
b
b
b
b
b
b
b
"}
(37,1,1) = {"
a
a
a
a
a
a
a
a
a
a
a
a
a
a
a
a
a
a
a
a
a
a
a
a
a
a
a
e
t
z
z
z
d
d
x
b
a
a
a
a
a
a
a
a
a
a
a
a
a
a
a
a
a
a
a
a
a
a
a
a
a
a
a
a
"}
(38,1,1) = {"
a
a
a
a
a
a
a
a
a
a
j
a
a
a
a
a
a
a
a
a
a
a
a
a
a
a
a
a
v
x
d
d
d
d
x
b
a
a
a
a
a
a
a
a
j
a
a
a
a
a
a
a
a
a
a
a
a
a
a
a
a
r
a
f
"}
(39,1,1) = {"
a
a
a
a
a
a
a
a
a
a
a
a
a
a
a
a
a
a
a
a
a
a
a
a
a
a
a
a
b
x
d
d
D
d
x
b
a
a
a
a
a
a
a
a
a
a
a
a
a
a
a
a
a
a
a
a
a
a
a
a
a
a
a
f
"}
(40,1,1) = {"
a
a
a
a
a
a
a
a
a
a
a
a
a
a
a
a
a
a
a
a
a
a
a
a
a
a
a
a
b
x
d
d
d
d
x
b
a
a
a
a
a
a
a
a
a
a
a
a
a
a
a
a
a
a
a
a
a
a
a
a
a
a
a
f
"}
(41,1,1) = {"
a
a
a
a
a
a
a
a
a
a
a
a
a
a
a
a
a
a
a
a
a
a
a
a
a
a
a
a
b
x
d
d
d
d
x
b
a
a
a
a
a
a
a
a
a
a
a
a
a
a
a
a
a
a
a
a
a
a
a
a
a
a
a
f
"}
(42,1,1) = {"
a
a
a
a
a
a
a
a
a
a
a
a
a
a
a
a
a
a
a
a
a
a
a
a
a
a
a
a
b
x
d
d
d
d
x
b
a
a
a
a
a
a
a
a
a
a
a
a
a
a
a
a
a
a
a
a
a
a
a
a
a
a
a
f
"}
(43,1,1) = {"
a
a
a
a
a
a
a
a
a
a
a
a
a
a
a
a
a
a
a
a
a
a
a
a
a
a
a
a
b
x
d
d
d
d
x
b
a
a
a
a
a
a
a
a
a
a
a
a
a
a
a
a
a
a
a
a
a
a
a
a
a
a
a
f
"}
(44,1,1) = {"
a
a
a
a
a
a
a
a
a
a
a
a
a
a
a
a
a
a
a
a
a
a
a
a
a
a
a
a
b
x
d
d
d
d
x
b
a
a
a
a
a
a
a
a
a
a
a
a
a
a
a
a
a
a
a
a
a
a
a
a
a
a
a
f
"}
(45,1,1) = {"
a
a
a
a
a
a
a
a
a
a
a
a
a
a
a
a
a
a
a
a
a
a
a
a
a
a
a
a
b
x
d
d
d
d
x
b
a
a
a
a
a
a
a
a
a
a
a
a
a
a
a
a
a
a
a
a
a
a
a
a
a
a
a
f
"}
(46,1,1) = {"
a
a
a
a
a
a
a
a
a
a
j
a
a
a
a
a
a
a
a
a
a
a
a
a
a
a
a
a
b
x
d
d
d
d
x
y
a
a
a
a
a
a
a
a
j
a
a
a
a
a
a
a
a
a
a
a
a
a
a
a
a
a
a
f
"}
(47,1,1) = {"
a
a
a
a
a
a
a
a
a
a
a
a
a
a
a
a
a
a
a
a
a
a
a
a
a
a
a
a
b
x
d
d
d
d
x
b
a
a
a
a
a
a
a
a
a
a
a
a
a
a
a
a
a
a
a
a
a
a
a
a
a
a
a
f
"}
(48,1,1) = {"
a
a
a
a
a
a
a
a
a
a
a
a
a
a
a
a
a
a
a
a
a
a
a
a
a
a
a
a
b
x
d
d
D
d
x
b
a
a
a
a
a
a
a
a
a
a
a
a
a
a
a
a
a
a
a
a
a
a
a
a
a
a
a
f
"}
(49,1,1) = {"
a
a
a
a
a
a
a
a
a
a
a
a
a
a
a
a
a
a
a
a
a
a
a
a
a
a
a
a
b
x
d
d
d
d
x
b
a
a
a
a
a
a
a
a
a
a
a
a
a
a
a
a
a
a
a
a
a
a
a
a
a
a
a
f
"}
(50,1,1) = {"
a
a
a
a
a
a
a
a
a
a
a
a
a
a
a
a
a
a
a
a
a
a
a
a
a
a
a
a
b
x
d
d
d
d
x
b
a
a
a
a
a
a
a
a
a
a
a
a
a
a
a
a
a
a
a
a
a
a
a
a
a
a
a
f
"}
(51,1,1) = {"
a
a
a
a
a
a
a
a
a
a
a
a
a
a
a
a
a
a
a
a
a
a
a
a
a
a
a
a
b
x
d
d
d
d
x
b
a
a
a
a
a
a
a
a
a
a
a
a
a
a
a
a
a
a
a
a
a
a
a
a
a
a
a
f
"}
(52,1,1) = {"
a
a
a
a
a
a
a
a
a
a
a
a
a
a
a
a
a
a
a
a
a
a
a
a
a
a
a
a
b
x
d
d
d
d
x
b
a
a
a
a
a
a
a
a
a
a
a
a
a
a
a
a
a
a
a
a
a
a
a
a
a
a
a
f
"}
(53,1,1) = {"
a
a
a
a
a
a
a
a
a
a
a
a
a
a
a
a
a
a
a
a
a
a
a
a
a
a
a
a
b
x
d
d
d
d
x
b
a
a
a
a
a
a
a
a
a
a
a
a
a
a
a
a
a
a
a
a
a
a
a
a
a
a
a
f
"}
(54,1,1) = {"
a
a
a
f
g
g
g
g
g
g
f
a
a
a
a
a
a
a
a
a
a
a
a
a
a
a
a
a
t
x
d
d
d
d
x
b
a
a
a
a
a
a
a
a
H
a
a
a
a
a
a
a
a
m
a
a
a
a
a
a
a
m
a
f
"}
(55,1,1) = {"
a
a
a
a
a
a
a
a
a
a
k
f
a
a
a
a
a
a
a
p
a
a
a
a
a
a
a
p
b
x
d
d
d
d
x
b
a
a
a
a
a
a
a
a
a
a
a
a
a
a
a
a
a
a
a
a
a
a
a
a
a
a
a
f
"}
(56,1,1) = {"
a
a
a
a
a
a
a
a
a
a
a
g
a
a
a
a
a
a
a
a
a
a
a
a
a
a
a
a
b
x
d
d
d
d
x
b
a
a
a
a
a
a
a
a
a
a
a
a
a
a
a
a
a
a
a
a
a
a
a
a
a
a
a
f
"}
(57,1,1) = {"
a
a
a
a
a
a
a
a
a
a
a
g
a
a
a
a
a
a
a
a
a
a
a
a
a
a
a
a
b
x
d
d
D
d
x
b
a
a
a
a
a
a
a
a
a
a
a
a
a
a
a
a
a
a
a
a
a
a
a
a
a
a
a
f
"}
(58,1,1) = {"
a
a
a
a
a
a
a
a
a
a
a
g
a
a
a
a
a
a
a
a
a
a
a
a
a
a
a
a
b
x
d
d
d
d
x
b
a
a
a
a
a
a
a
a
a
a
a
a
a
a
a
a
a
a
a
a
a
a
a
a
a
a
a
f
"}
(59,1,1) = {"
a
a
a
a
a
a
a
a
a
a
a
g
a
a
a
a
a
a
a
a
a
a
a
a
a
a
a
a
b
x
d
d
d
d
x
b
a
a
a
a
a
a
a
a
a
a
a
a
a
a
a
a
a
a
a
a
a
a
a
a
a
a
a
f
"}
(60,1,1) = {"
a
a
a
a
a
a
a
a
a
a
a
g
a
a
a
a
a
a
a
a
a
a
a
a
a
a
a
a
b
x
d
d
D
d
x
b
a
a
a
a
a
a
a
a
a
a
a
a
a
a
a
a
a
a
a
a
a
a
a
a
a
a
a
f
"}
(61,1,1) = {"
a
a
a
a
a
a
a
a
a
a
a
g
a
a
a
a
a
a
a
a
a
a
a
a
a
a
a
a
b
x
d
d
d
d
x
b
a
a
a
a
a
a
a
a
a
a
a
a
a
a
a
a
a
a
a
a
a
a
a
a
a
a
a
f
"}
(62,1,1) = {"
a
a
a
a
a
a
a
a
a
a
a
f
a
a
a
a
a
a
a
a
a
a
a
a
a
a
a
a
b
x
d
d
d
d
x
b
a
a
a
a
a
a
a
a
a
a
a
a
a
a
a
a
a
a
a
a
a
a
a
a
a
a
a
f
"}
(63,1,1) = {"
a
a
a
a
a
a
a
a
a
a
a
a
a
a
a
a
a
a
a
a
a
a
a
a
a
a
a
a
b
x
d
d
d
d
x
b
a
f
f
f
f
f
f
f
f
f
f
f
f
f
f
f
f
f
f
f
f
f
f
f
f
f
f
f
"}
(64,1,1) = {"
a
a
a
a
a
a
a
a
a
a
a
a
a
a
a
a
a
a
a
a
a
a
a
a
a
a
a
a
b
x
d
d
d
d
x
b
a
a
a
a
a
a
a
a
a
a
a
a
a
a
a
a
a
a
a
a
a
a
a
a
a
a
a
a
"}
