"a" = (/turf/space,/area)
"b" = (/turf/simulated/wall/clockwork,/area)
"c" = (/turf/simulated/floor/clockwork/alt2,/area)
"d" = (/turf/simulated/floor/clockwork/reebe,/area)
"e" = (/turf/simulated/floor/clockwork/alt1,/area)
"f" = (/turf/simulated/floor/clockwork/alt3,/area)
"g" = (/turf/simulated/floor/clockwork/special,/area)
"h" = (/obj/structure/smooth/window/clockwork,/turf/simulated/floor/clockwork/reebe,/area)
"i" = (/obj/structure/smooth/table/brass,/turf/simulated/floor/clockwork/reebe,/area)
"j" = (/turf/unsimulated/abyss,/area)
"k" = (/turf/simulated/wall/rock/indestructable,/area)

(1,1,1) = {"
aaaaaaaaaaaaaaaaaaaaaaaaaaaaaaaaaaaaaaaaaaaaaaaaaaaaaaaaaaaaaaaa
aaaaaaaaaaaaaaaaaaaaaaaaaaaaaaaaaaaaaaaaaaaaaaaaaaaaaaaaaaaaaaaa
aaaaaaaaaaaaaaaaaaaaaaaaaaaaaaaaaaaaaaaaaaaaaaaaaaaaaaaaaaaaaaaa
aaaaaaaaaaaaaaaaaaaaaaaaaaaaaaaaaaaaaaaaaaaaaaaaaaaaaaaaaaaaaaaa
aaaaaaaaaaaaaaaaaaaaaaaaaaaaaaaaaaaaaaaaaaaaaaaaaaaaaaaaaaaaaaaa
aaaaaaaaaaaaaaaaaaaaaaaaaaaaaaaaaaaaaaaaaaaaaaaaaaaaaaaaaaaaaaaa
aaaaaaaaaaaaaaaaaaaaaaaaaaaaaaaaaaaaaaaaaaaaaaaaaaaaaaaaaaaaaaaa
aaaaaaaaaaaaaaaaaaaaaaaaaaaaaaaaaaaaaaaaaaaaaaaaaaaaaaaaaaaaaaaa
aaaaaaaaaaaaaaaaaaaaaaaaaaaaaaaaaaaaaaaaaaaaaaaaaaaaaaaaaaaaaaaa
aaaaaaaaaaaaaaaaaaaaaaaaaaaaaaaaaaaaaaaaaaaaaaaaaaaaaaaaaaaaaaaa
aaaaaaaaaaaaaaaaaaaaaaaaaaaaaaaaaaaaaaaaaaaaaaaaaaaaaaaaaaaaaaaa
aaaaaaaaaaaaaaaaaaaaaaaaaaaaaaaaaaaaaaaaaaaaaaaaaaaaaaaaaaaaaaaa
aaaaaaaaaaakkkkkkkkkkkkkkkkkkkkkkkkkkkkkkkkkkkkkkkkaaaaaaaaaaaaa
aaaaaaaaaaakbbbbbbbbbbbbbbbbbbbbbbbbbbbbbbbbbbbbbbkaaaaaaaaaaaaa
aaaaaaaaaaakbjjjjjjjjjjjjjjbceddecbjjjjjjjjjjjjjjbkaaaaaaaaaaaaa
aaaaaaaaaaakbjjjjjjjjjjjjjjheddddehjjjjjjjjjjjjjjbkaaaaaaaaaaaaa
aaaaaaaaaaakbjjjjjjjjjjjjjjhddddddhjjjjjjjjjjjjjjbkaaaaaaaaaaaaa
aaaaaaaaaaakbjjjjjjjjjjjjjjhddddddhjjjjjjjjjjjjjjbkaaaaaaaaaaaaa
aaaaaaaaaaakbjjjjjjjjjjjjjjheddddehjjjjjjjjjjjjjjbkaaaaaaaaaaaaa
aaaaaaaaaaakbjjjjjjjjjjjjjjbceddecbjjjjjjjjjjjjjjbkaaaaaaaaaaaaa
aaaaaaaaaaakbjjjjjjbbhhhhhbbbbffbbbbhhhhhbbjjjjjjbkaaaaaaaaaaaaa
aaaaaaaaaaakbjjjjjjbceffffffffffffffffffecbjjjjjjbkaaaaaaaaaaaaa
aaaaaaaaaaakbjjjjjjhddddddddddddddddddddddhjjjjjjbkaaaaaaaaaaaaa
aaaaaaaaaaakbjjjjjjbiiiiiiiiiiiiiiiiiiiiiibjjjjjjbkaaaaaaaaaaaaa
aaaaaaaaaaakbjjjjjjbbbbbbbbbbbbbbbbbbbbbbbbjjjjjjbkaaaaaaaaaaaaa
aaaaaaaaaaakbjjjjjjbiiiiiiiiiiiiiiiiiiiibbbjjjjjjbkaaaaaaaaaaaaa
aaaaaaaaaaakbjjjjjjhddddddddddddddddddddidhjjjjjjbkaaaaaaaaaaaaa
aaaaaaaaaaakbjjjjjjbbbbbbbbbdbbbbbdbbbbbbhbjjjjjjbkaaaaaaaaaaaaa
aaaaaaaaaaakbjjjjjjhdddbdddddbbdbbddddddbihjjjjjjbkaaaaaaaaaaaaa
aaaaaaaaaaakbjjjjjjhdbdbdbbbbbbbbbbbbbbbbhhjjjjjjbkaaaaaaaaaaaaa
aaaaaaaaaaakbjjjjjjhdbdbdbddddddddddddddbdhjjjjjjbkaaaaaaaaaaaaa
aaaaaaaaaaakbjjjjjjhdbdddddbbbdddbbbbbbdbdbjjjjjjbkaaaaaaaaaaaaa
aaaaaaaaaaakbjjjjjjhdddbbbdbdbhhhbdbddddddhjjjjjjbkaaaaaaaaaaaaa
aaaaaaaaaaakbjjjjjjhdbbbdddbdidddidbddbbbdhjjjjjjbkaaaaaaaaaaaaa
aaaaaaaaaaakbjjjjjjhdbdidbbbdidddidbbdidbdhjjjjjjbkaaaaaaaaaaaaa
aaaaaaaaaaakbjjjjjjhdbdbdddddidddiddddbdbdhjjjjjjbkaaaaaaaaaaaaa
aaaaaaaaaaakbjjjjjjbbbdbbbbbbbdddbbbbbbdbbbjjjjjjbkaaaaaaaaaaaaa
aaaaaaaaaaakbjjjjjjbeddddddddddddddddddddebjjjjjjbkaaaaaaaaaaaaa
aaaaaaaaaaakbjjjjjjbceffffgfgffffgfgffffecbjjjjjjbkaaaaaaaaaaaaa
aaaaaaaaaaakbjjjjjjbbhhhbbfdfbhhbfdfbbhhhbbjjjjjjbkaaaaaaaaaaaaa
aaaaaaaaaaakbjjjjjjjjjjjjbfdfhjjhfdfbjjjjjjjjjjjjbkaaaaaaaaaaaaa
aaaaaaaaaaakbjjjjjjjjjjjjhfdfhjjhfdfhjjjjjjjjjjjjbkaaaaaaaaaaaaa
aaaaaaaaaaakbjjjjjjjjjjjjhfdfhjjhfdfhjjjjjjjjjjjjbkaaaaaaaaaaaaa
aaaaaaaaaaakbjjjjjjjjjjjjhfdfhjjhfdfhjjjjjjjjjjjjbkaaaaaaaaaaaaa
aaaaaaaaaaakbjjjjjjjjjjjjhfdfhjjhfdfhjjjjjjjjjjjjbkaaaaaaaaaaaaa
aaaaaaaaaaakbjjjjjjjjjjjjhfdfhjjhfdfhjjjjjjjjjjjjbkaaaaaaaaaaaaa
aaaaaaaaaaakbjjjjjjjjjjjjbfdfhjjhfdfbjjjjjjjjjjjjbkaaaaaaaaaaaaa
aaaaaaaaaaakbbhhhhhhhhhhbbfdfbhhbfdfbbhhhhhhhhhhbbkaaaaaaaaaaaaa
aaaaaaaaaaakbcefffffffffffgfgffffgfgfffffffffffecbkaaaaaaaaaaaaa
aaaaaaaaaaakbeddddddddddddddddddddddddddddddddddebkaaaaaaaaaaaaa
aaaaaaaaaaakbfddddddddddddddddddddddddddddddddddfbkaaaaaaaaaaaaa
aaaaaaaaaaakbfddddddddddddddddddddddddddddddddddfbkaaaaaaaaaaaaa
aaaaaaaaaaakbfddddddddddddddddddddddddddddddddddfbkaaaaaaaaaaaaa
aaaaaaaaaaakbfddddddddddddddddddddddddddddddddddfbkaaaaaaaaaaaaa
aaaaaaaaaaakbfddddddddddddddddddddddddddddddddddfbkaaaaaaaaaaaaa
aaaaaaaaaaakbfddddddddddddddddddddddddddddddddddfbkaaaaaaaaaaaaa
aaaaaaaaaaakbeddddddddddddgffffffffgddddddddddddebkaaaaaaaaaaaaa
aaaaaaaaaaakbceffffffffffffddddddddffffffffffffecbkaaaaaaaaaaaaa
aaaaaaaaaaakbbhhhhhhhhhhhbgffffffffgbhhhhhhhhhhhbbkaaaaaaaaaaaaa
aaaaaaaaaaaaaaaaaaaaaaaaaaaaaaaaaaaaaaaaaaaaaaaaaaaaaaaaaaaaaaaa
aaaaaaaaaaaaaaaaaaaaaaaaaaaaaaaaaaaaaaaaaaaaaaaaaaaaaaaaaaaaaaaa
aaaaaaaaaaaaaaaaaaaaaaaaaaaaaaaaaaaaaaaaaaaaaaaaaaaaaaaaaaaaaaaa
aaaaaaaaaaaaaaaaaaaaaaaaaaaaaaaaaaaaaaaaaaaaaaaaaaaaaaaaaaaaaaaa
aaaaaaaaaaaaaaaaaaaaaaaaaaaaaaaaaaaaaaaaaaaaaaaaaaaaaaaaaaaaaaaa
"}
