//MAP CONVERTED BY dmm2tgm.py THIS HEADER COMMENT PREVENTS RECONVERSION, DO NOT REMOVE
"a" = (
/turf/space,
/area)
"b" = (
/turf/simulated/wall/cult,
/area)
"c" = (
/obj/structure/interactive/lighting/cult_pylon,
/turf/simulated/floor/cult,
/area)
"d" = (
/turf/simulated/floor/cult,
/area)
"e" = (
/obj/structure/smooth/table/cult,
/turf/simulated/floor/cult,
/area)
"f" = (
/obj/structure/interactive/lighting/cult_pylon,
/turf/simulated/floor/cult/darker,
/area)
"g" = (
/obj/structure/smooth/table/cult,
/turf/simulated/floor/cult/darker,
/area)
"h" = (
/turf/simulated/floor/cult/darker,
/area)
"i" = (
/turf/simulated/floor/stair/cult{
	icon_state = "stair";
	dir = 1
	},
/area)
"j" = (
/turf/simulated/floor/stair/cult,
/area)
"k" = (
/turf/simulated/floor/stair/cult{
	icon_state = "stair";
	dir = 4
	},
/area)
"l" = (
/mob/living/simple/cult/construct/behemoth,
/turf/simulated/floor/cult,
/area)
"m" = (
/mob/living/advanced/npc/cultist,
/turf/simulated/floor/cult,
/area)
"n" = (
/mob/living/advanced/npc/cultist{
	icon_state = "directional";
	dir = 4
	},
/turf/simulated/floor/cult,
/area)
"o" = (
/mob/living/advanced/npc/cultist{
	icon_state = "directional";
	dir = 8
	},
/turf/simulated/floor/cult,
/area)
"p" = (
/mob/living/advanced/npc/cultist{
	icon_state = "directional";
	dir = 1
	},
/turf/simulated/floor/cult,
/area)
"q" = (
/mob/living/simple/cult/construct/behemoth,
/turf/simulated/floor/cult/darker,
/area)
"r" = (
/mob/living/simple/cult/construct/artificer,
/turf/simulated/floor/cult,
/area)
"s" = (
/mob/living/simple/cult/construct/floating,
/turf/simulated/floor/cult,
/area)
"t" = (
/mob/living/simple/cult/construct/chosen,
/turf/simulated/floor/cult,
/area)
"u" = (
/obj/marker/objective_spawn,
/turf/simulated/floor/cult/darker,
/area)

(1,1,1) = {"
a
a
a
a
a
a
a
a
a
a
a
a
a
a
a
a
a
a
a
a
a
a
a
a
a
a
a
a
a
a
a
a
a
a
a
a
a
a
a
a
a
a
a
a
a
a
a
a
a
a
a
a
a
a
a
a
a
a
a
a
a
a
a
a
"}
(2,1,1) = {"
a
a
a
a
a
a
a
a
a
a
a
a
a
a
a
a
a
a
a
a
a
a
a
a
a
a
a
a
a
a
a
a
a
a
a
a
a
a
a
a
a
a
a
a
a
a
a
a
a
a
a
a
a
a
a
a
a
a
a
a
a
a
a
a
"}
(3,1,1) = {"
a
a
a
a
a
a
a
a
a
a
a
a
a
a
a
a
a
a
a
a
a
a
a
a
a
a
a
a
a
a
a
a
a
a
a
a
a
a
a
a
a
a
a
a
a
a
a
a
a
a
a
a
a
a
a
a
a
a
a
a
a
a
a
a
"}
(4,1,1) = {"
a
a
a
a
a
a
a
a
a
a
a
a
a
a
a
a
a
a
a
a
a
a
a
a
a
a
a
a
a
a
a
a
a
a
a
a
a
a
a
a
a
a
a
a
a
a
a
a
a
a
a
a
a
a
a
a
a
a
a
a
a
a
a
a
"}
(5,1,1) = {"
a
a
a
a
a
a
a
a
a
a
a
a
a
a
a
a
a
a
a
a
a
a
a
a
a
a
a
a
a
a
a
a
a
a
a
a
a
a
a
a
a
a
a
a
a
a
a
a
a
a
a
a
a
a
a
a
a
a
a
a
a
a
a
a
"}
(6,1,1) = {"
a
a
a
a
a
a
a
a
a
a
a
a
a
a
a
a
a
a
a
a
a
a
a
a
a
a
a
a
a
a
a
a
a
a
a
a
a
a
a
a
a
a
a
a
a
a
a
a
a
a
a
a
a
a
a
a
a
a
a
a
a
a
a
a
"}
(7,1,1) = {"
a
a
a
a
a
a
a
a
a
a
a
a
a
a
a
a
a
a
a
a
a
a
a
a
a
a
a
a
a
a
a
a
a
a
a
a
a
a
a
a
a
a
a
a
a
a
a
a
a
a
a
a
a
a
a
a
a
a
a
a
a
a
a
a
"}
(8,1,1) = {"
a
a
a
a
a
a
a
a
a
a
a
a
a
a
a
a
a
a
a
a
a
a
a
a
a
a
a
a
a
a
a
a
a
a
a
a
a
a
a
a
a
a
a
a
a
a
a
a
a
a
a
a
a
a
a
a
a
a
a
a
a
a
a
a
"}
(9,1,1) = {"
a
a
a
a
a
a
a
a
a
a
a
a
a
a
a
a
a
a
a
a
a
a
a
a
a
a
a
a
a
a
a
a
a
a
a
a
a
a
a
a
a
a
a
a
a
a
a
a
a
a
a
a
a
a
a
a
a
a
a
a
a
a
a
a
"}
(10,1,1) = {"
a
a
a
a
a
a
a
a
a
a
a
a
a
a
a
a
a
a
a
a
a
a
a
a
a
a
a
a
a
a
a
a
a
a
a
a
a
a
a
a
a
a
a
a
a
a
a
a
a
a
a
a
a
a
a
a
a
a
a
a
a
a
a
a
"}
(11,1,1) = {"
a
a
a
a
a
a
a
a
a
a
a
b
b
b
b
d
d
d
d
d
d
d
d
b
b
b
b
b
d
d
d
d
d
d
b
b
b
b
b
b
b
b
b
b
b
b
b
b
b
b
b
b
b
b
a
a
a
a
a
a
a
a
a
a
"}
(12,1,1) = {"
a
a
a
a
a
a
a
a
a
a
a
b
c
d
d
d
d
d
d
d
d
d
d
d
c
b
c
d
d
d
d
d
d
d
d
c
b
c
e
e
e
e
e
e
c
b
c
d
d
d
d
d
c
b
a
a
a
a
a
a
a
a
a
a
"}
(13,1,1) = {"
a
a
a
a
a
a
a
a
a
a
a
b
d
d
d
d
d
d
d
d
d
d
d
d
d
b
d
d
o
d
d
d
o
d
d
d
b
d
d
d
d
d
d
d
d
b
d
d
d
d
d
d
e
b
a
a
a
a
a
a
a
a
a
a
"}
(14,1,1) = {"
a
a
a
a
a
a
a
a
a
a
a
b
d
d
d
d
d
d
d
d
d
d
d
d
d
d
d
d
d
d
d
d
d
d
d
d
d
d
d
d
d
d
r
d
d
b
d
d
d
d
r
d
e
b
a
a
a
a
a
a
a
a
a
a
"}
(15,1,1) = {"
a
a
a
a
a
a
a
a
a
a
a
d
d
d
d
d
d
d
n
d
d
d
d
d
d
d
d
d
d
d
d
d
d
d
d
d
d
d
d
l
d
d
d
d
d
b
d
d
d
d
d
d
e
b
a
a
a
a
a
a
a
a
a
a
"}
(16,1,1) = {"
a
a
a
a
a
a
a
a
a
a
a
d
d
d
d
d
e
e
e
e
e
d
d
d
d
b
d
d
d
d
d
o
d
d
d
d
b
d
d
d
d
d
d
d
d
b
d
d
l
d
d
d
e
b
a
a
a
a
a
a
a
a
a
a
"}
(17,1,1) = {"
a
a
a
a
a
a
a
a
a
a
a
d
d
d
d
d
e
e
e
e
e
p
d
d
d
b
c
d
d
d
d
d
d
d
d
c
b
c
d
d
d
d
d
d
c
b
d
d
d
d
d
d
e
b
a
a
a
a
a
a
a
a
a
a
"}
(18,1,1) = {"
a
a
a
a
a
a
a
a
a
a
a
d
d
d
d
m
e
e
e
e
e
d
d
d
d
b
b
b
b
b
b
b
b
b
b
b
b
b
b
b
b
k
k
b
b
b
d
d
d
d
d
d
e
b
a
a
a
a
a
a
a
a
a
a
"}
(19,1,1) = {"
a
a
a
a
a
a
a
a
a
a
a
d
d
d
d
d
e
e
e
e
e
d
d
d
d
b
c
d
d
d
d
d
d
d
d
c
b
f
h
h
h
h
h
h
f
b
c
d
d
d
d
d
c
b
a
a
a
a
a
a
a
a
a
a
"}
(20,1,1) = {"
a
a
a
a
a
a
a
a
a
a
a
d
d
d
d
d
d
d
o
d
d
d
d
d
d
d
d
d
d
d
d
d
d
d
d
d
b
h
h
h
h
h
h
h
h
b
b
b
b
d
b
b
b
b
a
a
a
a
a
a
a
a
a
a
"}
(21,1,1) = {"
a
a
a
a
a
a
a
a
a
a
a
d
d
d
d
d
d
d
d
d
d
d
d
d
d
d
d
d
d
d
d
d
d
d
d
d
j
h
h
h
h
h
h
h
h
b
c
d
d
d
d
d
c
b
a
a
a
a
a
a
a
a
a
a
"}
(22,1,1) = {"
a
a
a
a
a
a
a
a
a
a
a
b
d
d
d
d
d
d
d
d
d
d
d
d
d
b
c
d
d
d
d
d
d
d
d
d
j
h
h
h
h
h
h
h
h
i
d
d
d
d
d
d
d
b
a
a
a
a
a
a
a
a
a
a
"}
(23,1,1) = {"
a
a
a
a
a
a
a
a
a
a
a
b
c
d
d
d
d
d
d
d
d
d
d
d
c
b
b
b
b
b
b
b
d
d
d
d
b
h
h
h
h
h
h
h
h
i
d
d
d
d
d
d
d
b
a
a
a
a
a
a
a
a
a
a
"}
(24,1,1) = {"
a
a
a
a
a
a
a
a
a
a
a
b
b
b
b
b
b
d
d
b
b
b
b
b
b
b
f
h
h
h
f
b
c
d
d
c
b
f
h
h
h
h
h
h
f
b
c
d
d
d
d
d
d
b
a
a
a
a
a
a
a
a
a
a
"}
(25,1,1) = {"
a
a
a
a
a
a
a
a
a
a
a
b
c
d
b
c
d
d
d
d
c
b
f
h
h
h
h
h
h
h
h
b
b
b
b
b
b
b
b
b
b
b
b
b
b
b
b
b
b
d
r
d
d
b
a
a
a
a
a
a
a
a
a
a
"}
(26,1,1) = {"
a
a
a
a
a
a
a
a
a
a
a
b
d
d
b
d
d
d
d
d
d
b
g
h
h
h
h
h
u
h
h
b
c
e
e
e
e
e
e
c
b
c
d
n
d
n
d
c
b
d
d
d
d
b
a
a
a
a
a
a
a
a
a
a
"}
(27,1,1) = {"
a
a
a
a
a
a
a
a
a
a
a
b
d
d
d
d
d
l
d
d
d
b
g
h
h
h
h
h
h
h
h
b
d
d
d
d
d
d
d
d
b
d
d
d
d
d
d
e
b
d
d
d
d
b
a
a
a
a
a
a
a
a
a
a
"}
(28,1,1) = {"
a
a
a
a
a
a
a
a
a
a
a
b
d
d
d
d
d
d
d
d
d
b
g
h
q
h
h
h
h
h
h
b
d
d
d
d
d
d
d
d
b
d
d
d
d
d
d
e
b
d
d
d
d
d
a
a
a
a
a
a
a
a
a
a
"}
(29,1,1) = {"
a
a
a
a
a
a
a
a
a
a
a
b
d
d
b
d
d
d
d
d
d
b
g
h
h
h
h
h
h
h
h
i
d
s
d
d
d
s
d
d
d
d
d
d
d
d
d
e
b
d
d
d
d
d
a
a
a
a
a
a
a
a
a
a
"}
(30,1,1) = {"
a
a
a
a
a
a
a
a
a
a
a
b
d
d
b
c
d
d
d
d
c
b
g
h
h
h
h
h
h
h
h
i
d
d
d
d
d
d
d
d
d
d
d
d
d
d
d
e
b
d
d
d
d
d
a
a
a
a
a
a
a
a
a
a
"}
(31,1,1) = {"
a
a
a
a
a
a
a
a
a
a
a
b
d
d
b
b
b
d
d
d
b
b
g
h
h
h
h
h
h
h
h
i
d
d
d
d
d
d
d
d
d
d
d
d
d
d
d
e
b
d
l
d
d
d
a
a
a
a
a
a
a
a
a
a
"}
(32,1,1) = {"
a
a
a
a
a
a
a
a
a
a
a
b
d
d
c
b
c
d
d
d
c
b
g
h
h
h
h
h
h
h
h
b
d
d
d
e
e
e
d
d
d
d
d
d
d
d
d
e
b
d
d
d
d
d
a
a
a
a
a
a
a
a
a
a
"}
(33,1,1) = {"
a
a
a
a
a
a
a
a
a
a
a
b
d
d
d
b
e
d
d
d
d
b
g
h
h
h
h
h
h
h
h
b
d
d
d
e
e
e
d
d
b
d
d
d
d
d
d
e
b
d
d
d
d
d
a
a
a
a
a
a
a
a
a
a
"}
(34,1,1) = {"
a
a
a
a
a
a
a
a
a
a
a
b
d
d
d
b
e
d
o
d
d
b
g
h
h
h
h
h
q
h
h
b
d
d
d
e
e
e
d
d
b
d
d
d
d
d
d
e
b
d
d
d
d
d
a
a
a
a
a
a
a
a
a
a
"}
(35,1,1) = {"
a
a
a
a
a
a
a
a
a
a
a
b
d
d
d
b
e
d
d
d
d
b
g
h
u
h
h
h
h
h
h
b
d
d
d
d
d
d
d
d
b
d
d
d
d
d
d
e
b
d
d
d
d
d
a
a
a
a
a
a
a
a
a
a
"}
(36,1,1) = {"
a
a
a
a
a
a
a
a
a
a
a
d
d
d
d
b
e
d
d
d
d
b
f
h
h
h
h
h
h
h
f
b
d
d
d
d
d
d
d
d
b
d
d
d
d
d
d
e
b
d
d
d
d
d
a
a
a
a
a
a
a
a
a
a
"}
(37,1,1) = {"
a
a
a
a
a
a
a
a
a
a
a
d
d
d
d
b
e
d
d
d
d
b
b
b
b
b
b
b
b
b
b
b
d
d
d
d
d
d
d
d
b
c
d
d
d
d
d
c
b
d
d
l
d
d
a
a
a
a
a
a
a
a
a
a
"}
(38,1,1) = {"
a
a
a
a
a
a
a
a
a
a
a
d
d
d
d
b
e
d
d
d
d
d
d
d
d
d
d
d
c
b
c
d
d
d
d
d
d
d
d
d
b
b
b
d
d
d
b
b
b
d
d
d
d
d
a
a
a
a
a
a
a
a
a
a
"}
(39,1,1) = {"
a
a
a
a
a
a
a
a
a
a
a
d
d
d
d
b
e
d
d
d
d
o
d
d
d
d
d
d
d
d
d
d
d
d
d
d
d
s
d
d
b
c
d
d
d
d
d
c
b
d
d
d
d
d
a
a
a
a
a
a
a
a
a
a
"}
(40,1,1) = {"
a
a
a
a
a
a
a
a
a
a
a
d
l
d
d
b
e
d
o
d
d
d
d
d
r
d
d
d
d
d
d
d
d
d
d
d
d
d
d
d
b
d
d
d
d
d
d
d
b
d
d
d
d
d
a
a
a
a
a
a
a
a
a
a
"}
(41,1,1) = {"
a
a
a
a
a
a
a
a
a
a
a
d
d
d
d
b
c
d
d
d
d
d
d
d
d
d
d
d
c
b
c
d
d
d
d
d
d
d
d
c
b
d
d
d
d
d
d
p
b
d
d
d
d
d
a
a
a
a
a
a
a
a
a
a
"}
(42,1,1) = {"
a
a
a
a
a
a
a
a
a
a
a
d
d
d
d
b
b
b
b
b
b
b
b
b
b
b
b
b
b
b
b
b
b
b
b
b
b
b
b
b
b
d
d
e
e
e
d
d
b
d
d
d
d
b
a
a
a
a
a
a
a
a
a
a
"}
(43,1,1) = {"
a
a
a
a
a
a
a
a
a
a
a
d
d
d
d
b
c
d
d
d
d
d
c
b
c
e
e
e
e
e
e
e
e
e
c
b
c
e
e
e
e
d
d
e
e
e
d
d
b
d
d
d
d
b
a
a
a
a
a
a
a
a
a
a
"}
(44,1,1) = {"
a
a
a
a
a
a
a
a
a
a
a
d
d
d
d
b
d
m
d
d
d
d
d
b
d
d
d
d
d
d
d
d
d
d
d
b
d
d
d
d
d
d
d
e
e
e
d
p
b
d
r
d
d
b
a
a
a
a
a
a
a
a
a
a
"}
(45,1,1) = {"
a
a
a
a
a
a
a
a
a
a
a
b
d
d
d
d
d
d
d
d
m
d
d
d
d
d
d
d
d
d
d
d
d
d
d
d
d
d
d
d
d
d
d
d
d
d
d
d
b
d
d
d
d
b
a
a
a
a
a
a
a
a
a
a
"}
(46,1,1) = {"
a
a
a
a
a
a
a
a
a
a
a
b
d
d
d
d
d
d
d
d
d
d
d
b
d
d
d
d
d
d
d
d
d
d
d
b
d
d
d
d
d
d
d
d
d
d
d
d
b
d
d
d
d
b
a
a
a
a
a
a
a
a
a
a
"}
(47,1,1) = {"
a
a
a
a
a
a
a
a
a
a
a
b
d
d
d
d
d
d
d
d
d
d
d
b
d
d
d
d
d
d
d
d
d
d
d
b
c
d
d
d
d
d
d
d
d
d
d
c
b
c
d
d
c
b
a
a
a
a
a
a
a
a
a
a
"}
(48,1,1) = {"
a
a
a
a
a
a
a
a
a
a
a
b
d
d
d
b
d
d
d
m
d
d
d
b
c
d
o
d
d
d
d
o
d
d
c
b
b
b
b
b
b
b
b
d
d
d
b
b
b
b
d
d
b
b
a
a
a
a
a
a
a
a
a
a
"}
(49,1,1) = {"
a
a
a
a
a
a
a
a
a
a
a
b
d
d
d
b
c
d
d
d
d
d
c
b
b
b
b
b
b
b
b
b
b
b
b
b
c
d
d
d
d
d
d
d
d
d
d
d
d
d
d
d
c
b
a
a
a
a
a
a
a
a
a
a
"}
(50,1,1) = {"
a
a
a
a
a
a
a
a
a
a
a
b
d
d
d
b
b
b
b
b
b
b
b
b
c
d
d
d
d
d
d
d
d
d
d
d
d
d
d
d
d
d
d
d
d
d
d
d
d
d
d
d
d
b
a
a
a
a
a
a
a
a
a
a
"}
(51,1,1) = {"
a
a
a
a
a
a
a
a
a
a
a
b
d
d
d
b
c
d
d
d
d
d
d
d
d
d
d
d
d
d
d
d
d
d
d
d
d
d
d
d
d
d
d
d
d
d
d
d
r
d
d
d
d
b
a
a
a
a
a
a
a
a
a
a
"}
(52,1,1) = {"
a
a
a
a
a
a
a
a
a
a
a
b
d
d
d
d
d
d
d
d
d
d
d
d
d
d
d
d
d
d
d
d
d
d
d
d
d
t
d
d
d
d
d
d
d
d
d
d
d
d
d
d
d
b
a
a
a
a
a
a
a
a
a
a
"}
(53,1,1) = {"
a
a
a
a
a
a
a
a
a
a
a
b
d
d
d
d
d
d
d
d
d
d
d
d
d
r
d
d
d
d
d
d
d
d
d
d
d
d
d
d
d
d
d
d
d
d
d
d
d
d
d
d
d
b
a
a
a
a
a
a
a
a
a
a
"}
(54,1,1) = {"
a
a
a
a
a
a
a
a
a
a
a
b
c
d
d
b
c
d
d
d
d
d
d
d
d
d
d
d
d
d
d
d
d
d
d
d
d
d
d
d
d
d
d
d
d
d
d
d
d
d
d
d
c
b
a
a
a
a
a
a
a
a
a
a
"}
(55,1,1) = {"
a
a
a
a
a
a
a
a
a
a
a
b
b
b
b
b
b
b
b
d
d
d
d
d
d
d
d
b
b
b
b
b
b
b
b
b
b
b
b
b
b
d
d
d
d
d
d
d
d
d
b
b
b
b
a
a
a
a
a
a
a
a
a
a
"}
(56,1,1) = {"
a
a
a
a
a
a
a
a
a
a
a
a
a
a
a
a
a
a
a
a
a
a
a
a
a
a
a
a
a
a
a
a
a
a
a
a
a
a
a
a
a
a
a
a
a
a
a
a
a
a
a
a
a
a
a
a
a
a
a
a
a
a
a
a
"}
(57,1,1) = {"
a
a
a
a
a
a
a
a
a
a
a
a
a
a
a
a
a
a
a
a
a
a
a
a
a
a
a
a
a
a
a
a
a
a
a
a
a
a
a
a
a
a
a
a
a
a
a
a
a
a
a
a
a
a
a
a
a
a
a
a
a
a
a
a
"}
(58,1,1) = {"
a
a
a
a
a
a
a
a
a
a
a
a
a
a
a
a
a
a
a
a
a
a
a
a
a
a
a
a
a
a
a
a
a
a
a
a
a
a
a
a
a
a
a
a
a
a
a
a
a
a
a
a
a
a
a
a
a
a
a
a
a
a
a
a
"}
(59,1,1) = {"
a
a
a
a
a
a
a
a
a
a
a
a
a
a
a
a
a
a
a
a
a
a
a
a
a
a
a
a
a
a
a
a
a
a
a
a
a
a
a
a
a
a
a
a
a
a
a
a
a
a
a
a
a
a
a
a
a
a
a
a
a
a
a
a
"}
(60,1,1) = {"
a
a
a
a
a
a
a
a
a
a
a
a
a
a
a
a
a
a
a
a
a
a
a
a
a
a
a
a
a
a
a
a
a
a
a
a
a
a
a
a
a
a
a
a
a
a
a
a
a
a
a
a
a
a
a
a
a
a
a
a
a
a
a
a
"}
(61,1,1) = {"
a
a
a
a
a
a
a
a
a
a
a
a
a
a
a
a
a
a
a
a
a
a
a
a
a
a
a
a
a
a
a
a
a
a
a
a
a
a
a
a
a
a
a
a
a
a
a
a
a
a
a
a
a
a
a
a
a
a
a
a
a
a
a
a
"}
(62,1,1) = {"
a
a
a
a
a
a
a
a
a
a
a
a
a
a
a
a
a
a
a
a
a
a
a
a
a
a
a
a
a
a
a
a
a
a
a
a
a
a
a
a
a
a
a
a
a
a
a
a
a
a
a
a
a
a
a
a
a
a
a
a
a
a
a
a
"}
(63,1,1) = {"
a
a
a
a
a
a
a
a
a
a
a
a
a
a
a
a
a
a
a
a
a
a
a
a
a
a
a
a
a
a
a
a
a
a
a
a
a
a
a
a
a
a
a
a
a
a
a
a
a
a
a
a
a
a
a
a
a
a
a
a
a
a
a
a
"}
(64,1,1) = {"
a
a
a
a
a
a
a
a
a
a
a
a
a
a
a
a
a
a
a
a
a
a
a
a
a
a
a
a
a
a
a
a
a
a
a
a
a
a
a
a
a
a
a
a
a
a
a
a
a
a
a
a
a
a
a
a
a
a
a
a
a
a
a
a
"}
