"a" = (/turf/dmm_suite/clear_turf,/area/dmm_suite/clear_area)
"b" = (/obj/structure/shuttle_engine/burst/right{icon_state = "burst_r"; dir = 1},/turf/simulated/floor/plating/shuttle,/area/shuttle/teal_bullet)
"c" = (/obj/structure/shuttle_engine/burst{icon_state = "burst_s"; dir = 1},/turf/simulated/floor/plating/shuttle,/area/shuttle/teal_bullet)
"d" = (/obj/structure/shuttle_engine/burst/left{icon_state = "burst_l"; dir = 1},/turf/simulated/floor/plating/shuttle,/area/shuttle/teal_bullet)
"e" = (/turf/simulated/wall/metal/shuttle/off_white,/area/shuttle/teal_bullet)
"f" = (/obj/structure/window/directional/anchored{icon_state = "single"; dir = 5},/obj/structure/table/steel,/turf/simulated/floor/plating/shuttle,/area/shuttle/teal_bullet)
"g" = (/obj/structure/shuttle_engine/heater{icon_state = "heater"; dir = 1},/obj/structure/window/directional/anchored,/turf/simulated/floor/plating/shuttle,/area/shuttle/teal_bullet)
"h" = (/obj/structure/window/directional/anchored{icon_state = "single"; dir = 9},/obj/structure/table/steel,/turf/simulated/floor/plating/shuttle,/area/shuttle/teal_bullet)
"i" = (/obj/structure/interactive/door/airlock/external,/turf/simulated/floor/tile/shuttle/cyan,/area/shuttle/teal_bullet)
"j" = (/turf/simulated/floor/tile/shuttle/cyan,/area/shuttle/teal_bullet)
"k" = (/obj/shuttle_controller,/turf/simulated/floor/tile/shuttle,/area/shuttle/teal_bullet)
"l" = (/obj/marker/spawning/window/shuttle,/turf/simulated/floor/plating/shuttle,/area/shuttle/teal_bullet)
"m" = (/obj/structure/interactive/chair/shuttle,/turf/simulated/floor/tile/shuttle/cyan,/area/shuttle/teal_bullet)
"n" = (/obj/structure/sign/no_smoking,/turf/simulated/wall/metal/shuttle/off_white,/area/shuttle/teal_bullet)
"o" = (/obj/structure/interactive/lighting/fixture/tube{icon_state = "preview"; dir = 4},/turf/simulated/floor/tile/shuttle/cyan,/area/shuttle/teal_bullet)
"p" = (/obj/structure/interactive/lighting/fixture/tube{icon_state = "preview"; dir = 8},/turf/simulated/floor/tile/shuttle/cyan,/area/shuttle/teal_bullet)
"q" = (/turf/simulated/floor/tile/shuttle,/area/shuttle/teal_bullet)
"r" = (/turf/simulated/floor/plating/shuttle,/area/shuttle/teal_bullet)
"s" = (/mob/living/simple/turret/nanotrasen,/turf/simulated/floor/plating/shuttle,/area/shuttle/teal_bullet)
"t" = (/obj/structure/interactive/chair/shuttle,/turf/simulated/floor/tile/shuttle,/area/shuttle/teal_bullet)
"u" = (/obj/structure/interactive/computer/console/flight_control{icon_state = "computer"; dir = 1},/turf/simulated/floor/tile/shuttle,/area/shuttle/teal_bullet)

(1,1,1) = {"
aaabcdaaa
arefghera
arijkjira
arlmqmlra
aalmqmlaa
aanotpnaa
aallullaa
aaslllsaa
aaararaaa
"}
