"a" = (/turf/dmm_suite/clear_turf,/area/dmm_suite/clear_area)
"b" = (/turf/simulated/wall/rock/indestructable,/area/prefab/clockwork_cult)
"c" = (/turf/simulated/wall/clockwork/indestructable,/area/prefab/clockwork_cult)
"d" = (/turf/simulated/wall/clockwork,/area/prefab/clockwork_cult)
"e" = (/turf/unsimulated/abyss,/area/prefab/clockwork_cult)
"f" = (/mob/living/simple/parrot/clockwork,/turf/simulated/floor/clockwork/reebe,/area/prefab/clockwork_cult)
"g" = (/turf/simulated/floor/clockwork/alt1,/area/prefab/clockwork_cult)
"h" = (/obj/structure/table/brass,/turf/simulated/floor/clockwork/alt1,/area/prefab/clockwork_cult)
"i" = (/obj/structure/window/clockwork,/turf/simulated/floor/clockwork/reebe,/area/prefab/clockwork_cult)
"j" = (/obj/marker/map_node,/turf/simulated/floor/clockwork/reebe,/area/prefab/clockwork_cult)
"k" = (/mob/living/advanced/npc/clockwork_cultist,/turf/simulated/floor/clockwork/reebe,/area/prefab/clockwork_cult)
"l" = (/obj/structure/window/clockwork,/turf/simulated/floor/clockwork/alt1,/area/prefab/clockwork_cult)
"m" = (/mob/living/simple/watcher/clockwork{dir = 4; icon_state = "warden"},/turf/simulated/floor/clockwork/alt2,/area/prefab/clockwork_cult)
"n" = (/mob/living/simple/watcher/clockwork,/turf/simulated/floor/clockwork/reebe,/area/prefab/clockwork_cult)
"o" = (/mob/living/simple/watcher/clockwork{dir = 8; icon_state = "warden"},/turf/simulated/floor/clockwork/alt2,/area/prefab/clockwork_cult)
"p" = (/obj/structure/window/clockwork,/turf/simulated/floor/clockwork/alt3,/area/prefab/clockwork_cult)
"q" = (/turf/simulated/floor/clockwork/alt3,/area/prefab/clockwork_cult)
"r" = (/turf/simulated/floor/clockwork/reebe,/area/prefab/clockwork_cult)
"s" = (/turf/simulated/wall/clockwork/tough,/area/prefab/clockwork_cult)
"t" = (/mob/living/advanced/npc/clockwork_cultist{dir = 1; icon_state = "directional"},/turf/simulated/floor/clockwork/reebe,/area/prefab/clockwork_cult)
"u" = (/mob/living/simple/clockwork_marauder,/turf/simulated/floor/clockwork/reebe,/area/prefab/clockwork_cult)
"v" = (/mob/living/simple/clockwork_marauder{dir = 4; icon_state = "living"},/turf/simulated/floor/clockwork/reebe,/area/prefab/clockwork_cult)
"w" = (/mob/living/simple/clockwork_marauder{dir = 8; icon_state = "living"},/turf/simulated/floor/clockwork/reebe,/area/prefab/clockwork_cult)
"x" = (/mob/living/simple/watcher/clockwork{dir = 4; icon_state = "warden"},/turf/simulated/floor/clockwork/reebe,/area/prefab/clockwork_cult)
"y" = (/mob/living/simple/watcher/clockwork{dir = 8; icon_state = "warden"},/turf/simulated/floor/clockwork/reebe,/area/prefab/clockwork_cult)
"z" = (/mob/living/advanced/npc/clockwork_cultist{dir = 4; icon_state = "directional"},/turf/simulated/floor/clockwork/reebe,/area/prefab/clockwork_cult)
"A" = (/mob/living/advanced/npc/clockwork_cultist{dir = 8; icon_state = "directional"},/turf/simulated/floor/clockwork/reebe,/area/prefab/clockwork_cult)
"B" = (/turf/simulated/floor/clockwork/special,/area/prefab/clockwork_cult)
"C" = (/mob/living/simple/clockwork_marauder,/turf/simulated/floor/clockwork/alt3,/area/prefab/clockwork_cult)
"D" = (/mob/living/simple/clockwork_fragment,/turf/simulated/floor/clockwork/reebe,/area/prefab/clockwork_cult)
"E" = (/obj/structure/table/brass,/turf/simulated/floor/clockwork/alt3,/area/prefab/clockwork_cult)
"F" = (/turf/dmm_suite/no_wall,/area/dmm_suite/clear_area)
"G" = (/mob/living/simple/turret/clockwork,/turf/simulated/floor/clockwork/alt2,/area/prefab/clockwork_cult)
"H" = (/mob/living/simple/watcher/clockwork_mobile,/turf/simulated/floor/clockwork/reebe,/area/prefab/clockwork_cult)
"I" = (/obj/structure/table/brass,/turf/simulated/floor/clockwork/special,/area/prefab/clockwork_cult)
"J" = (/obj/structure/table/brass,/turf/simulated/floor/clockwork/reebe,/area/prefab/clockwork_cult)
"K" = (/obj/marker/map_node,/turf/simulated/floor/clockwork/alt3,/area/prefab/clockwork_cult)
"L" = (/obj/marker/map_node,/turf/dmm_suite/no_wall,/area/dmm_suite/clear_area)
"S" = (/obj/structure/interactive/crate/chest/filled,/turf/simulated/floor/clockwork/alt3,/area/prefab/clockwork_cult)

(1,1,1) = {"
aaaaaaaaaaaaaaaaaaaaaaaaaaaaaaaaaaaaaaaaaaaaaaaaaaaaaaaaaaaaaaaa
aaaaaaaaaaaaaaaaaaaaaaaaaaaaaaaaaaaaaaaaaaaaaaaaaaaaaaaaaaaaaaaa
aaaaaaaaaaaaaaaaaaaaaaaaaaaaaaaaaaaaaaaaaaaaaaaaaaaaaaaaaaaaaaaa
aaaaaaaaaaaaaaaaaaaaaaaaaaaaaaaaaaaaaaaaaaaaaaaaaaaaaaaaaaaaaaaa
aaaaaaaaaaaaaaaaaaaaaaaaaaaaaaaaaaaaaaaaaaaaaaaaaaaaaaaaaaaaaaaa
aaaaaaaaaaaaaaaaaaaaaaaaaaaaaaaaaaaaaaaaaaaaaaaaaaaaaaaaaaaaaaaa
aaaaaaaaaaaaaaaaaaaaaaaaaaaaaaaaaaaaaaaaaaaaaaaaaaaaaaaaaaaaaaaa
aaaaaaaaaaaaaaaaaaaaaaaaaaaaaaaaaaaaaaaaaaaaaaaaaaaaaaaaaaaaaaaa
aaaaaaaaaaaaaaaaaaaaaaaaaaaaaaaaaaaaaaaaaaaaaaaaaaaaaaaaaaaaaaaa
aaaaaaaaaaaaaaaaaaaaaaaaaaaaaaaaaaaaaaaaaaaaaaaaaaaaaaaaaaaaaaaa
aaaaaaaaaaaaaaaaaaaaaaaaaaaaaaaaaaaaaaaaaaaaaaaaaaaaaaaaaaaaaaaa
aaaaaaaaaaaaaaaaaaaaaaaaaaaaaaaaaaaaaaaaaaaaaaaaaaaaaaaaaaaaaaaa
aaaaaaaaaabbbbbbbbbbbbbbbbbbbbbbbbbbbbbbbbbbbbbbbbbaaaaaaaaaaaaa
aaaaaaaaaabcccccccccccccccdddddddddcccccccccccccccbaaaaaaaaaaaaa
aaaaaaaaaabceeeeeeeeeeeeeedGgrrrgGdeeeeeeeeeeeeeecbaaaaaaaaaaaaa
aaaaaaaaaabceeeeeeeeeeeeeeigrrfrrgieeeeeeeeeeeeeecbaaaaaaaaaaaaa
aaaaaaaaaabceeeeeeeeeeeeeeirrrrrrrieeeeeeeeeeeeeecbaaaaaaaaaaaaa
aaaaaaaaaabceeeeeeeeeeeeeeikrrrrrkieeeeeeeeeeeeeecbaaaaaaaaaaaaa
aaaaaaaaaabceeeeeeeeeeeeeeilikkkilieeeeeeeeeeeeeecbaaaaaaaaaaaaa
aaaaaaaaaabceeeeeeeeeeeeeedmlnnnlodeeeeeeeeeeeeeecbaaaaaaaaaaaaa
aaaaaaaaaabceeeeeeddiiiiiddddpppddddiiiiiddeeeeeecbaaaaaaaaaaaaa
aaaaaaaaaabceeeeeedGgqqqqqqqqqqqqqqqqqqqgGdeeeeeecbaaaaaaaaaaaaa
aaaaaaaaaabceeeeeeirnrrrnkrrnrkrnrrknrrrnrieeeeeecbaaaaaaaaaaaaa
aaaaaaaaaabceeeeeedJJJJJJJJJJJJJJJJJJJJJJJdeeeeeecbaaaaaaaaaaaaa
aaaaaaaaaabceeeeeedddddddddddddddddddddddddeeeeeecbaaaaaaaaaaaaa
aaaaaaaaaabceeeeeedJJJJJJJJJJJJJJJJJJJJJJJdeeeeeecbaaaaaaaaaaaaa
aaaaaaaaaabceeeeeeirrrrrrrrrrrrrrrrrrrrrrnieeeeeecbaaaaaaaaaaaaa
aaaaaaaaaabceeeeeeddddddddrssrrrssrssssssideeeeeecbaaaaaaaaaaaaa
aaaaaaaaaabceeeeeeikrrdkrrrsstttssrrrrrusrieeeeeecbaaaaaaaaaaaaa
aaaaaaaaaabceeeeeeirdrdrsssssssssssssssssiieeeeeecbaaaaaaaaaaaaa
aaaaaaaaaabceeeeeeirdrdrsrrrrrrrrrrrrrrrsrieeeeeecbaaaaaaaaaaaaa
aaaaaaaaaabceeeeeeirdvrrrdddnnnnnddddddrsrdeeeeeecbaaaaaaaaaaaaa
aaaaaaaaaabceeeeeeirrrddddJdiiiiidJdrrrrrwieeeeeecbaaaaaaaaaaaaa
aaaaaaaaaabceeeeeeirsssrrdxJJJJJJJydrrsssrieeeeeecbaaaaaaaaaaaaa
aaaaaaaaaabceeeeeeirsurrddzJHrrrHJAddzrusrieeeeeecbaaaaaaaaaaaaa
aaaaaaaaaabceeeeeeirsrsrrrxJrrrrrJyrrrsrsrieeeeeecbaaaaaaaaaaaaa
aaaaaaaaaabceeeeeesssrssssssrrrrrssssssrssseeeeeecbaaaaaaaaaaaaa
aaaaaaaaaabceeeeeedgrrrrrrrrrrrrrrrrrrrrrgdeeeeeecbaaaaaaaaaaaaa
aaaaaaaaaabceeeeeedGgqqqqBKBqqqqqBKBqqqqgGdeeeeeecbaaaaaaaaaaaaa
aaaaaaaaaabceeeeeeddiiiddqrqdiiidqrqddiiiddeeeeeecbaaaaaaaaaaaaa
aaaaaaaaaabceeeeeeeeeeeedqHqieeeiqHqdeeeeeeeeeeeecbaaaaaaaaaaaaa
aaaaaaaaaabceeeeeeeeeeeeiqrqieeeiqrqieeeeeeeeeeeecbaaaaaaaaaaaaa
aaaaaaaaaabceeeeeeeeeeeeiqrqieeeiqrqieeeeeeeeeeeecbaaaaaaaaaaaaa
aaaaaaaaaabceeeeeeeeeeeeiqjqieeeiqjqieeeeeeeeeeeecbaaaaaaaaaaaaa
aaaaaaaaaabceeeeeeeeeeeeiqrqieeeiqrqieeeeeeeeeeeecbaaaaaaaaaaaaa
aaaaaaaaaabceeeeeeeeeeeeiqHqieeeiqHqieeeeeeeeeeeecbaaaaaaaaaaaaa
aaaaaaaaaabceeeeeeeeeeeedqrqieeeiqrqdeeeeeeeeeeeecbaaaaaaaaaaaaa
aaaaaaaaaaaddiiiiiiiiiiddqrqdiiidqrqddiiiiiiiiiiddaaaaaaaaaaaaaa
aaaaaaaaaaadGhSEEEEEEEEECBqBCqqqCBqBCEEEEEEEEEShGdaaaaaaaaaaaaaa
aaaaaaaaaaadgrrrrrrrrrrrrrjrrrrrrrjrrrrrrrrrrrrrgdaaaaaaaaaaaaaa
aaaaaaaaaaadqrrrrrrrrrrjrrrrrrrrrrrrrjrrrDrrrrrrqdaaaaaaaaaaaaaa
aaaaaaaaaaadqrrrrrrDrrrrrrrddiiiddrrrrrrrrrrrrrrqdaaaaaaaaaaaaaa
aaaaaaaaaaadqrrrrrrrurrrddddEEEEEddddrrrrurrurrrqdaaaaaaaaaaaaaa
aaaaaaaaaaadqrrrrrrrrrrrdIEEErnrEEEIdrrrrrrrrrrrqdaaaaaaaaaaaaaa
aaaaaaaaaaadqrrDrurrrrrrdErrDrrrrrrEdrrrrDrrrrDrqdaaaaaaaaaaaaaa
aaaaaaaaaaadqrrrrrrrDrrjrKrrrrjrDrDKrjrrrrrrrrrrqdaaaaaaaaaaaaaa
aaaaaaaaaaadgrrrrrrrrrrrdqDrurrrurrqdrrrrrrrrrrrgdaaaaaaaaaaaaaa
aaaaaaaaaaadGgqqqqqqqqqqdBqqqqqqqqqBdqqqqqqqqqqgGdaaaaaaaaaaaaaa
aaaaaaaaaaaddiiiiiiiiiiiddrrrrrrrrrddiiiiiiiiiiiddaaaaaaaaaaaaaa
aaaaaaaaaaaaFFFFFFFFFFFFFFFFFFFFFFFFFFFFFFFFFFFFFaaaaaaaaaaaaaaa
aaaaaaaaaaaaaFFFFFFFFFFFFFFFFFFFFFFFFFFFFFFFFFFFaaaaaaaaaaaaaaaa
aaaaaaaaaaaaaaFFFFFFFFFFFFFFFFLFFFFFFFFFFFFFFFFaaaaaaaaaaaaaaaaa
aaaaaaaaaaaaaaaFFFFFFFFFFFFFFFFFFFFFFFFFFFFFFFaaaaaaaaaaaaaaaaaa
aaaaaaaaaaaaaaaaFFFFFFFFFFFFFFFFFFFFFFFFFFFFFaaaaaaaaaaaaaaaaaaa
"}
