"ay" = (/obj/marker/map_node,/mob/living/simple/clockwork_marauder{dir = 8;icon_state = "living"},/turf/simulated/floor/clockwork/reebe,/area/mission/prefab/misc/clockwork_hall)
"bm" = (/obj/marker/map_node/x3,/turf/dmm_suite/no_wall,/area/dmm_suite/clear_area)
"bU" = (/obj/marker/objective_spawn,/turf/simulated/floor/clockwork/reebe,/area/mission/prefab/misc/clockwork_hall)
"ds" = (/mob/living/simple/parrot/clockwork,/turf/simulated/floor/clockwork/reebe,/area/mission/prefab/misc/clockwork_hall)
"fe" = (/obj/structure/table/brass,/turf/simulated/floor/clockwork/special,/area/mission/prefab/misc/clockwork_hall)
"fr" = (/obj/marker/map_node/x4,/turf/simulated/floor/clockwork/reebe,/area/mission/prefab/misc/clockwork_hall)
"fN" = (/obj/structure/table/brass,/turf/simulated/floor/clockwork/alt3,/area/mission/prefab/misc/clockwork_hall)
"fQ" = (/obj/marker/map_node,/mob/living/simple/watcher/clockwork,/turf/simulated/floor/clockwork/reebe,/area/mission/prefab/misc/clockwork_hall)
"fR" = (/obj/structure/window/clockwork,/turf/simulated/floor/clockwork/alt3,/area/mission/prefab/misc/clockwork_hall)
"gw" = (/mob/living/simple/clockwork_marauder,/turf/simulated/floor/clockwork/reebe,/area/mission/prefab/misc/clockwork_hall)
"hv" = (/turf/simulated/wall/clockwork/indestructable,/area/mission/prefab/misc/clockwork_hall)
"iD" = (/mob/living/simple/watcher/clockwork,/turf/simulated/floor/clockwork/reebe,/area/mission/prefab/misc/clockwork_hall)
"iH" = (/obj/structure/interactive/crate/chest/filled,/turf/simulated/floor/clockwork/alt3,/area/mission/prefab/misc/clockwork_hall)
"kt" = (/mob/living/simple/turret/clockwork,/turf/simulated/floor/clockwork/alt3,/area/mission/prefab/misc/clockwork_hall)
"lj" = (/obj/marker/map_node/x2,/turf/simulated/floor/clockwork/reebe,/area/mission/prefab/misc/clockwork_hall)
"lW" = (/turf/simulated/wall/clockwork/tough,/area/mission/prefab/misc/clockwork_hall)
"nm" = (/mob/living/simple/watcher/clockwork_mobile,/turf/simulated/floor/clockwork/alt3,/area/mission/prefab/misc/clockwork_hall)
"sd" = (/mob/living/simple/watcher/clockwork_mobile,/turf/simulated/floor/clockwork/reebe,/area/mission/prefab/misc/clockwork_hall)
"ti" = (/obj/marker/map_node,/turf/simulated/floor/clockwork/reebe,/area/mission/prefab/misc/clockwork_hall)
"vv" = (/mob/living/simple/turret/clockwork,/turf/simulated/floor/clockwork/alt1,/area/mission/prefab/misc/clockwork_hall)
"we" = (/obj/structure/window/clockwork,/turf/simulated/floor/clockwork/alt1,/area/mission/prefab/misc/clockwork_hall)
"wp" = (/turf/simulated/floor/clockwork/alt3,/area/mission/prefab/misc/clockwork_hall)
"yo" = (/mob/living/advanced/npc/clockwork_cultist{dir = 8;icon_state = "directional"},/turf/simulated/floor/clockwork/alt3,/area/mission/prefab/misc/clockwork_hall)
"yu" = (/turf/simulated/floor/clockwork/special,/area/mission/prefab/misc/clockwork_hall)
"yK" = (/mob/living/advanced/npc/clockwork_cultist{dir = 4;icon_state = "directional"},/turf/simulated/floor/clockwork/reebe,/area/mission/prefab/misc/clockwork_hall)
"zk" = (/mob/living/advanced/npc/clockwork_cultist,/turf/simulated/floor/clockwork/reebe,/area/mission/prefab/misc/clockwork_hall)
"zU" = (/obj/marker/map_node,/turf/dmm_suite/no_wall,/area/dmm_suite/clear_area)
"AF" = (/turf/dmm_suite/clear_turf,/area/dmm_suite/clear_area)
"Dp" = (/mob/living/simple/turret/clockwork,/turf/simulated/floor/clockwork/special,/area/mission/prefab/misc/clockwork_hall)
"EI" = (/turf/simulated/wall/clockwork,/area/mission/prefab/misc/clockwork_hall)
"FQ" = (/obj/marker/map_node,/turf/simulated/floor/clockwork/alt3,/area/mission/prefab/misc/clockwork_hall)
"Gl" = (/obj/structure/table/brass,/turf/simulated/floor/clockwork/reebe,/area/mission/prefab/misc/clockwork_hall)
"Hs" = (/mob/living/simple/watcher/clockwork{dir = 4;icon_state = "warden"},/turf/simulated/floor/clockwork/reebe,/area/mission/prefab/misc/clockwork_hall)
"Hu" = (/obj/marker/map_node/x2,/mob/living/simple/watcher/clockwork,/turf/simulated/floor/clockwork/reebe,/area/mission/prefab/misc/clockwork_hall)
"Iq" = (/mob/living/simple/turret/clockwork,/turf/simulated/floor/clockwork/alt2,/area/mission/prefab/misc/clockwork_hall)
"IN" = (/turf/dmm_suite/no_wall,/area/dmm_suite/clear_area)
"Lc" = (/mob/living/simple/watcher/clockwork{dir = 4;icon_state = "warden"},/turf/simulated/floor/clockwork/alt2,/area/mission/prefab/misc/clockwork_hall)
"MP" = (/mob/living/advanced/npc/clockwork_cultist{dir = 8;icon_state = "directional"},/turf/simulated/floor/clockwork/reebe,/area/mission/prefab/misc/clockwork_hall)
"MS" = (/mob/living/simple/clockwork_marauder{dir = 4;icon_state = "living"},/turf/simulated/floor/clockwork/reebe,/area/mission/prefab/misc/clockwork_hall)
"NP" = (/mob/living/simple/clockwork_fragment,/turf/simulated/floor/clockwork/reebe,/area/mission/prefab/misc/clockwork_hall)
"QK" = (/mob/living/advanced/npc/clockwork_cultist{dir = 4;icon_state = "directional"},/turf/simulated/floor/clockwork/alt3,/area/mission/prefab/misc/clockwork_hall)
"QN" = (/obj/structure/interactive/crate/chest/filled,/turf/simulated/floor/clockwork/reebe,/area/mission/prefab/misc/clockwork_hall)
"Ra" = (/turf/simulated/floor/clockwork/reebe,/area/mission/prefab/misc/clockwork_hall)
"RL" = (/obj/structure/window/clockwork,/turf/simulated/floor/clockwork/reebe,/area/mission/prefab/misc/clockwork_hall)
"Se" = (/mob/living/advanced/npc/clockwork_cultist{dir = 1;icon_state = "directional"},/turf/simulated/floor/clockwork/reebe,/area/mission/prefab/misc/clockwork_hall)
"SU" = (/mob/living/simple/turret/clockwork,/turf/simulated/floor/clockwork/reebe,/area/mission/prefab/misc/clockwork_hall)
"Uo" = (/mob/living/simple/watcher/clockwork{dir = 8;icon_state = "warden"},/turf/simulated/floor/clockwork/alt2,/area/mission/prefab/misc/clockwork_hall)
"Vg" = (/mob/living/simple/clockwork_marauder,/turf/simulated/floor/clockwork/alt3,/area/mission/prefab/misc/clockwork_hall)
"Xy" = (/turf/simulated/floor/clockwork/alt1,/area/mission/prefab/misc/clockwork_hall)
"XG" = (/obj/structure/table/brass,/turf/simulated/floor/clockwork/alt1,/area/mission/prefab/misc/clockwork_hall)
"Yi" = (/mob/living/simple/watcher/clockwork{dir = 8;icon_state = "warden"},/turf/simulated/floor/clockwork/reebe,/area/mission/prefab/misc/clockwork_hall)
"ZN" = (/obj/marker/smart_clear_turf,/turf/dmm_suite/no_wall,/area/dmm_suite/clear_area)

(1,1,1) = {"
AFAFAFAFAFAFAFAFAFAFAFAFAFAFAFAFAFAFAFAFAFAFAFAFAFAFAFAFAFAFAFAFAFAFAFAFAFAFAFAFAFAFAFAFAFAFAFAFAFAFAFAFAFAFAFAFAFAFAFAFAFAFAFAF
AFAFAFAFAFAFAFAFAFAFAFAFAFAFAFAFAFAFAFAFAFAFAFAFAFAFAFAFAFAFAFAFAFAFAFAFAFAFAFAFAFAFAFAFAFAFAFAFAFAFAFAFAFAFAFAFAFAFAFAFAFAFAFAF
AFAFAFAFAFAFAFAFAFAFAFAFAFAFAFAFAFAFAFAFAFAFAFAFAFAFAFAFAFAFAFAFAFAFAFAFAFAFAFAFAFAFAFAFAFAFAFAFAFAFAFAFAFAFAFAFAFAFAFAFAFAFAFAF
AFAFAFAFAFAFAFAFAFAFAFAFAFAFAFAFAFAFAFAFAFAFAFAFAFAFAFAFAFAFAFAFAFAFAFAFAFAFAFAFAFAFAFAFAFAFAFAFAFAFAFAFAFAFAFAFAFAFAFAFAFAFAFAF
AFAFAFAFAFAFAFAFAFAFAFAFAFAFAFAFAFAFAFAFAFAFAFAFAFAFAFAFAFAFAFAFAFAFAFAFAFAFAFAFAFAFAFAFAFAFAFAFAFAFAFAFAFAFAFAFAFAFAFAFAFAFAFAF
AFAFAFAFAFAFAFAFAFAFAFAFAFAFAFAFAFAFAFAFAFAFAFAFAFAFAFAFAFAFAFAFAFAFAFAFAFAFAFAFAFAFAFAFAFAFAFAFAFAFAFAFAFAFAFAFAFAFAFAFAFAFAFAF
AFAFAFAFAFAFAFAFAFAFAFAFAFAFAFAFAFAFAFAFAFAFAFAFAFAFAFAFAFAFAFAFAFAFAFAFAFAFAFAFAFAFAFAFAFAFAFAFAFAFAFAFAFAFAFAFAFAFAFAFAFAFAFAF
AFAFAFAFAFAFAFAFAFAFAFAFAFAFAFAFAFAFAFAFAFAFAFAFAFAFAFAFAFAFAFAFAFAFAFAFAFAFAFAFAFAFAFAFAFAFAFAFAFAFAFAFAFAFAFAFAFAFAFAFAFAFAFAF
AFAFAFAFAFAFAFAFAFAFAFAFAFAFAFAFAFAFAFAFAFAFAFAFAFAFAFAFAFAFAFAFAFAFAFAFAFAFAFAFAFAFAFAFAFAFAFAFAFAFAFAFAFAFAFAFAFAFAFAFAFAFAFAF
AFAFAFAFAFAFAFAFAFAFAFAFAFAFAFAFAFAFAFAFAFAFAFAFAFAFAFAFAFAFAFAFAFAFAFAFAFAFAFAFAFAFAFAFAFAFAFAFAFAFAFAFAFAFAFAFAFAFAFAFAFAFAFAF
AFAFAFAFAFAFAFAFAFAFAFAFAFAFAFAFAFAFAFAFAFAFAFAFAFAFAFAFAFAFAFAFAFAFAFAFAFAFAFAFAFAFAFAFAFAFAFAFAFAFAFAFAFAFAFAFAFAFAFAFAFAFAFAF
AFAFAFAFAFAFAFAFAFAFAFAFAFAFAFAFAFAFAFAFAFAFAFAFAFAFAFAFAFAFAFAFAFAFAFAFAFAFAFAFAFAFAFAFAFAFAFAFAFAFAFAFAFAFAFAFAFAFAFAFAFAFAFAF
AFAFAFAFAFAFAFAFAFAFINININININININININININININININININININININININININININININININININININININININININAFAFAFAFAFAFAFAFAFAFAFAFAF
AFAFAFAFAFAFAFAFAFAFINhvhvhvhvhvhvhvhvhvhvhvhvhvhvhvlWlWlWlWlWlWlWlWlWhvhvhvhvhvhvhvhvhvhvhvhvhvhvhvINAFAFAFAFAFAFAFAFAFAFAFAFAF
AFAFAFAFAFAFAFAFAFAFINhvSUtiEIRaRaEIRaXyRaRazkRaRaXylWIqXyQNbUQNXyIqlWXyRaRazkRaRaXyRaEIRaRaEItiSUhvINAFAFAFAFAFAFAFAFAFAFAFAFAF
AFAFAFAFAFAFAFAFAFAFINhvRaRaEIEIEIEIRawpRaRaRaRaRawplWXyRaRadsRaRaXylWwpRaRaRaRaRawpRaEIEIEIEIRaRahvINAFAFAFAFAFAFAFAFAFAFAFAFAF
AFAFAFAFAFAFAFAFAFAFINhvRaRaEIiDQNEIRaXyRaRaljRaRawplWRaRaRaRaRaRaRalWwpRaRaljRaRaXyRaEIQNiDEIRaRahvINAFAFAFAFAFAFAFAFAFAFAFAFAF
AFAFAFAFAFAFAFAFAFAFINhvRaRaRatiRaRaRaEIRaRaRaRaRawplWzkRaRaRaRaRazklWwpRaRaRaRaRaEIRaRaRatiRaRaRahvINAFAFAFAFAFAFAFAFAFAFAFAFAF
AFAFAFAFAFAFAFAFAFAFINhvEIEIEIEIEIEIRaEIRaRaRaRaRawplWweRLzkzkzkRLwelWwpRaRaRaRaRaEIRaEIEIEIEIEIEIhvINAFAFAFAFAFAFAFAFAFAFAFAFAF
AFAFAFAFAFAFAFAFAFAFINhvRaRaRaRaRaRaRaEIXGfNfNfNfNvvlWLcweiDiDiDweUolWvvfNfNfNfNfNEIRaRaRaRaRaRaRahvINAFAFAFAFAFAFAFAFAFAFAFAFAF
AFAFAFAFAFAFAFAFAFAFINhvGlGlGlGlGlGlEIEIRLRLRLRLRLEIlWlWEIfRwpfREIlWlWEIRLRLRLRLRLEIEIGlGlGlGlGlGlhvINAFAFAFAFAFAFAFAFAFAFAFAFAF
AFAFAFAFAFAFAFAFAFAFINhvyuwpwpwpwpyuEIIqXywpwpwpwpwpwpwpwpwpwpwpwpwpwpwpwpwpwpwpXyIqEIyuwpwpwpwpyuhvINAFAFAFAFAFAFAFAFAFAFAFAFAF
AFAFAFAFAFAFAFAFAFAFINhvwpRaRaRaRawpRLRaiDRaRaRaiDzkRaRaiDRazkRaiDRaRazkiDRaRaRaiDRaRLwpRaRaRaRawphvINAFAFAFAFAFAFAFAFAFAFAFAFAF
AFAFAFAFAFAFAFAFAFAFINhvwpRaRaRaRaEIEIGlGlGlGlGlGlGlGlGlGlGlGlGlGlGlGlGlGlGlGlGlGlGlEIEIRaRaRaRawphvINAFAFAFAFAFAFAFAFAFAFAFAFAF
AFAFAFAFAFAFAFAFAFAFINhvwpRaRaRaRaktEIEIEIEIEIEIEIEIEIEIRLRLRLRLRLEIEIEIEIEIEIEIEIEIEIktRaRaRaRawphvINAFAFAFAFAFAFAFAFAFAFAFAFAF
AFAFAFAFAFAFAFAFAFAFINhvwpRaRaRaRayoEIGlGlQNGlGlzkGlGlGlGlGlGlGlGlGlGlGlzkGlGlQNGlGlEIQKRaRaRaRawphvINAFAFAFAFAFAFAFAFAFAFAFAFAF
AFAFAFAFAFAFAFAFAFAFINhvwpsdRaljRayuRaRaRaRaRaRaRaRatiRaRaRatiRaRaRatiRaRaRaRaRaRafQRayuRaljRasdwphvINAFAFAFAFAFAFAFAFAFAFAFAFAF
AFAFAFAFAFAFAFAFAFAFINhvwpRaRaRaRayoEIEIEIEIEIEIEIEIRalWlWRaRaRalWlWRalWlWlWlWlWlWRLEIQKRaRaRaRawphvINAFAFAFAFAFAFAFAFAFAFAFAFAF
AFAFAFAFAFAFAFAFAFAFINhvwpRaRaRaRawpRLzkRaRaEIzkRaRaRalWlWSeSeSelWlWtiRaRaRaRagwlWtiRLwpRaRaRaRawphvINAFAFAFAFAFAFAFAFAFAFAFAFAF
AFAFAFAFAFAFAFAFAFAFINhvwpRaRaRaRaiHRLRaEIRaEIRalWlWlWlWlWlWlWlWlWlWlWlWlWlWlWlWlWRLRLiHRaRaRaRawphvINAFAFAFAFAFAFAFAFAFAFAFAFAF
AFAFAFAFAFAFAFAFAFAFINhvwpRaRaRaRawpRLRaEIRaEIRalWRaRaRaRaRaRaRatiRaRaRaRaRaRatilWRaRLwpRaRaRaRawphvINAFAFAFAFAFAFAFAFAFAFAFAFAF
AFAFAFAFAFAFAFAFAFAFINhvwpRaRaRawpEIEIRaEIMSRaRaRaEIEIEIiDiDHuiDiDEIEIEIEIEIEIRalWRaEIEIwpRaRaRawphvINAFAFAFAFAFAFAFAFAFAFAFAFAF
AFAFAFAFAFAFAFAFAFAFINhvwpRaRaRawpSURLRaRaRaEIEIEIEIGlEIRLRLRLRLRLEIGlEIRaRaRatiRaayRLSUwpRaRaRawphvINAFAFAFAFAFAFAFAFAFAFAFAFAF
AFAFAFAFAFAFAFAFAFAFINhvwpRaRaRawpEIEIRalWlWlWRaRaEIHsGlGlGlGlGlGlGlYiEIRaRalWlWlWRaEIEIwpRaRaRawphvINAFAFAFAFAFAFAFAFAFAFAFAFAF
AFAFAFAFAFAFAFAFAFAFINhvwpRaRaljwpwpEIRalWgwRaRaEIEIyKGlsdRaRaRasdGlMPEIEIyKRagwlWRaEIwpwpljRaRawphvINAFAFAFAFAFAFAFAFAFAFAFAFAF
AFAFAFAFAFAFAFAFAFAFINhvwpRaRaRaRayuRaRalWRalWRaRaRaHsGlRaRaljRaRaGlYiRaRaRalWRalWRaRayuRaRaRaRawphvINAFAFAFAFAFAFAFAFAFAFAFAFAF
AFAFAFAFAFAFAFAFAFAFINhvwpRaRaRaRayolWlWlWRalWlWlWlWlWlWRaRaRaRaRalWlWlWlWlWlWRalWlWlWQKRaRaRaRawphvINAFAFAFAFAFAFAFAFAFAFAFAFAF
AFAFAFAFAFAFAFAFAFAFINhvwpRaRaRaRawpEIXyRaRaRaRaRaRaRaRaRaRatiRaRaRaRaRaRaRaRaRaRaXyEIwpRaRaRaRawphvINAFAFAFAFAFAFAFAFAFAFAFAFAF
AFAFAFAFAFAFAFAFAFAFINhvyuwpwpwpwpyuEIIqXywpwpwpwpyuFQyuwpwpwpwpwpyuFQyuwpwpwpwpXyIqEIyuwpwpwpwpyuhvINAFAFAFAFAFAFAFAFAFAFAFAFAF
AFAFAFAFAFAFAFAFAFAFINhvGlGlGlGlGlGllWlWRLRLRLlWlWwpRawpEIRLRLRLEIwpRawplWlWRLRLRLlWlWGlGlGlGlGlGlhvINAFAFAFAFAFAFAFAFAFAFAFAFAF
AFAFAFAFAFAFAFAFAFAFINhvyunmwpwpnmwpfNfNfNfNfNDplWwpsdwpRLyuiHyuRLwpsdwplWDpfNfNfNfNfNwpnmwpwpnmyuhvINAFAFAFAFAFAFAFAFAFAFAFAFAF
AFAFAFAFAFAFAFAFAFAFINhvwpRaRaRaRaRaRaRaRaRaMPfNRLwpRawpRLwpsdwpRLwpRawpRLfNyKRaRaRaRaRaRaRaRaRawphvINAFAFAFAFAFAFAFAFAFAFAFAFAF
AFAFAFAFAFAFAFAFAFAFINhvwpRaRaRaRaRaRaRaRaRaRafNRLwpRawpRLwpgwwpRLwpRawpRLfNRaRaRaRaRaRaRaRaRaRawphvINAFAFAFAFAFAFAFAFAFAFAFAFAF
AFAFAFAFAFAFAFAFAFAFINhvwpRaRaljRaRaRagwRatiRaiHRLwpljwpRLwpRawpRLwpljwpRLiHRatiRagwRaRaRaljRaRawphvINAFAFAFAFAFAFAFAFAFAFAFAFAF
AFAFAFAFAFAFAFAFAFAFINhvwpRaRaRaRaRaRaRaRaRaRafNRLwpRawpRLwpsdwpRLwpRawpRLfNRaRaRaRaRaRaRaRaRaRawphvINAFAFAFAFAFAFAFAFAFAFAFAFAF
AFAFAFAFAFAFAFAFAFAFINhvwpRaRaRaRaRaRaRaRaRaMPfNRLwpsdwpRLwpRawpRLwpsdwpRLfNyKRaRaRaRaRaRaRaRaRawphvINAFAFAFAFAFAFAFAFAFAFAFAFAF
AFAFAFAFAFAFAFAFAFAFINhvDpfNfNfNfNfNfNfNfNfNfNDplWwpRawpRLyuwpyuRLwpRawplWDpfNfNfNfNfNfNfNfNfNfNDphvINAFAFAFAFAFAFAFAFAFAFAFAFAF
AFAFAFAFAFAFAFAFAFAFINlWlWRLRLRLRLRLRLRLRLRLRLlWlWwpRawpEIRLRLRLEIwpRawplWlWRLRLRLRLRLRLRLRLRLRLlWlWINAFAFAFAFAFAFAFAFAFAFAFAFAF
AFAFAFAFAFAFAFAFAFAFINEIIqXGiHfNfNfNfNfNfNfNfNfNVgyuwpyuVgwpwpwpVgyuwpyuVgfNfNfNfNfNfNfNfNfNiHXGIqEIINAFAFAFAFAFAFAFAFAFAFAFAFAF
AFAFAFAFAFAFAFAFAFAFINEIXyRaRaRaRaRaRaRaRaRaRaRaRaRaljRaRaRaljRaRaRaljRaRaRaRaRaRaRaRaRaRaRaRaRaXyEIINAFAFAFAFAFAFAFAFAFAFAFAFAF
AFAFAFAFAFAFAFAFAFAFINEIwpRaRaRaRaRaRaRaRaRaRatiRaRaRaRaRaRaRaRaRaRaRaRaRatiRaRaRaNPRaRaRaRaRaRawpEIINAFAFAFAFAFAFAFAFAFAFAFAFAF
AFAFAFAFAFAFAFAFAFAFINEIwpRaRaRaRaRaRaNPRaRaRaRaRaRaRaEIEIRLRLRLEIEIRaRaRaRaRaRaRaRaRaRaRaRaRaRawpEIINAFAFAFAFAFAFAFAFAFAFAFAFAF
AFAFAFAFAFAFAFAFAFAFINEIwpRaRaRaRafrRaRagwRaRaRaEIEIEIEIfNfNfNfNfNEIEIEIEIRaRaRaRagwRafrgwRaRaRawpEIINAFAFAFAFAFAFAFAFAFAFAFAFAF
AFAFAFAFAFAFAFAFAFAFINEIwpRaRaRaRaRaRaRaRaRaRaRaEIfefNfNfNRaiDRafNfNfNfeEIRaRaRaRaRaRaRaRaRaRaRawpEIINAFAFAFAFAFAFAFAFAFAFAFAFAF
AFAFAFAFAFAFAFAFAFAFINEIwpRaRaNPRagwRaRaRaRaRaRaEIfNRaRaNPRaRaRaRaRaRafNEIRaRaRaRaNPRaRaRaRaNPRawpEIINAFAFAFAFAFAFAFAFAFAFAFAFAF
AFAFAFAFAFAFAFAFAFAFINEIwpRaRaRaRaRaRaRaNPRaRatiRaFQRaRaRaRaljRaNPRaNPFQRatiRaRaRaRaRaRaRaRaRaRawpEIINAFAFAFAFAFAFAFAFAFAFAFAFAF
AFAFAFAFAFAFAFAFAFAFINEIXyRaRaRaRaRaRaRaRaRaRaRaEIwpNPRagwRaRaRagwRaRawpEIRaRaRaRaRaRaRaRaRaRaRaXyEIINAFAFAFAFAFAFAFAFAFAFAFAFAF
AFAFAFAFAFAFAFAFAFAFINEIIqXywpwpwpwpwpwpwpwpwpwpEIyuwpwpwpwpwpwpwpwpwpyuEIwpwpwpwpwpwpwpwpwpwpXyIqEIINAFAFAFAFAFAFAFAFAFAFAFAFAF
AFAFAFAFAFAFAFAFAFAFINEIEIRLRLRLRLRLRLRLRLRLRLRLEIEIRaRaRaRaRaRaRaRaRaEIEIRLRLRLRLRLRLRLRLRLRLRLEIEIINAFAFAFAFAFAFAFAFAFAFAFAFAF
AFAFAFAFAFAFAFAFAFAFINININININININININININININININININININININININININININININININININININININININININAFAFAFAFAFAFAFAFAFAFAFAFAF
AFAFAFAFAFAFAFAFAFAFAFAFAFzUINZNINININININININININININZNININININININZNININININININININININZNINzUAFAFAFAFAFAFAFAFAFAFAFAFAFAFAFAF
AFAFAFAFAFAFAFAFAFAFAFAFAFAFININININININbmININININbmININININbmININININbmININININbmININININININAFAFAFAFAFAFAFAFAFAFAFAFAFAFAFAFAF
AFAFAFAFAFAFAFAFAFAFAFAFAFAFAFINININININININININININININININININININININININININININININININAFAFAFAFAFAFAFAFAFAFAFAFAFAFAFAFAFAF
AFAFAFAFAFAFAFAFAFAFAFAFAFAFAFAFINININININININININININININININININININININININININININININAFAFAFAFAFAFAFAFAFAFAFAFAFAFAFAFAFAFAF
"}
