"a" = (/turf/dmm_suite/clear_turf,/area/dmm_suite/clear_area)
"b" = (/turf/simulated/wall/rock/indestructable,/area/prefab/clockwork_cult)
"c" = (/turf/simulated/wall/rock/indestructable,/area/mission/prefab/misc/clockwork_hall)
"d" = (/turf/simulated/wall/clockwork/indestructable,/area/mission/prefab/misc/clockwork_hall)
"e" = (/turf/simulated/wall/clockwork,/area/mission/prefab/misc/clockwork_hall)
"f" = (/turf/unsimulated/abyss,/area/mission/prefab/misc/clockwork_hall)
"g" = (/mob/living/simple/turret/clockwork,/turf/simulated/floor/clockwork/alt2,/area/mission/prefab/misc/clockwork_hall)
"h" = (/turf/simulated/floor/clockwork/alt1,/area/mission/prefab/misc/clockwork_hall)
"i" = (/turf/simulated/floor/clockwork/reebe,/area/mission/prefab/misc/clockwork_hall)
"j" = (/obj/marker/objective_spawn,/turf/simulated/floor/clockwork/reebe,/area/mission/prefab/misc/clockwork_hall)
"k" = (/obj/structure/window/clockwork,/turf/simulated/floor/clockwork/reebe,/area/mission/prefab/misc/clockwork_hall)
"l" = (/mob/living/simple/parrot/clockwork,/turf/simulated/floor/clockwork/reebe,/area/mission/prefab/misc/clockwork_hall)
"m" = (/mob/living/advanced/npc/clockwork_cultist,/turf/simulated/floor/clockwork/reebe,/area/mission/prefab/misc/clockwork_hall)
"n" = (/obj/structure/window/clockwork,/turf/simulated/floor/clockwork/alt1,/area/mission/prefab/misc/clockwork_hall)
"o" = (/mob/living/simple/watcher/clockwork{dir = 4; icon_state = "warden"},/turf/simulated/floor/clockwork/alt2,/area/mission/prefab/misc/clockwork_hall)
"p" = (/mob/living/simple/watcher/clockwork,/turf/simulated/floor/clockwork/reebe,/area/mission/prefab/misc/clockwork_hall)
"q" = (/mob/living/simple/watcher/clockwork{dir = 8; icon_state = "warden"},/turf/simulated/floor/clockwork/alt2,/area/mission/prefab/misc/clockwork_hall)
"r" = (/obj/structure/window/clockwork,/turf/simulated/floor/clockwork/alt3,/area/mission/prefab/misc/clockwork_hall)
"s" = (/turf/simulated/floor/clockwork/alt3,/area/mission/prefab/misc/clockwork_hall)
"t" = (/obj/structure/table/brass,/turf/simulated/floor/clockwork/reebe,/area/mission/prefab/misc/clockwork_hall)
"u" = (/obj/marker/map_node,/turf/simulated/floor/clockwork/reebe,/area/mission/prefab/misc/clockwork_hall)
"v" = (/obj/marker/map_node,/mob/living/simple/watcher/clockwork,/turf/simulated/floor/clockwork/reebe,/area/mission/prefab/misc/clockwork_hall)
"w" = (/turf/simulated/wall/clockwork/tough,/area/mission/prefab/misc/clockwork_hall)
"x" = (/mob/living/advanced/npc/clockwork_cultist{dir = 1; icon_state = "directional"},/turf/simulated/floor/clockwork/reebe,/area/mission/prefab/misc/clockwork_hall)
"y" = (/mob/living/simple/clockwork_marauder,/turf/simulated/floor/clockwork/reebe,/area/mission/prefab/misc/clockwork_hall)
"z" = (/mob/living/simple/clockwork_marauder{dir = 4; icon_state = "living"},/turf/simulated/floor/clockwork/reebe,/area/mission/prefab/misc/clockwork_hall)
"A" = (/obj/marker/map_node/x2,/mob/living/simple/watcher/clockwork,/turf/simulated/floor/clockwork/reebe,/area/mission/prefab/misc/clockwork_hall)
"B" = (/obj/marker/map_node,/mob/living/simple/clockwork_marauder{dir = 8; icon_state = "living"},/turf/simulated/floor/clockwork/reebe,/area/mission/prefab/misc/clockwork_hall)
"C" = (/mob/living/simple/watcher/clockwork{dir = 4; icon_state = "warden"},/turf/simulated/floor/clockwork/reebe,/area/mission/prefab/misc/clockwork_hall)
"D" = (/mob/living/simple/watcher/clockwork{dir = 8; icon_state = "warden"},/turf/simulated/floor/clockwork/reebe,/area/mission/prefab/misc/clockwork_hall)
"E" = (/mob/living/advanced/npc/clockwork_cultist{dir = 4; icon_state = "directional"},/turf/simulated/floor/clockwork/reebe,/area/mission/prefab/misc/clockwork_hall)
"F" = (/turf/dmm_suite/no_wall,/area/dmm_suite/clear_area)
"G" = (/mob/living/simple/watcher/clockwork_mobile,/turf/simulated/floor/clockwork/reebe,/area/mission/prefab/misc/clockwork_hall)
"H" = (/mob/living/advanced/npc/clockwork_cultist{dir = 8; icon_state = "directional"},/turf/simulated/floor/clockwork/reebe,/area/mission/prefab/misc/clockwork_hall)
"I" = (/obj/marker/map_node/x2,/turf/simulated/floor/clockwork/reebe,/area/mission/prefab/misc/clockwork_hall)
"J" = (/turf/simulated/floor/clockwork/special,/area/mission/prefab/misc/clockwork_hall)
"K" = (/obj/marker/map_node,/turf/simulated/floor/clockwork/alt3,/area/mission/prefab/misc/clockwork_hall)
"L" = (/obj/marker/map_node/x3,/turf/dmm_suite/no_wall,/area/dmm_suite/clear_area)
"M" = (/turf/dmm_suite/clear_turf,/area/mission/prefab/misc/clockwork_hall)
"N" = (/obj/structure/table/brass,/turf/simulated/floor/clockwork/alt1,/area/mission/prefab/misc/clockwork_hall)
"O" = (/obj/structure/interactive/crate/chest/filled,/turf/simulated/floor/clockwork/alt3,/area/mission/prefab/misc/clockwork_hall)
"P" = (/obj/structure/table/brass,/turf/simulated/floor/clockwork/alt3,/area/mission/prefab/misc/clockwork_hall)
"Q" = (/mob/living/simple/clockwork_marauder,/turf/simulated/floor/clockwork/alt3,/area/mission/prefab/misc/clockwork_hall)
"R" = (/obj/marker/smart_clear_turf,/turf/dmm_suite/no_wall,/area/dmm_suite/clear_area)
"S" = (/mob/living/simple/clockwork_fragment,/turf/simulated/floor/clockwork/reebe,/area/mission/prefab/misc/clockwork_hall)
"T" = (/obj/marker/map_node/x4,/turf/simulated/floor/clockwork/reebe,/area/mission/prefab/misc/clockwork_hall)
"U" = (/obj/structure/table/brass,/turf/simulated/floor/clockwork/special,/area/mission/prefab/misc/clockwork_hall)

(1,1,1) = {"
aaaaaaaaaaaaaaaaaaaaaaaaaaaaaaaaaaaaaaaaaaaaaaaaaaaaaaaaaaaaaaaa
aaaaaaaaaaaaaaaaaaaaaaaaaaaaaaaaaaaaaaaaaaaaaaaaaaaaaaaaaaaaaaaa
aaaaaaaaaaaaaaaaaaaaaaaaaaaaaaaaaaaaaaaaaaaaaaaaaaaaaaaaaaaaaaaa
aaaaaaaaaaaaaaaaaaaaaaaaaaaaaaaaaaaaaaaaaaaaaaaaaaaaaaaaaaaaaaaa
aaaaaaaaaaaaaaaaaaaaaaaaaaaaaaaaaaaaaaaaaaaaaaaaaaaaaaaaaaaaaaaa
aaaaaaaaaaaaaaaaaaaaaaaaaaaaaaaaaaaaaaaaaaaaaaaaaaaaaaaaaaaaaaaa
aaaaaaaaaaaaaaaaaaaaaaaaaaaaaaaaaaaaaaaaaaaaaaaaaaaaaaaaaaaaaaaa
aaaaaaaaaaaaaaaaaaaaaaaaaaaaaaaaaaaaaaaaaaaaaaaaaaaaaaaaaaaaaaaa
aaaaaaaaaaaaaaaaaaaaaaaaaaaaaaaaaaaaaaaaaaaaaaaaaaaaaaaaaaaaaaaa
aaaaaaaaaaaaaaaaaaaaaaaaaaaaaaaaaaaaaaaaaaaaaaaaaaaaaaaaaaaaaaaa
aaaaaaaaaaaaaaaaaaaaaaaaaaaaaaaaaaaaaaaaaaaaaaaaaaaaaaaaaaaaaaaa
aaaaaaaaaaaaaaaaaaaaaaaaaaaaaaaaaaaaaaaaaaaaaaaaaaaaaaaaaaaaaaaa
aaaaaaaaaaccccccccccccccccccccccccccccccccccccccccbaaaaaaaaaaaaa
aaaaaaaaaacdddddddddddddddeeeeeeeeedddddddddddddddbaaaaaaaaaaaaa
aaaaaaaaaacdffffffffffffffeghijihgeffffffffffffffdbaaaaaaaaaaaaa
aaaaaaaaaacdffffffffffffffkhiiliihkffffffffffffffdbaaaaaaaaaaaaa
aaaaaaaaaacdffffffffffffffkiiiiiiikffffffffffffffdbaaaaaaaaaaaaa
aaaaaaaaaacdffffffffffffffkmiiiiimkffffffffffffffdbaaaaaaaaaaaaa
aaaaaaaaaacdffffffffffffffknkmmmknkffffffffffffffdbaaaaaaaaaaaaa
aaaaaaaaaacdffffffffffffffeonpppnqeffffffffffffffdbaaaaaaaaaaaaa
aaaaaaaaaacdffffffeekkkkkeeeerrreeeekkkkkeeffffffdbaaaaaaaaaaaaa
aaaaaaaaaacdffffffeghssssssssssssssssssshgeffffffdbaaaaaaaaaaaaa
aaaaaaaaaacdffffffkipiiipmiipimipiimpiiipikffffffdbaaaaaaaaaaaaa
aaaaaaaaaacdffffffettttttttttttttttttttttteffffffdbaaaaaaaaaaaaa
aaaaaaaaaacdffffffeeeeeeeeeeeeeeeeeeeeeeeeeffffffdbaaaaaaaaaaaaa
aaaaaaaaaacdffffffettttttttttttttttttttttteffffffdbaaaaaaaaaaaaa
aaaaaaaaaacdffffffkiiiiiiiuiiiuiiiuiiiiiivkffffffdbaaaaaaaaaaaaa
aaaaaaaaaacdffffffeeeeeeeeiwwiiiwwiwwwwwwkeffffffdbaaaaaaaaaaaaa
aaaaaaaaaacdffffffkmiiemiiiwwxxxwwuiiiiywukffffffdbaaaaaaaaaaaaa
aaaaaaaaaacdffffffkieieiwwwwwwwwwwwwwwwwwkkffffffdbaaaaaaaaaaaaa
aaaaaaaaaacdffffffkieieiwiiiiiiiuiiiiiiuwikffffffdbaaaaaaaaaaaaa
aaaaaaaaaacdffffffkieziiieeeppAppeeeeeeiwieffffffdbaaaaaaaaaaaaa
aaaaaaaaaacdffffffkiiieeeetekkkkketeiiiuiBkffffffdbaaaaaaaaaaaaa
aaaaaaaaaacdffffffkiwwwiieCtttttttDeiiwwwikffffffdbaaaaaaaaaaaaa
aaaaaaaaaacdffffffkiwyiieeEtGiiiGtHeeEiywikffffffdbaaaaaaaaaaaaa
aaaaaaaaaacdffffffkiwiwiiiCtiiIiitDiiiwiwikffffffdbaaaaaaaaaaaaa
aaaaaaaaaacdffffffwwwiwwwwwwiiiiiwwwwwwiwwwffffffdbaaaaaaaaaaaaa
aaaaaaaaaacdffffffehiiiiiiiiiiuiiiiiiiiiiheffffffdbaaaaaaaaaaaaa
aaaaaaaaaacdffffffeghssssJKJsssssJKJsssshgeffffffdbaaaaaaaaaaaaa
aaaaaaaaaacdffffffeekkkeesisekkkesiseekkkeeffffffdbaaaaaaaaaaaaa
aaaaaaaaaacdffffffffffffesGskfffksGseffffffffffffdbaaaaaaaaaaaaa
aaaaaaaaaacdffffffffffffksiskfffksiskffffffffffffdbaaaaaaaaaaaaa
aaaaaaaaaacdffffffffffffksiskfffksiskffffffffffffdbaaaaaaaaaaaaa
aaaaaaaaaacdffffffffffffksIskfffksIskffffffffffffdbaaaaaaaaaaaaa
aaaaaaaaaacdffffffffffffksiskfffksiskffffffffffffdbaaaaaaaaaaaaa
aaaaaaaaaacdffffffffffffksGskfffksGskffffffffffffdbaaaaaaaaaaaaa
aaaaaaaaaacdffffffffffffesiskfffksiseffffffffffffdbaaaaaaaaaaaaa
aaaaaaaaaaMeekkkkkkkkkkeesisekkkesiseekkkkkkkkkkeeaaaaaaaaaaaaaa
aaaaaaaaaaMegNOPPPPPPPPPQJsJQsssQJsJQPPPPPPPPPONgeaaaaaaaaaaaaaa
aaaaaaaaaaMehiiiiiiiiiiiiiIiiiIiiiIiiiiiiiiiiiiiheaaaaaaaaaaaaaa
aaaaaaaaaaMesiiiiiiiiiiuiiiiiiiiiiiiiuiiiSiiiiiiseaaaaaaaaaaaaaa
aaaaaaaaaaMesiiiiiiSiiiiiiieekkkeeiiiiiiiiiiiiiiseaaaaaaaaaaaaaa
aaaaaaaaaaMesiiiiTiiyiiieeeePPPPPeeeeiiiiyiTyiiiseaaaaaaaaaaaaaa
aaaaaaaaaaMesiiiiiiiiiiieUPPPipiPPPUeiiiiiiiiiiiseaaaaaaaaaaaaaa
aaaaaaaaaaMesiiSiyiiiiiiePiiSiiiiiiPeiiiiSiiiiSiseaaaaaaaaaaaaaa
aaaaaaaaaaMesiiiiiiiSiiuiKiiiiIiSiSKiuiiiiiiiiiiseaaaaaaaaaaaaaa
aaaaaaaaaaMehiiiiiiiiiiiesSiyiiiyiiseiiiiiiiiiiiheaaaaaaaaaaaaaa
aaaaaaaaaaMeghsssssssssseJsssssssssJesssssssssshgeaaaaaaaaaaaaaa
aaaaaaaaaaMeekkkkkkkkkkkeeiiiiiiiiieekkkkkkkkkkkeeaaaaaaaaaaaaaa
aaaaaaaaaaaaFFFFFFFFFFFFFFFFFFFFFFFFFFFFFFFFFFFFFaaaaaaaaaaaaaaa
aaaaaaaaaaaaaFFRFFFFFFFFFFFRFFFFFFRFFFFFFFFFFRFFaaaaaaaaaaaaaaaa
aaaaaaaaaaaaaaFFFFFFLFFFFLFFFFLFFFFLFFFFLFFFFFFaaaaaaaaaaaaaaaaa
aaaaaaaaaaaaaaaFFFFFFFFFFFFFFFFFFFFFFFFFFFFFFFaaaaaaaaaaaaaaaaaa
aaaaaaaaaaaaaaaaFFFFFFFFFFFFFFFFFFFFFFFFFFFFFaaaaaaaaaaaaaaaaaaa
"}
