"aa" = (/turf/dmm_suite/clear_turf,/area/dmm_suite/clear_area)
"ab" = (/turf/dmm_suite/no_wall,/area/dmm_suite/clear_area)
"ac" = (/turf/simulated/wall/clockwork/indestructable,/area/mission/prefab/misc/clockwork_hall)
"ad" = (/turf/simulated/wall/clockwork/tough,/area/mission/prefab/misc/clockwork_hall)
"ae" = (/mob/living/simple/turret/clockwork,/turf/simulated/floor/clockwork/reebe,/area/mission/prefab/misc/clockwork_hall)
"af" = (/obj/marker/map_node,/turf/simulated/floor/clockwork/reebe,/area/mission/prefab/misc/clockwork_hall)
"ag" = (/turf/simulated/wall/clockwork,/area/mission/prefab/misc/clockwork_hall)
"ah" = (/turf/simulated/floor/clockwork/reebe,/area/mission/prefab/misc/clockwork_hall)
"ai" = (/turf/simulated/floor/clockwork/alt1,/area/mission/prefab/misc/clockwork_hall)
"aj" = (/mob/living/advanced/npc/clockwork_cultist,/turf/simulated/floor/clockwork/reebe,/area/mission/prefab/misc/clockwork_hall)
"ak" = (/mob/living/simple/turret/clockwork,/turf/simulated/floor/clockwork/alt2,/area/mission/prefab/misc/clockwork_hall)
"al" = (/obj/structure/interactive/crate/chest/filled,/turf/simulated/floor/clockwork/reebe,/area/mission/prefab/misc/clockwork_hall)
"am" = (/obj/marker/objective_spawn,/turf/simulated/floor/clockwork/reebe,/area/mission/prefab/misc/clockwork_hall)
"an" = (/turf/simulated/floor/clockwork/alt3,/area/mission/prefab/misc/clockwork_hall)
"ao" = (/mob/living/simple/parrot/clockwork,/turf/simulated/floor/clockwork/reebe,/area/mission/prefab/misc/clockwork_hall)
"ap" = (/mob/living/simple/watcher/clockwork,/turf/simulated/floor/clockwork/reebe,/area/mission/prefab/misc/clockwork_hall)
"aq" = (/obj/marker/map_node/x2,/turf/simulated/floor/clockwork/reebe,/area/mission/prefab/misc/clockwork_hall)
"ar" = (/obj/structure/window/clockwork,/turf/simulated/floor/clockwork/alt1,/area/mission/prefab/misc/clockwork_hall)
"as" = (/obj/structure/window/clockwork,/turf/simulated/floor/clockwork/reebe,/area/mission/prefab/misc/clockwork_hall)
"at" = (/obj/structure/table/brass,/turf/simulated/floor/clockwork/alt1,/area/mission/prefab/misc/clockwork_hall)
"au" = (/obj/structure/table/brass,/turf/simulated/floor/clockwork/alt3,/area/mission/prefab/misc/clockwork_hall)
"av" = (/mob/living/simple/turret/clockwork,/turf/simulated/floor/clockwork/alt1,/area/mission/prefab/misc/clockwork_hall)
"aw" = (/mob/living/simple/watcher/clockwork{icon_state = "warden"; dir = 4},/turf/simulated/floor/clockwork/alt2,/area/mission/prefab/misc/clockwork_hall)
"ax" = (/mob/living/simple/watcher/clockwork{icon_state = "warden"; dir = 8},/turf/simulated/floor/clockwork/alt2,/area/mission/prefab/misc/clockwork_hall)
"ay" = (/obj/structure/table/brass,/turf/simulated/floor/clockwork/reebe,/area/mission/prefab/misc/clockwork_hall)
"az" = (/obj/structure/window/clockwork,/turf/simulated/floor/clockwork/alt3,/area/mission/prefab/misc/clockwork_hall)
"aA" = (/turf/simulated/floor/clockwork/special,/area/mission/prefab/misc/clockwork_hall)
"aB" = (/mob/living/simple/turret/clockwork,/turf/simulated/floor/clockwork/alt3,/area/mission/prefab/misc/clockwork_hall)
"aC" = (/mob/living/advanced/npc/clockwork_cultist{icon_state = "directional"; dir = 8},/turf/simulated/floor/clockwork/alt3,/area/mission/prefab/misc/clockwork_hall)
"aD" = (/mob/living/advanced/npc/clockwork_cultist{icon_state = "directional"; dir = 4},/turf/simulated/floor/clockwork/alt3,/area/mission/prefab/misc/clockwork_hall)
"aE" = (/mob/living/simple/watcher/clockwork_mobile,/turf/simulated/floor/clockwork/reebe,/area/mission/prefab/misc/clockwork_hall)
"aF" = (/mob/living/simple/watcher/clockwork,/obj/marker/map_node,/turf/simulated/floor/clockwork/reebe,/area/mission/prefab/misc/clockwork_hall)
"aG" = (/mob/living/advanced/npc/clockwork_cultist{icon_state = "directional"; dir = 1},/turf/simulated/floor/clockwork/reebe,/area/mission/prefab/misc/clockwork_hall)
"aH" = (/mob/living/simple/clockwork_marauder,/turf/simulated/floor/clockwork/reebe,/area/mission/prefab/misc/clockwork_hall)
"aI" = (/obj/structure/interactive/crate/chest/filled,/turf/simulated/floor/clockwork/alt3,/area/mission/prefab/misc/clockwork_hall)
"aJ" = (/mob/living/advanced/npc/clockwork_cultist,/obj/marker/map_node,/turf/simulated/floor/clockwork/reebe,/area/mission/prefab/misc/clockwork_hall)
"aK" = (/mob/living/simple/watcher/clockwork,/obj/marker/map_node/x2,/turf/simulated/floor/clockwork/reebe,/area/mission/prefab/misc/clockwork_hall)
"aL" = (/mob/living/simple/clockwork_marauder{icon_state = "living"; dir = 8},/obj/marker/map_node,/turf/simulated/floor/clockwork/reebe,/area/mission/prefab/misc/clockwork_hall)
"aM" = (/mob/living/simple/watcher/clockwork{icon_state = "warden"; dir = 4},/turf/simulated/floor/clockwork/reebe,/area/mission/prefab/misc/clockwork_hall)
"aN" = (/mob/living/simple/watcher/clockwork{icon_state = "warden"; dir = 8},/turf/simulated/floor/clockwork/reebe,/area/mission/prefab/misc/clockwork_hall)
"aO" = (/mob/living/advanced/npc/clockwork_cultist{icon_state = "directional"; dir = 4},/turf/simulated/floor/clockwork/reebe,/area/mission/prefab/misc/clockwork_hall)
"aP" = (/mob/living/advanced/npc/clockwork_cultist{icon_state = "directional"; dir = 8},/turf/simulated/floor/clockwork/reebe,/area/mission/prefab/misc/clockwork_hall)
"aQ" = (/obj/marker/map_node,/turf/simulated/floor/clockwork/alt3,/area/mission/prefab/misc/clockwork_hall)
"aR" = (/mob/living/simple/watcher/clockwork_mobile,/turf/simulated/floor/clockwork/alt3,/area/mission/prefab/misc/clockwork_hall)
"aS" = (/mob/living/simple/turret/clockwork,/turf/simulated/floor/clockwork/special,/area/mission/prefab/misc/clockwork_hall)
"aT" = (/mob/living/simple/clockwork_marauder,/turf/simulated/floor/clockwork/alt3,/area/mission/prefab/misc/clockwork_hall)
"aU" = (/mob/living/simple/clockwork_fragment,/turf/simulated/floor/clockwork/reebe,/area/mission/prefab/misc/clockwork_hall)
"aV" = (/obj/marker/map_node/x4,/turf/simulated/floor/clockwork/reebe,/area/mission/prefab/misc/clockwork_hall)
"aW" = (/obj/structure/table/brass,/turf/simulated/floor/clockwork/special,/area/mission/prefab/misc/clockwork_hall)
"aX" = (/obj/marker/map_node,/turf/dmm_suite/no_wall,/area/dmm_suite/clear_area)
"aY" = (/obj/marker/smart_clear_turf,/turf/dmm_suite/no_wall,/area/dmm_suite/clear_area)
"aZ" = (/obj/marker/map_node/x3,/turf/dmm_suite/no_wall,/area/dmm_suite/clear_area)
"ba" = (/obj/marker/map_node,/turf/simulated/floor/clockwork/special,/area/mission/prefab/misc/clockwork_hall)
"bb" = (/mob/living/simple/clockwork_marauder{icon_state = "living"; dir = 4},/obj/marker/map_node,/turf/simulated/floor/clockwork/reebe,/area/mission/prefab/misc/clockwork_hall)
"bc" = (/mob/living/simple/clockwork_marauder,/obj/marker/map_node,/turf/simulated/floor/clockwork/reebe,/area/mission/prefab/misc/clockwork_hall)
"bd" = (/mob/living/advanced/npc/clockwork_cultist{icon_state = "directional"; dir = 4},/obj/marker/map_node,/turf/simulated/floor/clockwork/reebe,/area/mission/prefab/misc/clockwork_hall)
"be" = (/mob/living/simple/watcher/clockwork{icon_state = "warden"; dir = 4},/obj/marker/map_node,/turf/simulated/floor/clockwork/reebe,/area/mission/prefab/misc/clockwork_hall)
"bf" = (/mob/living/simple/watcher/clockwork{icon_state = "warden"; dir = 8},/obj/marker/map_node,/turf/simulated/floor/clockwork/reebe,/area/mission/prefab/misc/clockwork_hall)
"bg" = (/obj/marker/lobby,/turf/simulated/floor/clockwork/reebe,/area/mission/prefab/misc/clockwork_hall)

(1,1,1) = {"
aaaaaaaaaaaaaaaaaaaaaaaaaaaaaaaaaaaaaaaaaaaaaaaaaaaaaaaaaaaaaaaaaaaaaaaaaaaaaaaaaaaaaaaaaaaaaaaaaaaaaaaaaaaaaaaaaaaaaaaaaaaaaaaa
aaaaaaaaaaaaaaaaaaaaaaaaaaaaaaaaaaaaaaaaaaaaaaaaaaaaaaaaaaaaaaaaaaaaaaaaaaaaaaaaaaaaaaaaaaaaaaaaaaaaaaaaaaaaaaaaaaaaaaaaaaaaaaaa
aaaaaaaaaaaaaaaaaaaaaaaaaaaaaaaaaaaaaaaaaaaaaaaaaaaaaaaaaaaaaaaaaaaaaaaaaaaaaaaaaaaaaaaaaaaaaaaaaaaaaaaaaaaaaaaaaaaaaaaaaaaaaaaa
aaaaaaaaaaaaaaaaaaaaaaaaaaaaaaaaaaaaaaaaaaaaaaaaaaaaaaaaaaaaaaaaaaaaaaaaaaaaaaaaaaaaaaaaaaaaaaaaaaaaaaaaaaaaaaaaaaaaaaaaaaaaaaaa
aaaaaaaaaaaaaaaaaaaaaaaaaaaaaaaaaaaaaaaaaaaaaaaaaaaaaaaaaaaaaaaaaaaaaaaaaaaaaaaaaaaaaaaaaaaaaaaaaaaaaaaaaaaaaaaaaaaaaaaaaaaaaaaa
aaaaaaaaaaaaaaaaaaaaaaaaaaaaaaaaaaaaaaaaaaaaaaaaaaaaaaaaaaaaaaaaaaaaaaaaaaaaaaaaaaaaaaaaaaaaaaaaaaaaaaaaaaaaaaaaaaaaaaaaaaaaaaaa
aaaaaaaaaaaaaaaaaaaaaaaaaaaaaaaaaaaaaaaaaaaaaaaaaaaaaaaaaaaaaaaaaaaaaaaaaaaaaaaaaaaaaaaaaaaaaaaaaaaaaaaaaaaaaaaaaaaaaaaaaaaaaaaa
aaaaaaaaaaaaaaaaaaaaaaaaaaaaaaaaaaaaaaaaaaaaaaaaaaaaaaaaaaaaaaaaaaaaaaaaaaaaaaaaaaaaaaaaaaaaaaaaaaaaaaaaaaaaaaaaaaaaaaaaaaaaaaaa
aaaaaaaaaaaaaaaaaaaaaaaaaaaaaaaaaaaaaaaaaaaaaaaaaaaaaaaaaaaaaaaaaaaaaaaaaaaaaaaaaaaaaaaaaaaaaaaaaaaaaaaaaaaaaaaaaaaaaaaaaaaaaaaa
aaaaaaaaaaaaaaaaaaaaaaaaaaaaaaaaaaaaaaaaaaaaaaaaaaaaaaaaaaaaaaaaaaaaaaaaaaaaaaaaaaaaaaaaaaaaaaaaaaaaaaaaaaaaaaaaaaaaaaaaaaaaaaaa
aaaaaaaaaaaaaaaaaaaaaaaaaaaaaaaaaaaaaaaaaaaaaaaaaaaaaaaaaaaaaaaaaaaaaaaaaaaaaaaaaaaaaaaaaaaaaaaaaaaaaaaaaaaaaaaaaaaaaaaaaaaaaaaa
aaaaaaaaaaaaaaaaaaaaaaaaaaaaaaaaaaaaaaaaaaaaaaaaaaaaaaaaaaaaaaaaaaaaaaaaaaaaaaaaaaaaaaaaaaaaaaaaaaaaaaaaaaaaaaaaaaaaaaaaaaaaaaaa
aaaaaaaaaaaaaaaaaaaaabababababababababababababababababababababababababababababababababababababababababaaaaaaaaaaaaaaaaaaaaaaaaaa
aaaaaaaaaaaaaaaaaaaaabacacacacacacacacacacacacacacacadadadadadadadadadacacacacacacacacacacacacacacacabaaaaaaaaaaaaaaaaaaaaaaaaaa
aaaaaaaaaaaaaaaaaaaaabacaeafagahahagahaiahahajahahaiadakaialamalaiakadaiahahajahahaiahagahahagafaeacabaaaaaaaaaaaaaaaaaaaaaaaaaa
aaaaaaaaaaaaaaaaaaaaabacahahagagagagafanahahahahahanadaiahahaoahahaiadanahahahahahanafagagagagahahacabaaaaaaaaaaaaaaaaaaaaaaaaaa
aaaaaaaaaaaaaaaaaaaaabacahahagapalagahaiahahaqahahanadahahahafahahahadanahahaqahahaiahagalapagahahacabaaaaaaaaaaaaaaaaaaaaaaaaaa
aaaaaaaaaaaaaaaaaaaaabacahafahafahahafagahahahahahanadajahahahahahajadanahahahahahagafahahafahafahacabaaaaaaaaaaaaaaaaaaaaaaaaaa
aaaaaaaaaaaaaaaaaaaaabacagagagagagagahagahahahahahanadarasajajajasaradanahahahahahagahagagagagagagacabaaaaaaaaaaaaaaaaaaaaaaaaaa
aaaaaaaaaaaaaaaaaaaaabacbaahahahahafafagatauauauauavadawarapaFaparaxadavauauauauauagafbaahahahahafacabaaaaaaaaaaaaaaaaaaaaaaaaaa
aaaaaaaaaaaaaaaaaaaaabacahayayayayahagagasasasasasagadadagazanazagadadagasasasasasagagahayayayayahacabaaaaaaaaaaaaaaaaaaaaaaaaaa
aaaaaaaaaaaaaaaaaaaaabacbaananananbaagakaiananananaQananananaQananananaQananananaiakagbaananananbaacabaaaaaaaaaaaaaaaaaaaaaaaaaa
aaaaaaaaaaaaaaaaaaaaabacanahahahahanasahapahahahapajahahapahajahapahahajapahahahapahasanahahahahanacabaaaaaaaaaaaaaaaaaaaaaaaaaa
aaaaaaaaaaaaaaaaaaaaabacanahahahahagagayayayayayayayayayayayayayayayayayayayayayayayagagahahahahanacabaaaaaaaaaaaaaaaaaaaaaaaaaa
aaaaaaaaaaaaaaaaaaaaabacanahahahahaBagagagagagagagagagagasasasasasagagagagagagagagagagaBahahahahanacabaaaaaaaaaaaaaaaaaaaaaaaaaa
aaaaaaaaaaaaaaaaaaaaabacanahahahahaCagayayalayayajayayayayayayayayayayayajayayalayayagaDahahahahanacabaaaaaaaaaaaaaaaaaaaaaaaaaa
aaaaaaaaaaaaaaaaaaaaabacaQaEahaqahbaahahahafahahahahafahahahafahahahafahahahafahahaFahbaahaqahaEaQacabaaaaaaaaaaaaaaaaaaaaaaaaaa
aaaaaaaaaaaaaaaaaaaaabacanahahahahaCagagagagagagagagahadadahahahadadahadadadadadadahagaDahahahahanacabaaaaaaaaaaaaaaaaaaaaaaaaaa
aaaaaaaaaaaaaaaaaaaaabacanahahahahanasaJahafagaJahahafadadaGaGaGadadafahahahafaHadafasanahahahahanacabaaaaaaaaaaaaaaaaaaaaaaaaaa
aaaaaaaaaaaaaaaaaaaaabacanahahahahaIasahagahagahadadadadadadadadadadadadadadadadadahasaIahahahahanacabaaaaaaaaaaaaaaaaaaaaaaaaaa
aaaaaaaaaaaaaaaaaaaaabacanahahaqahanasahagahagahadahahahahahahahafahahahafahahafadahasanahaqahahanacabaaaaaaaaaaaaaaaaaaaaaaaaaa
aaaaaaaaaaaaaaaaaaaaabacanahahahanagagahagbbahafahagagagapapaKapapagagagagagagahadahagaganahahahanacabaaaaaaaaaaaaaaaaaaaaaaaaaa
aaaaaaaaaaaaaaaaaaaaabacanahahahanaeasafahafagagagagayagasasasasasagayagahafahafahaLasaeanahahahanacabaaaaaaaaaaaaaaaaaaaaaaaaaa
aaaaaaaaaaaaaaaaaaaaabacanahahahanagagahadadadafahagaMayayayayayayayaNagahahadadadahagaganahahahanacabaaaaaaaaaaaaaaaaaaaaaaaaaa
aaaaaaaaaaaaaaaaaaaaabacanahahaqananagahadbcahafagagaOayaEahahahaEayaPagagbdahbcadahagananaqahahanacabaaaaaaaaaaaaaaaaaaaaaaaaaa
aaaaaaaaaaaaaaaaaaaaabacanahahahahbaahafadahadafahahbeayahahaqahahaybfahahafadahadafahbaahahahahanacabaaaaaaaaaaaaaaaaaaaaaaaaaa
aaaaaaaaaaaaaaaaaaaaabacanahahahahaCadadadahadadadadadadahahahahahadadadadadadahadadadaDahahahahanacabaaaaaaaaaaaaaaaaaaaaaaaaaa
aaaaaaaaaaaaaaaaaaaaabacanahahahahanagaiahafahahahahahahahahafahahahahahahahahafahaiaganahahahahanacabaaaaaaaaaaaaaaaaaaaaaaaaaa
aaaaaaaaaaaaaaaaaaaaabacaAanaQananaAagakaiananananaAaQaAanananananaAaQaAananananaiakagaAananaQanaAacabaaaaaaaaaaaaaaaaaaaaaaaaaa
aaaaaaaaaaaaaaaaaaaaabacayayayayayayadadasasasadadanahanagasasasaganahanadadasasasadadayayayayayayacabaaaaaaaaaaaaaaaaaaaaaaaaaa
aaaaaaaaaaaaaaaaaaaaabacaAaRaQanaRanauauauauauaSadanaEanasaAaIaAasanaEanadaSauauauauauanaRanaQaRaAacabaaaaaaaaaaaaaaaaaaaaaaaaaa
aaaaaaaaaaaaaaaaaaaaabacanahahahahahahahahahaPauasanahanasanaEanasanahanasauaOahahahahahahahahahanacabaaaaaaaaaaaaaaaaaaaaaaaaaa
aaaaaaaaaaaaaaaaaaaaabacanahahahahahahahahahahauasanahanasanaHanasanahanasauahahahahahahahahahahanacabaaaaaaaaaaaaaaaaaaaaaaaaaa
aaaaaaaaaaaaaaaaaaaaabacanahahaqahahahaHahafahaIasanaqanasanbganasanaqanasaIahafahaHahahahaqahahanacabaaaaaaaaaaaaaaaaaaaaaaaaaa
aaaaaaaaaaaaaaaaaaaaabacanahahahahahahahahahahauasanahanasanaEanasanahanasauahahahahahahahahahahanacabaaaaaaaaaaaaaaaaaaaaaaaaaa
aaaaaaaaaaaaaaaaaaaaabacanahahahahahahahahahaPauasanaEanasanahanasanaEanasauaOahahahahahahahahahanacabaaaaaaaaaaaaaaaaaaaaaaaaaa
aaaaaaaaaaaaaaaaaaaaabacaSauauauauauauauauauauaSadanahanasaAanaAasanahanadaSauauauauauauauauauauaSacabaaaaaaaaaaaaaaaaaaaaaaaaaa
aaaaaaaaaaaaaaaaaaaaabadadasasasasasasasasasasadadanahanagasasasaganahanadadasasasasasasasasasasadadabaaaaaaaaaaaaaaaaaaaaaaaaaa
aaaaaaaaaaaaaaaaaaaaabagakataIauauauauauauauauauaTaAanaAaTanananaTaAanaAaTauauauauauauauauauaIatakagabaaaaaaaaaaaaaaaaaaaaaaaaaa
aaaaaaaaaaaaaaaaaaaaabagaiahahahahahahahahahahahahahaqahahahaqahahahaqahahahahahahahahahahahahahaiagabaaaaaaaaaaaaaaaaaaaaaaaaaa
aaaaaaaaaaaaaaaaaaaaabaganahahahahahahahahahahafahahahahahahahahahahahahahafahahahaUahahahahahahanagabaaaaaaaaaaaaaaaaaaaaaaaaaa
aaaaaaaaaaaaaaaaaaaaabaganahahahahahahaUahahahahahahahagagasasasagagahahahahahahahahahahahahahahanagabaaaaaaaaaaaaaaaaaaaaaaaaaa
aaaaaaaaaaaaaaaaaaaaabaganahahahahaVahahaHahahahagagagagauauauauauagagagagahahahahaHahaVaHahahahanagabaaaaaaaaaaaaaaaaaaaaaaaaaa
aaaaaaaaaaaaaaaaaaaaabaganahahahahahahahahahahahagaWauauauahapahauauauaWagahahahahahahahahahahahanagabaaaaaaaaaaaaaaaaaaaaaaaaaa
aaaaaaaaaaaaaaaaaaaaabaganahahaUahaHahahahahahahagauahahaUahahahahahahauagahahahahaUahahahahaUahanagabaaaaaaaaaaaaaaaaaaaaaaaaaa
aaaaaaaaaaaaaaaaaaaaabaganahahahahahahahaUahahafahaQahahahahaqahaUahaUaQahafahahahahahahahahahahanagabaaaaaaaaaaaaaaaaaaaaaaaaaa
aaaaaaaaaaaaaaaaaaaaabagaiahahahahahahahahahahahaganaUahaHahahahaHahahanagahahahahahahahahahahahaiagabaaaaaaaaaaaaaaaaaaaaaaaaaa
aaaaaaaaaaaaaaaaaaaaabagakaiananananananananananagaAanananananananananaAagananananananananananaiakagabaaaaaaaaaaaaaaaaaaaaaaaaaa
aaaaaaaaaaaaaaaaaaaaabagagasasasasasasasasasasasagagahafahahafahahafahagagasasasasasasasasasasasagagabaaaaaaaaaaaaaaaaaaaaaaaaaa
aaaaaaaaaaaaaaaaaaaaabababababababababababababababababababababababababababababababababababababababababaaaaaaaaaaaaaaaaaaaaaaaaaa
aaaaaaaaaaaaaaaaaaaaaaaaaaaXabaYabababababababababababaYababababababaYababababababababababaYabaXaaaaaaaaaaaaaaaaaaaaaaaaaaaaaaaa
aaaaaaaaaaaaaaaaaaaaaaaaaaaaababababababaZababababaZababababaZababababaZababababaZababababababaaaaaaaaaaaaaaaaaaaaaaaaaaaaaaaaaa
aaaaaaaaaaaaaaaaaaaaaaaaaaaaaaabababababababababababababababababababababababababababababababaaaaaaaaaaaaaaaaaaaaaaaaaaaaaaaaaaaa
aaaaaaaaaaaaaaaaaaaaaaaaaaaaaaaaabababababababababababababababababababababababababababababaaaaaaaaaaaaaaaaaaaaaaaaaaaaaaaaaaaaaa
"}
