//MAP CONVERTED BY dmm2tgm.py THIS HEADER COMMENT PREVENTS RECONVERSION, DO NOT REMOVE
"a" = (
/turf/dmm_suite/clear_turf,
/area/dmm_suite/clear_area)
"b" = (
/turf/simulated/wall/rock/indestructable,
/area/prefab/clockwork_cult)
"c" = (
/turf/simulated/wall/clockwork/indestructable,
/area/prefab/clockwork_cult)
"d" = (
/turf/simulated/wall/clockwork,
/area/prefab/clockwork_cult)
"e" = (
/turf/unsimulated/abyss,
/area/prefab/clockwork_cult)
"f" = (
/mob/living/simple/parrot/clockwork,
/turf/simulated/floor/clockwork/reebe,
/area/prefab/clockwork_cult)
"g" = (
/turf/simulated/floor/clockwork/alt1,
/area/prefab/clockwork_cult)
"h" = (
/obj/structure/table/brass,
/turf/simulated/floor/clockwork/alt1,
/area/prefab/clockwork_cult)
"i" = (
/obj/structure/window/clockwork,
/turf/simulated/floor/clockwork/reebe,
/area/prefab/clockwork_cult)
"j" = (
/obj/marker/map_node,
/turf/simulated/floor/clockwork/reebe,
/area/prefab/clockwork_cult)
"k" = (
/mob/living/advanced/npc/clockwork_cultist,
/turf/simulated/floor/clockwork/reebe,
/area/prefab/clockwork_cult)
"l" = (
/obj/structure/window/clockwork,
/turf/simulated/floor/clockwork/alt1,
/area/prefab/clockwork_cult)
"m" = (
/mob/living/simple/watcher/clockwork{
	dir = 4;
	icon_state = "warden"
	},
/turf/simulated/floor/clockwork/alt2,
/area/prefab/clockwork_cult)
"n" = (
/mob/living/simple/watcher/clockwork,
/turf/simulated/floor/clockwork/reebe,
/area/prefab/clockwork_cult)
"o" = (
/mob/living/simple/watcher/clockwork{
	dir = 8;
	icon_state = "warden"
	},
/turf/simulated/floor/clockwork/alt2,
/area/prefab/clockwork_cult)
"p" = (
/obj/structure/window/clockwork,
/turf/simulated/floor/clockwork/alt3,
/area/prefab/clockwork_cult)
"q" = (
/turf/simulated/floor/clockwork/alt3,
/area/prefab/clockwork_cult)
"r" = (
/turf/simulated/floor/clockwork/reebe,
/area/prefab/clockwork_cult)
"s" = (
/turf/simulated/wall/clockwork/tough,
/area/prefab/clockwork_cult)
"t" = (
/mob/living/advanced/npc/clockwork_cultist{
	dir = 1;
	icon_state = "directional"
	},
/turf/simulated/floor/clockwork/reebe,
/area/prefab/clockwork_cult)
"u" = (
/mob/living/simple/clockwork_marauder,
/turf/simulated/floor/clockwork/reebe,
/area/prefab/clockwork_cult)
"v" = (
/mob/living/simple/clockwork_marauder{
	dir = 4;
	icon_state = "living"
	},
/turf/simulated/floor/clockwork/reebe,
/area/prefab/clockwork_cult)
"w" = (
/mob/living/simple/clockwork_marauder{
	dir = 8;
	icon_state = "living"
	},
/turf/simulated/floor/clockwork/reebe,
/area/prefab/clockwork_cult)
"x" = (
/mob/living/simple/watcher/clockwork{
	dir = 4;
	icon_state = "warden"
	},
/turf/simulated/floor/clockwork/reebe,
/area/prefab/clockwork_cult)
"y" = (
/mob/living/simple/watcher/clockwork{
	dir = 8;
	icon_state = "warden"
	},
/turf/simulated/floor/clockwork/reebe,
/area/prefab/clockwork_cult)
"z" = (
/mob/living/advanced/npc/clockwork_cultist{
	dir = 4;
	icon_state = "directional"
	},
/turf/simulated/floor/clockwork/reebe,
/area/prefab/clockwork_cult)
"A" = (
/mob/living/advanced/npc/clockwork_cultist{
	dir = 8;
	icon_state = "directional"
	},
/turf/simulated/floor/clockwork/reebe,
/area/prefab/clockwork_cult)
"B" = (
/turf/simulated/floor/clockwork/special,
/area/prefab/clockwork_cult)
"C" = (
/mob/living/simple/clockwork_marauder,
/turf/simulated/floor/clockwork/alt3,
/area/prefab/clockwork_cult)
"D" = (
/mob/living/simple/clockwork_fragment,
/turf/simulated/floor/clockwork/reebe,
/area/prefab/clockwork_cult)
"E" = (
/obj/structure/table/brass,
/turf/simulated/floor/clockwork/alt3,
/area/prefab/clockwork_cult)
"F" = (
/turf/dmm_suite/no_wall,
/area/dmm_suite/clear_area)
"G" = (
/mob/living/simple/turret/clockwork,
/turf/simulated/floor/clockwork/alt2,
/area/prefab/clockwork_cult)
"H" = (
/mob/living/simple/watcher/clockwork_mobile,
/turf/simulated/floor/clockwork/reebe,
/area/prefab/clockwork_cult)
"I" = (
/obj/structure/table/brass,
/turf/simulated/floor/clockwork/special,
/area/prefab/clockwork_cult)
"J" = (
/obj/structure/table/brass,
/turf/simulated/floor/clockwork/reebe,
/area/prefab/clockwork_cult)
"K" = (
/obj/marker/map_node,
/turf/simulated/floor/clockwork/alt3,
/area/prefab/clockwork_cult)
"L" = (
/obj/marker/map_node,
/turf/dmm_suite/no_wall,
/area/dmm_suite/clear_area)
"S" = (
/obj/structure/interactive/crate/chest/filled,
/turf/simulated/floor/clockwork/alt3,
/area/prefab/clockwork_cult)

(1,1,1) = {"
a
a
a
a
a
a
a
a
a
a
a
a
a
a
a
a
a
a
a
a
a
a
a
a
a
a
a
a
a
a
a
a
a
a
a
a
a
a
a
a
a
a
a
a
a
a
a
a
a
a
a
a
a
a
a
a
a
a
a
a
a
a
a
a
"}
(2,1,1) = {"
a
a
a
a
a
a
a
a
a
a
a
a
a
a
a
a
a
a
a
a
a
a
a
a
a
a
a
a
a
a
a
a
a
a
a
a
a
a
a
a
a
a
a
a
a
a
a
a
a
a
a
a
a
a
a
a
a
a
a
a
a
a
a
a
"}
(3,1,1) = {"
a
a
a
a
a
a
a
a
a
a
a
a
a
a
a
a
a
a
a
a
a
a
a
a
a
a
a
a
a
a
a
a
a
a
a
a
a
a
a
a
a
a
a
a
a
a
a
a
a
a
a
a
a
a
a
a
a
a
a
a
a
a
a
a
"}
(4,1,1) = {"
a
a
a
a
a
a
a
a
a
a
a
a
a
a
a
a
a
a
a
a
a
a
a
a
a
a
a
a
a
a
a
a
a
a
a
a
a
a
a
a
a
a
a
a
a
a
a
a
a
a
a
a
a
a
a
a
a
a
a
a
a
a
a
a
"}
(5,1,1) = {"
a
a
a
a
a
a
a
a
a
a
a
a
a
a
a
a
a
a
a
a
a
a
a
a
a
a
a
a
a
a
a
a
a
a
a
a
a
a
a
a
a
a
a
a
a
a
a
a
a
a
a
a
a
a
a
a
a
a
a
a
a
a
a
a
"}
(6,1,1) = {"
a
a
a
a
a
a
a
a
a
a
a
a
a
a
a
a
a
a
a
a
a
a
a
a
a
a
a
a
a
a
a
a
a
a
a
a
a
a
a
a
a
a
a
a
a
a
a
a
a
a
a
a
a
a
a
a
a
a
a
a
a
a
a
a
"}
(7,1,1) = {"
a
a
a
a
a
a
a
a
a
a
a
a
a
a
a
a
a
a
a
a
a
a
a
a
a
a
a
a
a
a
a
a
a
a
a
a
a
a
a
a
a
a
a
a
a
a
a
a
a
a
a
a
a
a
a
a
a
a
a
a
a
a
a
a
"}
(8,1,1) = {"
a
a
a
a
a
a
a
a
a
a
a
a
a
a
a
a
a
a
a
a
a
a
a
a
a
a
a
a
a
a
a
a
a
a
a
a
a
a
a
a
a
a
a
a
a
a
a
a
a
a
a
a
a
a
a
a
a
a
a
a
a
a
a
a
"}
(9,1,1) = {"
a
a
a
a
a
a
a
a
a
a
a
a
a
a
a
a
a
a
a
a
a
a
a
a
a
a
a
a
a
a
a
a
a
a
a
a
a
a
a
a
a
a
a
a
a
a
a
a
a
a
a
a
a
a
a
a
a
a
a
a
a
a
a
a
"}
(10,1,1) = {"
a
a
a
a
a
a
a
a
a
a
a
a
a
a
a
a
a
a
a
a
a
a
a
a
a
a
a
a
a
a
a
a
a
a
a
a
a
a
a
a
a
a
a
a
a
a
a
a
a
a
a
a
a
a
a
a
a
a
a
a
a
a
a
a
"}
(11,1,1) = {"
a
a
a
a
a
a
a
a
a
a
a
a
b
b
b
b
b
b
b
b
b
b
b
b
b
b
b
b
b
b
b
b
b
b
b
b
b
b
b
b
b
b
b
b
b
b
b
a
a
a
a
a
a
a
a
a
a
a
a
a
a
a
a
a
"}
(12,1,1) = {"
a
a
a
a
a
a
a
a
a
a
a
a
b
c
c
c
c
c
c
c
c
c
c
c
c
c
c
c
c
c
c
c
c
c
c
c
c
c
c
c
c
c
c
c
c
c
c
d
d
d
d
d
d
d
d
d
d
d
d
a
a
a
a
a
"}
(13,1,1) = {"
a
a
a
a
a
a
a
a
a
a
a
a
b
c
e
e
e
e
e
e
e
e
e
e
e
e
e
e
e
e
e
e
e
e
e
e
e
e
e
e
e
e
e
e
e
e
e
d
G
g
q
q
q
q
q
q
g
G
d
F
a
a
a
a
"}
(14,1,1) = {"
a
a
a
a
a
a
a
a
a
a
a
a
b
c
e
e
e
e
e
e
e
e
e
e
e
e
e
e
e
e
e
e
e
e
e
e
e
e
e
e
e
e
e
e
e
e
e
i
h
r
r
r
r
r
r
r
r
g
i
F
F
a
a
a
"}
(15,1,1) = {"
a
a
a
a
a
a
a
a
a
a
a
a
b
c
e
e
e
e
e
e
e
e
e
e
e
e
e
e
e
e
e
e
e
e
e
e
e
e
e
e
e
e
e
e
e
e
e
i
S
r
r
r
r
r
r
r
r
q
i
F
F
F
a
a
"}
(16,1,1) = {"
a
a
a
a
a
a
a
a
a
a
a
a
b
c
e
e
e
e
e
e
e
e
e
e
e
e
e
e
e
e
e
e
e
e
e
e
e
e
e
e
e
e
e
e
e
e
e
i
E
r
r
r
r
r
D
r
r
q
i
F
F
F
F
a
"}
(17,1,1) = {"
a
a
a
a
a
a
a
a
a
a
a
a
b
c
e
e
e
e
e
e
e
e
e
e
e
e
e
e
e
e
e
e
e
e
e
e
e
e
e
e
e
e
e
e
e
e
e
i
E
r
r
r
r
r
r
r
r
q
i
F
F
F
F
F
"}
(18,1,1) = {"
a
a
a
a
a
a
a
a
a
a
a
a
b
c
e
e
e
e
e
e
e
e
e
e
e
e
e
e
e
e
e
e
e
e
e
e
e
e
e
e
e
e
e
e
e
e
e
i
E
r
r
r
r
r
u
r
r
q
i
F
F
F
F
F
"}
(19,1,1) = {"
a
a
a
a
a
a
a
a
a
a
a
a
b
c
e
e
e
e
e
e
d
d
i
d
d
d
i
d
i
i
i
i
i
i
i
i
s
d
d
d
e
e
e
e
e
e
e
i
E
r
r
r
r
r
r
r
r
q
i
F
F
F
F
F
"}
(20,1,1) = {"
a
a
a
a
a
a
a
a
a
a
a
a
b
c
e
e
e
e
e
e
d
G
r
J
d
J
r
d
k
r
r
r
r
r
r
r
s
g
G
d
e
e
e
e
e
e
e
i
E
r
r
D
r
r
r
r
r
q
i
F
F
F
F
F
"}
(21,1,1) = {"
a
a
a
a
a
a
a
a
a
a
a
a
b
c
e
e
e
e
e
e
i
g
n
J
d
J
r
d
r
d
d
d
r
s
s
s
s
r
g
i
e
e
e
e
e
e
e
i
E
r
r
r
u
r
r
D
r
q
i
F
F
F
F
F
"}
(22,1,1) = {"
a
a
a
a
a
a
a
a
a
a
a
a
b
c
e
e
e
e
e
e
i
q
r
J
d
J
r
d
r
r
r
v
r
s
u
r
r
r
q
i
e
e
e
e
e
e
e
i
E
r
r
r
r
r
r
r
r
q
i
F
F
F
F
F
"}
(23,1,1) = {"
a
a
a
a
a
a
a
a
a
a
a
a
b
c
e
e
e
e
e
e
i
q
r
J
d
J
r
d
d
d
d
r
d
s
r
s
s
r
q
i
e
e
e
e
e
e
e
i
E
r
r
r
r
r
r
r
r
q
i
F
F
F
F
F
"}
(24,1,1) = {"
a
a
a
a
a
a
a
a
a
a
a
a
b
c
e
e
e
e
e
e
i
q
r
J
d
J
r
d
k
r
r
r
d
r
r
r
s
r
q
d
e
e
e
e
e
e
e
d
E
r
j
r
r
r
r
j
r
q
i
F
F
F
F
F
"}
(25,1,1) = {"
a
a
a
a
a
a
a
a
a
a
a
a
b
c
e
e
e
e
e
e
i
q
n
J
d
J
r
d
r
s
s
r
d
r
d
r
s
r
q
d
d
i
i
i
i
i
d
d
C
r
r
r
d
d
d
r
d
d
d
F
F
F
F
F
"}
(26,1,1) = {"
a
a
a
a
a
a
a
a
a
a
a
a
b
c
e
e
e
e
e
e
d
q
k
J
d
J
r
d
r
s
r
d
d
d
d
r
s
r
B
q
q
q
q
q
q
q
q
q
B
r
r
r
d
I
E
K
q
B
d
F
F
F
F
F
"}
(27,1,1) = {"
a
a
a
a
a
a
a
a
a
a
a
a
b
d
d
i
i
i
i
d
d
q
r
J
d
J
r
r
r
s
r
d
J
x
z
x
s
r
K
r
H
r
r
j
r
H
r
r
q
j
r
r
d
E
r
r
D
q
r
F
F
F
F
F
"}
(28,1,1) = {"
a
a
a
a
a
a
a
a
a
a
a
a
b
d
G
g
r
k
l
m
d
q
r
J
d
J
r
s
s
s
r
d
d
J
J
J
s
r
B
q
q
q
q
q
q
q
q
q
B
r
r
d
d
E
r
r
r
q
r
F
F
F
F
F
"}
(29,1,1) = {"
a
a
a
a
a
a
a
a
a
a
a
a
b
d
g
r
r
r
i
l
d
q
n
J
d
J
r
s
s
s
r
n
i
J
H
r
r
r
q
d
i
i
i
i
i
i
i
d
C
r
r
d
E
E
D
r
u
q
r
F
F
F
F
F
"}
(30,1,1) = {"
a
a
a
a
a
a
a
a
a
a
a
a
b
d
r
r
r
r
k
n
p
q
r
J
d
J
r
r
t
s
r
n
i
J
r
r
r
r
q
i
e
e
e
e
e
e
e
i
q
r
r
i
E
r
r
r
r
q
r
F
F
F
F
F
"}
(31,1,1) = {"
a
a
a
a
a
a
a
a
a
a
a
a
b
d
r
f
r
r
k
n
p
q
k
J
d
J
r
r
t
s
r
n
i
J
r
r
r
r
q
i
e
e
e
e
e
e
e
i
q
r
r
i
E
n
r
j
r
q
r
F
F
L
F
F
"}
(32,1,1) = {"
a
a
a
a
a
a
a
a
a
a
a
a
b
d
r
r
r
r
k
n
p
q
r
J
d
J
r
r
t
s
r
n
i
J
r
r
r
r
q
i
e
e
e
e
e
e
e
i
q
r
r
i
E
r
r
r
r
q
r
F
F
F
F
F
"}
(33,1,1) = {"
a
a
a
a
a
a
a
a
a
a
a
a
b
d
g
r
r
r
i
l
d
q
n
J
d
J
r
s
s
s
r
n
i
J
H
r
r
r
q
d
i
i
i
i
i
i
i
d
C
r
r
d
E
E
r
D
u
q
r
F
F
F
F
F
"}
(34,1,1) = {"
a
a
a
a
a
a
a
a
a
a
a
a
b
d
G
g
r
k
l
o
d
q
r
J
d
J
r
s
s
s
r
d
d
J
J
J
s
r
B
q
q
q
q
q
q
q
q
q
B
r
r
d
d
E
r
r
r
q
r
F
F
F
F
F
"}
(35,1,1) = {"
a
a
a
a
a
a
a
a
a
a
a
a
b
d
d
i
i
i
i
d
d
q
r
J
d
J
r
r
r
s
r
d
J
y
A
y
s
r
K
r
H
r
r
j
r
H
r
r
q
j
r
r
d
E
r
D
r
q
r
F
F
F
F
F
"}
(36,1,1) = {"
a
a
a
a
a
a
a
a
a
a
a
a
b
c
e
e
e
e
e
e
d
q
k
J
d
J
r
s
r
s
r
d
d
d
d
r
s
r
B
q
q
q
q
q
q
q
q
q
B
r
r
r
d
I
E
K
q
B
d
F
F
F
F
F
"}
(37,1,1) = {"
a
a
a
a
a
a
a
a
a
a
a
a
b
c
e
e
e
e
e
e
i
q
n
J
d
J
r
s
r
s
r
d
r
r
d
r
s
r
q
d
d
i
i
i
i
i
d
d
C
r
r
r
d
d
d
r
d
d
d
F
F
F
F
F
"}
(38,1,1) = {"
a
a
a
a
a
a
a
a
a
a
a
a
b
c
e
e
e
e
e
e
i
q
r
J
d
J
r
s
r
s
r
d
r
r
z
r
s
r
q
d
e
e
e
e
e
e
e
d
E
r
j
r
r
r
r
j
r
q
i
F
F
F
F
F
"}
(39,1,1) = {"
a
a
a
a
a
a
a
a
a
a
a
a
b
c
e
e
e
e
e
e
i
q
r
J
d
J
r
s
r
s
r
d
r
s
r
s
s
r
q
i
e
e
e
e
e
e
e
i
E
r
r
r
r
r
r
r
r
q
i
F
F
F
F
F
"}
(40,1,1) = {"
a
a
a
a
a
a
a
a
a
a
a
a
b
c
e
e
e
e
e
e
i
q
r
J
d
J
r
s
u
s
r
r
r
s
u
r
r
r
q
i
e
e
e
e
e
e
e
i
E
r
r
r
r
r
r
r
r
q
i
F
F
F
F
F
"}
(41,1,1) = {"
a
a
a
a
a
a
a
a
a
a
a
a
b
c
e
e
e
e
e
e
i
g
n
J
d
J
r
s
s
s
s
s
r
s
s
s
s
r
g
i
e
e
e
e
e
e
e
i
E
r
r
r
r
r
r
r
r
q
i
F
F
F
F
F
"}
(42,1,1) = {"
a
a
a
a
a
a
a
a
a
a
a
a
b
c
e
e
e
e
e
e
d
G
r
J
d
J
n
i
r
i
r
r
w
r
r
r
s
g
G
d
e
e
e
e
e
e
e
i
E
r
D
r
u
r
D
r
r
q
i
F
F
F
F
F
"}
(43,1,1) = {"
a
a
a
a
a
a
a
a
a
a
a
a
b
c
e
e
e
e
e
e
d
d
i
d
d
d
i
d
i
i
i
d
i
i
i
i
s
d
d
d
e
e
e
e
e
e
e
i
E
r
r
r
r
r
r
r
r
q
i
F
F
F
F
F
"}
(44,1,1) = {"
a
a
a
a
a
a
a
a
a
a
a
a
b
c
e
e
e
e
e
e
e
e
e
e
e
e
e
e
e
e
e
e
e
e
e
e
e
e
e
e
e
e
e
e
e
e
e
i
E
r
r
r
r
r
r
r
r
q
i
F
F
F
F
F
"}
(45,1,1) = {"
a
a
a
a
a
a
a
a
a
a
a
a
b
c
e
e
e
e
e
e
e
e
e
e
e
e
e
e
e
e
e
e
e
e
e
e
e
e
e
e
e
e
e
e
e
e
e
i
E
r
r
r
u
r
r
r
r
q
i
F
F
F
F
F
"}
(46,1,1) = {"
a
a
a
a
a
a
a
a
a
a
a
a
b
c
e
e
e
e
e
e
e
e
e
e
e
e
e
e
e
e
e
e
e
e
e
e
e
e
e
e
e
e
e
e
e
e
e
i
E
r
r
r
r
r
r
r
r
q
i
F
F
F
F
a
"}
(47,1,1) = {"
a
a
a
a
a
a
a
a
a
a
a
a
b
c
e
e
e
e
e
e
e
e
e
e
e
e
e
e
e
e
e
e
e
e
e
e
e
e
e
e
e
e
e
e
e
e
e
i
S
r
r
r
r
r
D
r
r
q
i
F
F
F
a
a
"}
(48,1,1) = {"
a
a
a
a
a
a
a
a
a
a
a
a
b
c
e
e
e
e
e
e
e
e
e
e
e
e
e
e
e
e
e
e
e
e
e
e
e
e
e
e
e
e
e
e
e
e
e
i
h
r
r
r
r
r
r
r
r
g
i
F
F
a
a
a
"}
(49,1,1) = {"
a
a
a
a
a
a
a
a
a
a
a
a
b
c
e
e
e
e
e
e
e
e
e
e
e
e
e
e
e
e
e
e
e
e
e
e
e
e
e
e
e
e
e
e
e
e
e
d
G
g
q
q
q
q
q
q
g
G
d
F
a
a
a
a
"}
(50,1,1) = {"
a
a
a
a
a
a
a
a
a
a
a
a
b
c
c
c
c
c
c
c
c
c
c
c
c
c
c
c
c
c
c
c
c
c
c
c
c
c
c
c
c
c
c
c
c
c
c
d
d
d
d
d
d
d
d
d
d
d
d
a
a
a
a
a
"}
(51,1,1) = {"
a
a
a
a
a
a
a
a
a
a
a
a
b
b
b
b
b
b
b
b
b
b
b
b
b
b
b
b
b
b
b
b
b
b
b
b
b
b
b
b
b
b
b
b
b
b
b
a
a
a
a
a
a
a
a
a
a
a
a
a
a
a
a
a
"}
(52,1,1) = {"
a
a
a
a
a
a
a
a
a
a
a
a
a
a
a
a
a
a
a
a
a
a
a
a
a
a
a
a
a
a
a
a
a
a
a
a
a
a
a
a
a
a
a
a
a
a
a
a
a
a
a
a
a
a
a
a
a
a
a
a
a
a
a
a
"}
(53,1,1) = {"
a
a
a
a
a
a
a
a
a
a
a
a
a
a
a
a
a
a
a
a
a
a
a
a
a
a
a
a
a
a
a
a
a
a
a
a
a
a
a
a
a
a
a
a
a
a
a
a
a
a
a
a
a
a
a
a
a
a
a
a
a
a
a
a
"}
(54,1,1) = {"
a
a
a
a
a
a
a
a
a
a
a
a
a
a
a
a
a
a
a
a
a
a
a
a
a
a
a
a
a
a
a
a
a
a
a
a
a
a
a
a
a
a
a
a
a
a
a
a
a
a
a
a
a
a
a
a
a
a
a
a
a
a
a
a
"}
(55,1,1) = {"
a
a
a
a
a
a
a
a
a
a
a
a
a
a
a
a
a
a
a
a
a
a
a
a
a
a
a
a
a
a
a
a
a
a
a
a
a
a
a
a
a
a
a
a
a
a
a
a
a
a
a
a
a
a
a
a
a
a
a
a
a
a
a
a
"}
(56,1,1) = {"
a
a
a
a
a
a
a
a
a
a
a
a
a
a
a
a
a
a
a
a
a
a
a
a
a
a
a
a
a
a
a
a
a
a
a
a
a
a
a
a
a
a
a
a
a
a
a
a
a
a
a
a
a
a
a
a
a
a
a
a
a
a
a
a
"}
(57,1,1) = {"
a
a
a
a
a
a
a
a
a
a
a
a
a
a
a
a
a
a
a
a
a
a
a
a
a
a
a
a
a
a
a
a
a
a
a
a
a
a
a
a
a
a
a
a
a
a
a
a
a
a
a
a
a
a
a
a
a
a
a
a
a
a
a
a
"}
(58,1,1) = {"
a
a
a
a
a
a
a
a
a
a
a
a
a
a
a
a
a
a
a
a
a
a
a
a
a
a
a
a
a
a
a
a
a
a
a
a
a
a
a
a
a
a
a
a
a
a
a
a
a
a
a
a
a
a
a
a
a
a
a
a
a
a
a
a
"}
(59,1,1) = {"
a
a
a
a
a
a
a
a
a
a
a
a
a
a
a
a
a
a
a
a
a
a
a
a
a
a
a
a
a
a
a
a
a
a
a
a
a
a
a
a
a
a
a
a
a
a
a
a
a
a
a
a
a
a
a
a
a
a
a
a
a
a
a
a
"}
(60,1,1) = {"
a
a
a
a
a
a
a
a
a
a
a
a
a
a
a
a
a
a
a
a
a
a
a
a
a
a
a
a
a
a
a
a
a
a
a
a
a
a
a
a
a
a
a
a
a
a
a
a
a
a
a
a
a
a
a
a
a
a
a
a
a
a
a
a
"}
(61,1,1) = {"
a
a
a
a
a
a
a
a
a
a
a
a
a
a
a
a
a
a
a
a
a
a
a
a
a
a
a
a
a
a
a
a
a
a
a
a
a
a
a
a
a
a
a
a
a
a
a
a
a
a
a
a
a
a
a
a
a
a
a
a
a
a
a
a
"}
(62,1,1) = {"
a
a
a
a
a
a
a
a
a
a
a
a
a
a
a
a
a
a
a
a
a
a
a
a
a
a
a
a
a
a
a
a
a
a
a
a
a
a
a
a
a
a
a
a
a
a
a
a
a
a
a
a
a
a
a
a
a
a
a
a
a
a
a
a
"}
(63,1,1) = {"
a
a
a
a
a
a
a
a
a
a
a
a
a
a
a
a
a
a
a
a
a
a
a
a
a
a
a
a
a
a
a
a
a
a
a
a
a
a
a
a
a
a
a
a
a
a
a
a
a
a
a
a
a
a
a
a
a
a
a
a
a
a
a
a
"}
(64,1,1) = {"
a
a
a
a
a
a
a
a
a
a
a
a
a
a
a
a
a
a
a
a
a
a
a
a
a
a
a
a
a
a
a
a
a
a
a
a
a
a
a
a
a
a
a
a
a
a
a
a
a
a
a
a
a
a
a
a
a
a
a
a
a
a
a
a
"}
