//MAP CONVERTED BY dmm2tgm.py THIS HEADER COMMENT PREVENTS RECONVERSION, DO NOT REMOVE
"a" = (
/turf/dmm_suite/clear_turf,
/area/dmm_suite/clear_area)
"b" = (
/turf/simulated/wall/cult,
/area/mission/prefab/misc/cult)
"c" = (
/turf/simulated/floor/cult,
/area/mission/prefab/misc/cult)
"d" = (
/obj/structure/interactive/lighting/cult_pylon,
/turf/simulated/floor/cult,
/area/mission/prefab/misc/cult)
"e" = (
/mob/living/simple/cult/construct/behemoth,
/turf/simulated/floor/cult,
/area/mission/prefab/misc/cult)
"f" = (
/obj/marker/map_node,
/turf/simulated/floor/cult,
/area/mission/prefab/misc/cult)
"g" = (
/obj/structure/interactive/crate/chest/filled,
/turf/simulated/floor/cult,
/area/mission/prefab/misc/cult)
"h" = (
/mob/living/advanced/npc/cultist,
/turf/simulated/floor/cult,
/area/mission/prefab/misc/cult)
"i" = (
/mob/living/advanced/npc/cultist{
	dir = 8;
	icon_state = "directional"
	},
/turf/simulated/floor/cult,
/area/mission/prefab/misc/cult)
"j" = (
/mob/living/advanced/npc/cultist{
	dir = 1;
	icon_state = "directional"
	},
/turf/simulated/floor/cult,
/area/mission/prefab/misc/cult)
"k" = (
/obj/structure/interactive/lighting/cult_pylon,
/turf/simulated/floor/cult/darker,
/area/mission/prefab/misc/cult)
"l" = (
/obj/marker/map_node,
/turf/dmm_suite/no_wall,
/area/dmm_suite/clear_area)
"m" = (
/turf/simulated/floor/cult/darker,
/area/mission/prefab/misc/cult)
"n" = (
/mob/living/simple/cult/construct/behemoth,
/turf/simulated/floor/cult/darker,
/area/mission/prefab/misc/cult)
"o" = (
/obj/marker/objective_spawn,
/turf/simulated/floor/cult/darker,
/area/mission/prefab/misc/cult)
"p" = (
/mob/living/simple/cult/construct/artificer,
/turf/simulated/floor/cult,
/area/mission/prefab/misc/cult)
"q" = (
/obj/marker/lobby,
/turf/simulated/floor/cult/darker,
/area/mission/prefab/misc/cult)
"r" = (
/obj/marker/map_node,
/turf/simulated/floor/cult/darker,
/area/mission/prefab/misc/cult)
"s" = (
/turf/simulated/floor/stair/cult{
	dir = 1;
	icon_state = "stair"
	},
/area/mission/prefab/misc/cult)
"t" = (
/mob/living/simple/cult/construct/floating,
/turf/simulated/floor/cult,
/area/mission/prefab/misc/cult)
"u" = (
/obj/marker/map_node,
/turf/simulated/floor/stair/cult,
/area/mission/prefab/misc/cult)
"v" = (
/turf/simulated/floor/stair/cult,
/area/mission/prefab/misc/cult)
"w" = (
/turf/dmm_suite/no_wall,
/area/dmm_suite/clear_area)
"x" = (
/turf/simulated/floor/stair/cult{
	dir = 4;
	icon_state = "stair"
	},
/area/mission/prefab/misc/cult)
"y" = (
/mob/living/advanced/npc/cultist{
	dir = 4;
	icon_state = "directional"
	},
/turf/simulated/floor/cult,
/area/mission/prefab/misc/cult)
"z" = (
/obj/marker/smart_clear_turf,
/turf/dmm_suite/no_wall,
/area/dmm_suite/clear_area)

(1,1,1) = {"
a
a
a
a
a
a
a
a
a
a
a
a
a
a
a
a
a
a
a
a
a
a
a
a
a
a
a
a
a
a
a
a
a
a
a
a
a
a
a
a
a
a
a
a
a
a
a
a
a
a
a
a
a
a
a
a
a
a
a
a
a
a
a
a
"}
(2,1,1) = {"
a
a
a
a
a
a
a
a
a
a
a
a
a
a
a
a
a
a
a
a
a
a
a
a
a
a
a
a
a
a
a
a
a
a
a
a
a
a
a
a
a
a
a
a
a
a
a
a
a
a
a
a
a
a
a
a
a
a
a
a
a
a
a
a
"}
(3,1,1) = {"
a
a
a
a
a
a
a
a
a
a
a
a
a
a
a
a
a
a
a
a
a
a
a
a
a
a
a
a
a
a
a
a
a
a
a
a
a
a
a
a
a
a
a
a
a
a
a
a
a
a
a
a
a
a
a
a
a
a
a
a
a
a
a
a
"}
(4,1,1) = {"
a
a
a
a
a
a
a
a
a
a
a
a
a
a
a
a
a
a
a
a
a
a
a
a
a
a
a
a
a
a
a
a
a
a
a
a
a
a
a
a
a
a
a
a
a
a
a
a
a
a
a
a
a
a
a
a
a
a
a
a
a
a
a
a
"}
(5,1,1) = {"
a
a
a
a
a
a
a
a
a
a
a
a
a
a
a
a
a
a
a
a
a
a
a
a
a
a
a
a
a
a
a
a
a
a
a
a
a
a
a
a
a
a
a
a
a
a
a
a
a
a
a
a
a
a
a
a
a
a
a
a
a
a
a
a
"}
(6,1,1) = {"
a
a
a
a
a
a
a
a
a
a
a
a
a
a
a
a
a
a
a
a
a
a
a
a
a
a
a
a
a
a
a
a
a
a
a
a
a
a
a
a
a
a
a
a
a
a
a
a
a
a
a
a
a
a
a
a
a
a
a
a
a
a
a
a
"}
(7,1,1) = {"
a
a
a
a
a
a
a
a
a
a
a
a
a
a
a
a
a
a
a
a
a
a
a
a
a
a
a
a
a
a
a
a
a
a
a
w
w
w
w
w
w
w
w
w
w
w
w
w
a
a
a
a
a
a
a
a
a
a
a
a
a
a
a
a
"}
(8,1,1) = {"
a
a
a
a
a
a
a
a
a
a
a
a
a
a
a
w
w
w
w
w
w
w
w
w
a
a
a
a
a
a
a
a
a
a
a
l
w
w
w
w
w
w
l
w
w
w
w
w
a
a
a
a
a
a
a
a
a
a
a
a
a
a
a
a
"}
(9,1,1) = {"
a
a
a
a
a
a
a
a
a
a
a
a
a
w
w
w
w
w
w
w
l
w
w
w
w
a
a
a
a
a
a
a
a
a
a
w
w
w
w
w
w
w
w
w
w
w
w
w
a
a
a
a
a
a
a
a
a
a
a
a
a
a
a
a
"}
(10,1,1) = {"
a
a
a
a
a
a
a
a
a
a
a
w
w
w
l
w
w
w
w
w
w
w
w
w
w
w
l
w
w
w
a
a
a
w
w
w
w
w
w
w
w
w
w
w
w
w
w
l
a
a
a
a
a
a
a
a
a
a
a
a
a
a
a
a
"}
(11,1,1) = {"
a
a
a
a
a
a
a
a
a
a
a
w
w
w
w
w
w
w
w
z
w
w
w
w
w
w
w
w
w
w
a
a
a
w
w
w
b
b
b
b
b
b
b
b
b
b
w
w
w
a
a
a
a
a
a
a
a
a
a
a
a
a
a
a
"}
(12,1,1) = {"
a
a
a
a
a
a
a
a
a
a
w
w
w
w
w
b
b
b
b
c
c
c
c
b
b
b
w
w
w
w
w
w
a
w
w
l
b
d
c
c
c
c
c
c
d
b
w
w
w
a
a
a
a
a
a
a
a
a
a
a
a
a
a
a
"}
(13,1,1) = {"
a
a
a
a
a
a
a
a
a
a
w
w
w
w
w
b
d
c
c
c
c
c
c
c
d
b
w
w
w
w
w
w
w
w
w
w
b
c
c
c
c
c
c
c
c
b
w
w
w
a
a
a
a
a
a
a
a
a
a
a
a
a
a
a
"}
(14,1,1) = {"
a
a
a
a
a
a
a
a
a
a
w
w
w
w
w
b
c
c
c
c
f
c
c
c
c
f
w
w
w
w
w
l
w
w
w
z
c
c
c
c
c
c
p
c
c
b
w
w
w
a
a
a
a
a
a
a
a
a
a
a
a
a
a
a
"}
(15,1,1) = {"
a
a
a
a
a
a
a
a
a
a
w
l
w
w
w
c
c
c
c
c
c
c
c
c
c
c
z
w
w
w
w
w
w
w
w
w
f
c
c
e
c
c
f
c
c
b
w
w
w
a
a
a
a
a
a
a
a
a
a
a
a
a
a
a
"}
(16,1,1) = {"
a
a
a
a
a
a
a
a
a
w
w
w
w
w
w
c
c
c
c
c
c
c
c
c
c
b
a
w
w
w
w
w
w
w
w
a
b
c
c
c
c
c
c
c
c
b
w
l
w
a
a
a
a
a
a
a
a
a
a
a
a
a
a
a
"}
(17,1,1) = {"
a
a
a
a
a
a
a
a
a
w
w
w
w
w
z
c
c
c
c
c
c
j
c
c
c
b
a
a
a
a
a
a
a
a
a
a
b
d
c
c
c
c
c
c
d
b
w
w
w
a
a
a
a
a
a
a
a
a
a
a
a
a
a
a
"}
(18,1,1) = {"
a
a
a
a
a
a
a
a
a
w
w
w
w
w
w
f
c
c
f
h
c
c
c
c
c
b
b
b
b
b
b
b
b
b
b
b
b
b
b
b
b
x
x
b
b
b
w
w
w
a
a
a
a
a
a
a
a
a
a
a
a
a
a
a
"}
(19,1,1) = {"
a
a
a
a
a
a
a
a
w
w
l
w
w
w
w
c
c
c
c
c
c
c
c
c
c
b
d
c
c
c
c
c
c
c
c
d
b
k
m
m
m
m
m
m
k
b
w
w
w
l
a
a
a
a
a
a
a
a
a
a
a
a
a
a
"}
(20,1,1) = {"
a
a
a
a
a
a
a
a
w
w
w
w
w
w
w
c
c
c
c
c
c
c
c
c
c
c
c
c
c
c
c
c
c
c
c
c
b
m
m
m
m
m
m
m
m
b
b
b
b
w
a
a
a
a
a
a
a
a
a
a
a
a
a
a
"}
(21,1,1) = {"
a
a
a
a
a
a
a
a
w
w
w
w
w
w
w
c
c
c
c
c
f
c
c
c
c
f
c
c
c
c
f
c
c
f
c
c
u
m
m
m
m
m
m
m
m
b
d
c
c
w
a
a
a
a
a
a
a
a
a
a
a
a
a
a
"}
(22,1,1) = {"
a
a
a
a
a
a
a
a
w
w
w
w
w
w
w
b
c
c
c
c
c
c
c
c
c
b
d
c
c
c
c
c
c
c
c
c
v
m
m
m
m
m
m
m
m
s
c
c
c
z
w
a
a
a
a
a
a
a
a
a
a
a
a
a
"}
(23,1,1) = {"
a
a
a
a
a
a
a
a
w
w
w
w
w
w
w
b
d
c
c
c
c
c
c
c
d
b
b
b
b
b
b
b
g
c
c
c
b
m
m
m
m
m
r
m
m
s
c
c
c
l
w
a
a
a
a
a
a
a
a
a
a
a
a
a
"}
(24,1,1) = {"
a
a
a
a
a
a
a
a
w
w
l
b
b
b
b
b
b
f
c
b
b
b
b
b
b
b
k
m
m
m
k
b
d
c
c
d
b
k
m
m
m
m
m
m
k
b
d
c
c
w
w
a
a
a
a
a
a
a
a
a
a
a
a
a
"}
(25,1,1) = {"
a
a
a
a
a
a
a
a
w
w
w
b
d
c
b
d
c
c
c
c
d
b
k
m
m
m
m
m
m
m
m
b
b
b
b
b
b
b
b
b
b
b
b
b
b
b
b
b
b
w
w
a
w
a
a
a
a
a
a
a
a
a
a
a
"}
(26,1,1) = {"
a
a
a
a
a
a
a
a
a
w
w
b
c
c
b
g
c
c
c
c
c
b
m
m
m
m
m
m
m
m
m
b
d
c
c
c
c
c
c
d
b
d
c
y
c
y
c
d
b
w
w
w
w
a
a
a
a
a
a
a
a
a
a
a
"}
(27,1,1) = {"
a
a
a
a
a
a
a
a
a
w
w
b
c
c
c
c
c
e
c
c
c
b
m
m
m
m
m
m
m
m
m
b
g
c
c
c
c
c
c
c
b
g
c
c
c
c
c
c
b
w
w
w
w
a
a
a
a
a
a
a
a
a
a
a
"}
(28,1,1) = {"
a
a
a
a
a
a
a
a
a
w
w
b
c
f
c
c
c
c
f
c
c
b
m
m
n
m
m
m
m
m
m
b
c
c
c
c
c
c
c
c
b
c
c
c
c
c
c
c
b
w
l
w
w
a
a
a
a
a
a
a
a
a
a
a
"}
(29,1,1) = {"
a
a
a
a
a
a
a
a
a
w
w
b
c
c
b
c
c
c
c
c
c
b
m
m
m
m
m
m
m
m
m
s
c
t
c
c
c
t
c
c
c
c
c
c
c
c
c
c
b
w
w
w
w
a
a
a
a
a
a
a
a
a
a
a
"}
(30,1,1) = {"
a
a
a
a
a
a
a
a
a
w
l
b
c
c
b
d
c
c
c
c
d
b
m
m
m
m
q
m
r
m
m
s
f
c
c
c
c
c
c
c
c
c
c
c
c
c
c
c
b
w
w
w
w
a
a
a
a
a
a
a
a
a
a
a
"}
(31,1,1) = {"
a
a
a
a
a
a
a
a
a
w
w
b
c
c
b
b
b
c
c
c
b
b
m
m
m
m
m
m
m
m
m
s
c
c
c
c
f
c
c
c
f
c
c
c
f
c
c
c
b
w
w
w
w
a
a
a
a
a
a
a
a
a
a
a
"}
(32,1,1) = {"
a
a
a
a
a
a
a
a
a
w
w
b
c
c
d
b
d
c
f
c
d
b
m
m
m
m
m
m
m
m
m
b
c
c
c
c
c
c
c
c
c
c
c
c
c
c
c
c
b
w
w
w
a
a
a
a
a
a
a
a
a
a
a
a
"}
(33,1,1) = {"
a
a
a
a
a
a
a
a
a
w
w
b
c
c
c
b
c
c
c
c
c
b
m
m
m
m
m
m
m
m
m
b
c
c
c
c
c
c
c
c
b
c
c
c
c
c
c
c
b
w
w
w
a
a
a
a
a
a
a
a
a
a
a
a
"}
(34,1,1) = {"
a
a
a
a
a
a
a
a
a
w
w
b
c
c
c
b
c
c
i
c
c
b
m
m
m
m
m
m
n
m
m
b
c
c
c
c
c
c
c
c
b
c
c
c
c
c
c
c
b
w
l
w
a
a
a
a
a
a
a
a
a
a
a
a
"}
(35,1,1) = {"
a
a
a
a
a
a
a
a
a
w
w
b
c
c
c
b
c
c
c
c
c
b
m
m
o
m
m
m
m
m
m
b
c
c
c
c
c
c
c
c
b
c
c
c
f
c
c
c
b
w
w
a
a
a
a
a
a
a
a
a
a
a
a
a
"}
(36,1,1) = {"
a
a
a
a
a
a
a
a
a
w
l
c
c
f
c
b
c
c
c
c
c
b
k
m
m
m
m
m
m
m
k
b
c
c
c
c
f
c
c
c
b
c
c
c
c
c
c
c
b
w
w
a
a
a
a
a
a
a
a
a
a
a
a
a
"}
(37,1,1) = {"
a
a
a
a
a
a
a
a
a
w
w
c
c
c
c
b
c
c
c
c
c
b
b
b
b
b
b
b
b
b
b
b
c
c
c
c
c
c
c
c
b
d
c
c
c
c
c
d
b
w
w
w
a
a
a
a
a
a
a
a
a
a
a
a
"}
(38,1,1) = {"
a
a
a
a
a
a
a
a
a
w
w
c
c
c
c
b
c
c
c
c
c
c
c
c
c
c
c
c
d
b
d
c
c
c
c
c
c
c
c
c
b
b
b
c
c
c
b
b
b
w
w
a
a
a
a
a
a
a
a
a
a
a
a
a
"}
(39,1,1) = {"
a
a
a
a
a
a
a
a
a
w
w
c
c
c
c
b
c
c
f
c
c
i
c
f
c
c
c
c
c
c
c
c
c
f
c
c
c
t
c
c
b
w
w
w
l
z
w
w
w
w
l
a
a
a
a
a
a
a
a
a
a
a
a
a
"}
(40,1,1) = {"
a
a
a
a
a
a
a
a
a
w
z
c
e
c
c
b
c
c
i
c
c
c
c
c
p
c
c
f
c
c
c
c
c
c
c
c
c
c
c
c
b
w
w
w
w
w
w
w
w
w
w
w
a
a
a
a
a
a
a
a
a
a
a
a
"}
(41,1,1) = {"
a
a
a
a
a
a
a
a
w
w
w
c
c
c
c
b
d
c
c
c
c
c
c
c
c
c
c
c
d
b
d
c
c
c
c
c
c
c
c
d
b
w
w
w
w
w
w
l
w
w
w
a
a
a
a
a
a
a
a
a
a
a
a
a
"}
(42,1,1) = {"
a
a
a
a
a
a
a
a
w
w
l
c
c
f
c
b
b
b
b
b
b
b
b
b
b
b
b
b
b
b
b
b
b
b
b
b
b
b
b
b
b
w
w
w
w
w
w
w
w
w
w
a
a
a
a
a
a
a
a
a
a
a
a
a
"}
(43,1,1) = {"
a
a
a
a
a
a
a
a
w
w
w
c
c
c
c
b
d
c
c
c
c
c
d
b
d
c
c
c
c
c
c
c
c
c
d
b
d
c
c
c
c
w
w
w
w
w
w
w
w
w
a
a
a
a
a
a
a
a
a
a
a
a
a
a
"}
(44,1,1) = {"
a
a
a
a
a
a
a
a
w
w
w
c
c
c
c
b
c
h
c
c
c
c
c
b
c
c
c
c
c
c
c
c
c
c
c
b
c
c
c
c
c
w
w
w
w
w
w
w
w
w
a
a
a
a
a
a
a
a
a
a
a
a
a
a
"}
(45,1,1) = {"
a
a
a
a
a
a
a
a
w
w
w
b
c
c
c
c
c
c
c
c
h
c
f
c
c
c
c
c
f
c
c
c
c
c
f
c
c
c
f
c
c
l
w
w
l
w
w
w
w
w
a
a
a
a
a
a
a
a
a
a
a
a
a
a
"}
(46,1,1) = {"
a
a
a
a
a
a
a
a
w
w
w
b
c
f
c
c
c
c
c
f
c
c
c
b
c
c
c
c
c
c
c
c
c
c
c
b
c
c
c
c
c
w
w
w
w
w
w
w
w
w
a
a
a
a
a
a
a
a
a
a
a
a
a
a
"}
(47,1,1) = {"
a
a
a
a
a
a
a
a
a
w
w
b
c
c
c
c
c
c
c
c
c
c
c
b
g
c
c
c
c
c
c
c
c
c
c
b
d
c
c
c
c
z
w
w
w
w
w
w
w
a
a
a
a
a
a
a
a
a
a
a
a
a
a
a
"}
(48,1,1) = {"
a
a
a
a
a
a
a
a
a
a
w
b
c
f
c
b
c
c
c
h
c
c
c
b
d
c
i
c
c
c
c
i
c
c
d
b
b
b
b
b
b
w
w
w
w
w
w
w
a
a
a
a
a
a
a
a
a
a
a
a
a
a
a
a
"}
(49,1,1) = {"
a
a
a
a
a
a
a
a
a
a
a
b
c
c
c
b
d
c
c
c
c
c
d
b
b
b
b
b
b
b
b
b
b
b
b
b
w
w
w
w
w
w
w
w
w
a
a
a
a
a
a
a
a
a
a
a
a
a
a
a
a
a
a
a
"}
(50,1,1) = {"
a
a
a
a
a
a
a
a
a
a
a
b
c
c
c
b
b
b
b
b
b
b
b
b
w
w
w
w
w
w
l
w
w
w
w
l
w
w
w
w
w
l
w
w
w
a
a
a
a
a
a
a
a
a
a
a
a
a
a
a
a
a
a
a
"}
(51,1,1) = {"
a
a
a
a
a
a
a
a
a
a
a
b
c
c
c
b
w
w
w
w
w
w
w
w
w
l
w
w
w
w
w
w
w
w
w
w
w
w
w
w
w
w
w
w
a
a
a
a
a
a
a
a
a
a
a
a
a
a
a
a
a
a
a
a
"}
(52,1,1) = {"
a
a
a
a
a
a
a
a
a
a
a
b
c
f
c
c
w
w
w
l
w
w
w
w
w
w
w
w
w
w
w
w
w
w
w
w
w
w
w
a
a
a
a
a
a
a
a
a
a
a
a
a
a
a
a
a
a
a
a
a
a
a
a
a
"}
(53,1,1) = {"
a
a
a
a
a
a
a
a
a
a
a
b
c
c
c
c
z
w
w
w
w
w
w
w
a
a
a
a
a
a
a
a
a
a
a
a
a
a
a
a
a
a
a
a
a
a
a
a
a
a
a
a
a
a
a
a
a
a
a
a
a
a
a
a
"}
(54,1,1) = {"
a
a
a
a
a
a
a
a
a
a
a
b
d
c
c
b
a
a
a
a
a
a
a
a
a
a
a
a
a
a
a
a
a
a
a
a
a
a
a
a
a
a
a
a
a
a
a
a
a
a
a
a
a
a
a
a
a
a
a
a
a
a
a
a
"}
(55,1,1) = {"
a
a
a
a
a
a
a
a
a
a
a
b
b
b
b
b
a
a
a
a
a
a
a
a
a
a
a
a
a
a
a
a
a
a
a
a
a
a
a
a
a
a
a
a
a
a
a
a
a
a
a
a
a
a
a
a
a
a
a
a
a
a
a
a
"}
(56,1,1) = {"
a
a
a
a
a
a
a
a
a
a
a
a
a
a
a
a
a
a
a
a
a
a
a
a
a
a
a
a
a
a
a
a
a
a
a
a
a
a
a
a
a
a
a
a
a
a
a
a
a
a
a
a
a
a
a
a
a
a
a
a
a
a
a
a
"}
(57,1,1) = {"
a
a
a
a
a
a
a
a
a
a
a
a
a
a
a
a
a
a
a
a
a
a
a
a
a
a
a
a
a
a
a
a
a
a
a
a
a
a
a
a
a
a
a
a
a
a
a
a
a
a
a
a
a
a
a
a
a
a
a
a
a
a
a
a
"}
(58,1,1) = {"
a
a
a
a
a
a
a
a
a
a
a
a
a
a
a
a
a
a
a
a
a
a
a
a
a
a
a
a
a
a
a
a
a
a
a
a
a
a
a
a
a
a
a
a
a
a
a
a
a
a
a
a
a
a
a
a
a
a
a
a
a
a
a
a
"}
(59,1,1) = {"
a
a
a
a
a
a
a
a
a
a
a
a
a
a
a
a
a
a
a
a
a
a
a
a
a
a
a
a
a
a
a
a
a
a
a
a
a
a
a
a
a
a
a
a
a
a
a
a
a
a
a
a
a
a
a
a
a
a
a
a
a
a
a
a
"}
(60,1,1) = {"
a
a
a
a
a
a
a
a
a
a
a
a
a
a
a
a
a
a
a
a
a
a
a
a
a
a
a
a
a
a
a
a
a
a
a
a
a
a
a
a
a
a
a
a
a
a
a
a
a
a
a
a
a
a
a
a
a
a
a
a
a
a
a
a
"}
(61,1,1) = {"
a
a
a
a
a
a
a
a
a
a
a
a
a
a
a
a
a
a
a
a
a
a
a
a
a
a
a
a
a
a
a
a
a
a
a
a
a
a
a
a
a
a
a
a
a
a
a
a
a
a
a
a
a
a
a
a
a
a
a
a
a
a
a
a
"}
(62,1,1) = {"
a
a
a
a
a
a
a
a
a
a
a
a
a
a
a
a
a
a
a
a
a
a
a
a
a
a
a
a
a
a
a
a
a
a
a
a
a
a
a
a
a
a
a
a
a
a
a
a
a
a
a
a
a
a
a
a
a
a
a
a
a
a
a
a
"}
(63,1,1) = {"
a
a
a
a
a
a
a
a
a
a
a
a
a
a
a
a
a
a
a
a
a
a
a
a
a
a
a
a
a
a
a
a
a
a
a
a
a
a
a
a
a
a
a
a
a
a
a
a
a
a
a
a
a
a
a
a
a
a
a
a
a
a
a
a
"}
(64,1,1) = {"
a
a
a
a
a
a
a
a
a
a
a
a
a
a
a
a
a
a
a
a
a
a
a
a
a
a
a
a
a
a
a
a
a
a
a
a
a
a
a
a
a
a
a
a
a
a
a
a
a
a
a
a
a
a
a
a
a
a
a
a
a
a
a
a
"}
