"aa" = (/turf/dmm_suite/clear_turf,/area/dmm_suite/clear_area)
"ab" = (/turf/simulated/wall/metal/reinforced,/area/dmm_suite/clear_area)
"ac" = (/turf/simulated/floor/plating,/area/dmm_suite/clear_area)
"ad" = (/obj/structure/interactive/crate/closet,/turf/simulated/floor/plating,/area/ghost/maint/central)
"ae" = (/obj/structure/interactive/crate/trash,/turf/simulated/floor/plating,/area/ghost/maint/north)
"af" = (/obj/structure/interactive/door/airlock/glass,/turf/simulated/floor/tile/grey,/area/ghost/maint/north)
"ag" = (/turf/simulated/wall/metal,/area/ghost/engineering)
"ah" = (/obj/structure/interactive/misc/toilet,/obj/structure/interactive/lighting/fixture/bulb{icon_state = "preview"; dir = 8},/turf/simulated/floor/tile/tint,/area/ghost/bathrooms/male)
"ai" = (/obj/marker/map_node,/turf/simulated/floor/tile/grey,/area/ghost/hall/entrance)
"aj" = (/obj/marker/map_node,/turf/simulated/floor/plating,/area/dmm_suite/clear_area)
"ak" = (/obj/structure/interactive/misc/urinal{pixel_y = 32},/turf/simulated/floor/tile/tint,/area/ghost/bathrooms/male)
"al" = (/obj/marker/spawning/window,/turf/simulated/floor/plating,/area/ghost/engineering)
"am" = (/turf/simulated/floor/tile,/area/ghost/medical)
"an" = (/obj/structure/interactive/fire_closet,/turf/simulated/wall/metal,/area/ghost/science)
"ao" = (/turf/simulated/floor/tile/grey,/area/ghost/hall/entrance)
"ap" = (/obj/structure/interactive/door/airlock/lz_420/basement/bathroom,/turf/simulated/floor/tile/tint,/area/ghost/bathrooms/male)
"aq" = (/obj/structure/interactive/lighting/fixture/tube,/turf/simulated/floor/tile/grey,/area/ghost/hall/entrance)
"ar" = (/turf/simulated/floor/tile/tint,/area/ghost/bathrooms/male)
"as" = (/obj/structure/interactive/lighting/fixture/bulb{icon_state = "preview"; dir = 8},/obj/structure/interactive/misc/sink{icon_state = "sink"; dir = 4},/turf/simulated/floor/tile/tint,/area/ghost/bathrooms/male)
"at" = (/obj/structure/interactive/barricade{icon_state = "metal"; dir = 4},/turf/simulated/floor/tile/grey,/area/ghost/hall/entrance)
"au" = (/obj/marker/map_node,/turf/simulated/floor/tile/grey,/area/ghost/hall/north)
"av" = (/obj/structure/interactive/chair{dir = 8; icon_state = "chair"},/turf/simulated/floor/tile,/area/ghost/medical)
"aw" = (/turf/simulated/floor/tile/morphing/medical,/area/ghost/medical)
"ax" = (/obj/structure/interactive/fire_closet{icon_state = "extinguisher"; dir = 8},/turf/simulated/wall/metal,/area/ghost/science)
"ay" = (/turf/simulated/wall/metal/reinforced,/area/ghost/command)
"az" = (/turf/simulated/wall/metal,/area/ghost/cafe)
"aA" = (/obj/structure/interactive/door/airlock/glass,/turf/simulated/floor/tile/grey,/area/ghost/cafe)
"aB" = (/obj/structure/interactive/door/airlock/glass,/turf/simulated/floor/tile,/area/ghost/medical)
"aC" = (/obj/structure/interactive/bed/sleeper/medical,/turf/simulated/floor/tile,/area/ghost/medical)
"aD" = (/turf/simulated/wall/metal,/area/ghost/science)
"aE" = (/obj/structure/interactive/crate/trash,/turf/simulated/floor/tile/morphing/science,/area/ghost/science)
"aF" = (/turf/simulated/wall/metal,/area/ghost/command)
"aG" = (/obj/marker/map_node,/turf/simulated/floor/tile/grey,/area/ghost/hall/west)
"aH" = (/obj/structure/interactive/misc/computer3,/turf/simulated/floor/tile/morphing/command,/area/ghost/command)
"aI" = (/obj/marker/map_node,/turf/simulated/floor/tile/grey,/area/ghost/command)
"aJ" = (/obj/structure/interactive/crate/open,/turf/simulated/floor/plating,/area/ghost/maint/central)
"aK" = (/turf/simulated/wall/metal,/area/ghost/bathrooms/male)
"aL" = (/obj/structure/interactive/misc/computer4,/turf/simulated/floor/tile/morphing/command,/area/ghost/command)
"aM" = (/obj/structure/interactive/lighting/fixture/tube,/turf/simulated/floor/tile/morphing/science,/area/ghost/science)
"aN" = (/obj/structure/interactive/misc/sink{icon_state = "sink"; dir = 4},/turf/simulated/floor/tile/tint,/area/ghost/bathrooms/male)
"aO" = (/obj/structure/interactive/chair{icon_state = "chair"; dir = 1},/turf/simulated/floor/tile/grey,/area/ghost/science)
"aP" = (/turf/simulated/wall/metal/reinforced,/area/ghost/maint/north)
"aQ" = (/turf/simulated/wall/metal/reinforced,/area/ghost/maint/west)
"aR" = (/turf/simulated/wall/metal/reinforced,/area/ghost/maint/east)
"aS" = (/turf/simulated/floor/tile/grey,/area/ghost/hall/north)
"aT" = (/obj/structure/interactive/lighting/fixture/tube{dir = 8},/turf/simulated/floor/tile/grey,/area/ghost/hall/north)
"aU" = (/obj/structure/interactive/lighting/fixture/tube,/turf/simulated/floor/tile/grey,/area/ghost/hall/north)
"aV" = (/obj/structure/interactive/lighting/fixture/tube{dir = 1},/turf/simulated/floor/tile/grey,/area/ghost/hall/north)
"aW" = (/turf/simulated/floor/tile/grey,/area/ghost/hall/west)
"aX" = (/obj/structure/interactive/lighting/fixture/tube{dir = 4},/turf/simulated/floor/tile/grey,/area/ghost/hall/east)
"aY" = (/turf/simulated/floor/tile/grey,/area/ghost/hall/east)
"aZ" = (/obj/structure/interactive/lighting/fixture/tube{dir = 8},/turf/simulated/floor/tile/grey,/area/ghost/hall/west)
"ba" = (/turf/simulated/floor/tile/morphing/command,/area/ghost/hall/west)
"bb" = (/turf/simulated/floor/tile/morphing/science,/area/ghost/hall/east)
"bc" = (/turf/simulated/floor/tile/grey,/area/ghost/hall/south)
"bd" = (/obj/structure/interactive/lighting/fixture/tube,/turf/simulated/floor/tile/grey,/area/ghost/hall/south)
"be" = (/obj/structure/interactive/lighting/fixture/tube{dir = 8},/turf/simulated/floor/tile/morphing/science,/area/ghost/hall/east)
"bf" = (/obj/structure/interactive/lighting/fixture/tube{dir = 1},/turf/simulated/floor/tile/grey,/area/ghost/hall/west)
"bg" = (/obj/structure/scenery/fake_door/nocolide/blast_door{icon_state = "blast_opened"; dir = 4},/turf/simulated/floor/tile/grey,/area/ghost/hall/entrance)
"bh" = (/obj/marker/spawning/window/reinforced,/turf/simulated/floor/plating,/area/ghost/hall/entrance)
"bi" = (/obj/structure/interactive/door/airlock/lz_420/basement/glass,/turf/simulated/floor/tile/grey,/area/ghost/hall/entrance)
"bj" = (/obj/structure/interactive/lighting/fixture/tube{dir = 1},/turf/simulated/floor/tile/grey,/area/ghost/hall/entrance)
"bk" = (/turf/simulated/floor/plating,/area/ghost/maint/north)
"bl" = (/obj/structure/interactive/door/airlock/lz_420/maintenance,/turf/simulated/floor/plating,/area/ghost/maint/north)
"bm" = (/obj/structure/interactive/door/airlock/lz_420/maintenance,/turf/simulated/floor/plating,/area/ghost/maint/east)
"bn" = (/turf/simulated/floor/plating,/area/ghost/maint/east)
"bo" = (/turf/simulated/wall/metal,/area/ghost/maint/north)
"bp" = (/obj/structure/interactive/fire_alarm{icon_state = "fire_alarm"; dir = 4},/turf/simulated/wall/metal,/area/ghost/maint/north)
"bq" = (/turf/simulated/wall/metal,/area/ghost/maint/east)
"br" = (/obj/structure/interactive/fire_closet{icon_state = "extinguisher"; dir = 1},/turf/simulated/wall/metal,/area/ghost/science)
"bs" = (/obj/structure/interactive/fire_closet,/turf/simulated/wall/metal,/area/ghost/maint/north)
"bt" = (/obj/structure/interactive/fire_alarm,/turf/simulated/wall/metal,/area/ghost/maint/north)
"bu" = (/obj/structure/interactive/misc/computer1,/turf/simulated/floor/tile/morphing/command,/area/ghost/command)
"bv" = (/obj/structure/interactive/crate/closet,/turf/simulated/floor/tile/morphing/command,/area/ghost/command)
"bw" = (/obj/structure/interactive/lighting/fixture/tube,/turf/simulated/floor/tile/morphing/command,/area/ghost/command)
"bx" = (/obj/structure/interactive/chair,/turf/simulated/floor/tile/grey,/area/ghost/command)
"by" = (/obj/structure/interactive/crate/closet,/turf/simulated/floor/plating,/area/ghost/maint/east)
"bz" = (/obj/structure/interactive/construction/grille,/turf/simulated/floor/plating,/area/ghost/maint/east)
"bA" = (/obj/structure/interactive/crate/open,/turf/simulated/floor/plating,/area/ghost/maint/east)
"bB" = (/obj/structure/interactive/chair,/turf/simulated/floor/tile/morphing/command,/area/ghost/command)
"bC" = (/obj/structure/interactive/door/airlock/lz_420/maintenance,/turf/simulated/floor/plating,/area/ghost/maint/west)
"bD" = (/turf/simulated/wall/metal,/area/ghost/maint/west)
"bE" = (/turf/simulated/floor/plating,/area/ghost/maint/west)
"bF" = (/obj/structure/interactive/fire_closet,/turf/simulated/wall/metal,/area/ghost/maint/west)
"bG" = (/turf/simulated/wall/metal/reinforced,/area/ghost/maint/south)
"bH" = (/obj/structure/interactive/door/airlock/lz_420/maintenance,/turf/simulated/floor/plating,/area/ghost/maint/south)
"bI" = (/turf/simulated/wall/metal,/area/ghost/maint/south)
"bJ" = (/turf/simulated/floor/plating,/area/ghost/maint/south)
"bK" = (/obj/structure/interactive/crate/closet,/turf/simulated/floor/plating,/area/ghost/maint/south)
"bL" = (/obj/structure/interactive/construction/grille,/turf/simulated/floor/plating,/area/ghost/maint/south)
"bM" = (/turf/simulated/wall/metal/reinforced,/area/ghost/engineering)
"bN" = (/obj/structure/interactive/fire_alarm{icon_state = "fire_alarm"; dir = 8},/turf/simulated/wall/metal,/area/ghost/maint/central)
"bO" = (/obj/structure/interactive/door/airlock/lz_420/maintenance,/turf/simulated/floor/plating,/area/ghost/maint/central)
"bP" = (/turf/simulated/wall/metal,/area/ghost/maint/central)
"bQ" = (/obj/marker/map_node,/turf/simulated/floor/plating,/area/ghost/maint/central)
"bR" = (/obj/structure/interactive/fire_alarm,/turf/simulated/wall/metal,/area/ghost/maint/central)
"bS" = (/obj/structure/interactive/fire_closet,/turf/simulated/wall/metal,/area/ghost/maint/central)
"bT" = (/obj/structure/interactive/crate/trash,/turf/simulated/floor/plating,/area/ghost/maint/central)
"bU" = (/turf/simulated/floor/plating,/area/ghost/maint/central)
"bV" = (/obj/structure/interactive/chair{dir = 4; icon_state = "chair"},/turf/simulated/floor/plating,/area/ghost/maint/central)
"bW" = (/obj/structure/interactive/fire_closet{icon_state = "extinguisher"; dir = 8},/turf/simulated/wall/metal,/area/ghost/maint/central)
"bX" = (/turf/simulated/wall/metal,/area/ghost/medical)
"bY" = (/obj/structure/interactive/fire_alarm,/turf/simulated/wall/metal,/area/ghost/medical)
"bZ" = (/obj/structure/interactive/chair{dir = 8; icon_state = "chair"},/obj/marker/map_node,/turf/simulated/floor/plating,/area/ghost/maint/central)
"ca" = (/obj/structure/interactive/door/airlock/lz_420/maintenance,/turf/simulated/floor/plating,/area/ghost/medical)
"cb" = (/obj/marker/spawning/window,/turf/simulated/floor/plating,/area/ghost/medical)
"cc" = (/obj/structure/interactive/crate/trash,/turf/simulated/floor/tile/morphing/medical,/area/ghost/medical)
"cd" = (/obj/structure/interactive/crate/trash,/turf/simulated/floor/tile/red,/area/ghost/cafe)
"ce" = (/obj/marker/map_node,/turf/simulated/floor/tile/grey,/area/ghost/hall/south)
"cf" = (/obj/marker/map_node,/turf/simulated/floor/tile/dark,/area/ghost/engineering)
"cg" = (/obj/structure/interactive/chair{dir = 4; icon_state = "chair"},/turf/simulated/floor/tile/tint,/area/ghost/cafe)
"ch" = (/turf/simulated/floor/tile/red,/area/ghost/cafe)
"ci" = (/obj/structure/interactive/chair,/obj/marker/map_node,/turf/simulated/floor/tile/dark,/area/ghost/engineering)
"cj" = (/obj/structure/interactive/lighting/fixture/tube{dir = 4},/obj/structure/interactive/vending/coffee,/turf/simulated/floor/tile/tint,/area/ghost/cafe)
"ck" = (/obj/marker/map_node,/turf/simulated/floor/tile/grey,/area/ghost/hall/east)
"cl" = (/obj/structure/interactive/chair{dir = 4; icon_state = "chair"},/turf/simulated/floor/tile/red,/area/ghost/cafe)
"cm" = (/obj/structure/interactive/lighting/fixture/tube{dir = 8},/turf/simulated/floor/tile/tint,/area/ghost/cafe)
"cn" = (/turf/simulated/floor/tile/tint,/area/ghost/bathrooms/female)
"co" = (/turf/simulated/floor/tile/morphing/blue,/area/ghost/bathrooms/male)
"cp" = (/obj/structure/interactive/door/airlock/lz_420/basement/bathroom,/turf/simulated/floor/tile/tint,/area/ghost/bathrooms/female)
"cq" = (/obj/structure/interactive/fire_closet{dir = 4},/turf/simulated/wall/metal,/area/ghost/bathrooms/male)
"cr" = (/obj/structure/interactive/fire_alarm{icon_state = "fire_alarm"; dir = 4},/turf/simulated/wall/metal,/area/ghost/bathrooms/male)
"cs" = (/turf/simulated/wall/metal,/area/ghost/bathrooms/female)
"ct" = (/obj/structure/interactive/misc/toilet{icon_state = "toilet"; dir = 1},/obj/structure/interactive/lighting/fixture/bulb{icon_state = "preview"; dir = 8},/turf/simulated/floor/tile/tint,/area/ghost/bathrooms/female)
"cu" = (/turf/simulated/floor/tile/morphing/science,/area/ghost/science)
"cv" = (/obj/marker/map_node,/turf/simulated/floor/tile/morphing/science,/area/ghost/hall/east)
"cw" = (/obj/structure/interactive/chair{dir = 8; icon_state = "chair"},/turf/simulated/floor/tile/morphing/science,/area/ghost/science)
"cx" = (/obj/structure/interactive/lighting/fixture/tube{dir = 1},/turf/simulated/floor/tile/morphing/science,/area/ghost/science)
"cy" = (/obj/structure/interactive/crate/open,/turf/simulated/floor/tile/morphing/command,/area/ghost/command)
"cz" = (/obj/marker/map_node,/turf/simulated/floor/tile/grey,/area/ghost/science)
"cA" = (/obj/marker/spawning/window,/turf/simulated/floor/plating,/area/ghost/cafe)
"cB" = (/obj/structure/interactive/vending/junk/full,/turf/simulated/floor/tile/red,/area/ghost/cafe)
"cC" = (/obj/structure/interactive/chair,/turf/simulated/floor/tile,/area/ghost/medical)
"cD" = (/obj/structure/interactive/vending/soda/full,/turf/simulated/floor/tile/tint,/area/ghost/cafe)
"cE" = (/turf/simulated/floor/tile/tint,/area/ghost/cafe)
"cF" = (/obj/structure/interactive/fire_alarm{icon_state = "fire_alarm"; dir = 4},/turf/simulated/wall/metal,/area/ghost/cafe)
"cG" = (/turf/simulated/floor/tile/morphing/medical,/area/ghost/hall/north)
"cH" = (/obj/structure/interactive/door/airlock/glass,/turf/simulated/floor/tile/dark,/area/ghost/engineering)
"cI" = (/obj/structure/interactive/fire_closet{dir = 4},/turf/simulated/wall/metal,/area/ghost/cafe)
"cJ" = (/obj/structure/interactive/door/airlock/lz_420/maintenance,/turf/simulated/floor/plating,/area/ghost/cafe)
"cK" = (/obj/structure/interactive/crate/trash,/turf/simulated/floor/tile/morphing/engineering,/area/ghost/engineering)
"cL" = (/turf/simulated/floor/tile/dark,/area/ghost/engineering)
"cM" = (/obj/structure/interactive/fire_alarm{icon_state = "fire_alarm"; dir = 8},/turf/simulated/wall/metal,/area/ghost/command)
"cN" = (/obj/structure/interactive/chair{dir = 8; icon_state = "chair"},/turf/simulated/floor/tile/grey,/area/ghost/command)
"cO" = (/obj/structure/interactive/fire_alarm{icon_state = "fire_alarm"; dir = 8},/turf/simulated/wall/metal,/area/ghost/science)
"cP" = (/turf/simulated/floor/tile/morphing/command,/area/ghost/command)
"cQ" = (/turf/simulated/floor/tile/grey,/area/ghost/science)
"cR" = (/obj/marker/spawning/window,/turf/simulated/floor/plating,/area/ghost/science)
"cS" = (/turf/simulated/floor/tile/grey,/area/ghost/command)
"cT" = (/obj/marker/spawning/window,/turf/simulated/floor/plating,/area/ghost/command)
"cU" = (/obj/structure/interactive/lighting/fixture/tube{dir = 4},/turf/simulated/floor/tile/morphing/command,/area/ghost/command)
"cV" = (/obj/structure/interactive/lighting/fixture/tube{dir = 1},/turf/simulated/floor/tile/morphing/command,/area/ghost/command)
"cW" = (/obj/structure/interactive/crate/trash,/turf/simulated/floor/tile/morphing/command,/area/ghost/command)
"cX" = (/obj/structure/interactive/door/airlock/glass,/turf/simulated/floor/tile/grey,/area/ghost/science)
"cY" = (/obj/structure/interactive/fire_closet{dir = 4},/turf/simulated/wall/metal/reinforced,/area/ghost/command)
"cZ" = (/obj/structure/interactive/fire_alarm,/turf/simulated/wall/metal,/area/ghost/science)
"da" = (/obj/structure/interactive/lighting/fixture/tube{dir = 8},/turf/simulated/floor/tile/morphing/command,/area/ghost/command)
"db" = (/obj/structure/interactive/chair{dir = 4; icon_state = "chair"},/turf/simulated/floor/tile/morphing/command,/area/ghost/command)
"dc" = (/obj/marker/map_node,/turf/simulated/floor/tile/morphing/blue,/area/ghost/bathrooms/male)
"dd" = (/obj/structure/interactive/door/airlock/lz_420/maintenance,/turf/simulated/floor/plating,/area/ghost/science)
"de" = (/obj/structure/interactive/door/airlock/glass,/turf/simulated/floor/tile/grey,/area/ghost/command)
"df" = (/obj/marker/map_node,/turf/simulated/floor/tile/morphing/red,/area/ghost/bathrooms/female)
"dg" = (/obj/structure/interactive/fire_alarm,/turf/simulated/wall/metal,/area/ghost/command)
"dh" = (/obj/structure/interactive/chair{dir = 8; icon_state = "chair"},/turf/simulated/floor/tile/morphing/command,/area/ghost/command)
"di" = (/obj/marker/map_node,/turf/simulated/floor/tile/morphing/medical,/area/ghost/hall/north)
"dj" = (/obj/marker/map_node,/turf/simulated/floor/plating,/area/ghost/maint/north)
"dk" = (/obj/structure/interactive/door/airlock/lz_420/maintenance,/turf/simulated/floor/plating,/area/ghost/command)
"dl" = (/obj/structure/interactive/lighting/fixture/tube{dir = 8},/turf/simulated/floor/tile/morphing/engineering,/area/ghost/engineering)
"dm" = (/obj/structure/interactive/chair,/turf/simulated/floor/tile/dark,/area/ghost/engineering)
"dn" = (/obj/structure/interactive/door/airlock/lz_420/maintenance,/turf/simulated/floor/plating,/area/ghost/engineering)
"do" = (/obj/structure/interactive/chair{dir = 8; icon_state = "chair"},/turf/simulated/floor/tile/dark,/area/ghost/engineering)
"dp" = (/turf/simulated/floor/tile/morphing/engineering,/area/ghost/engineering)
"dq" = (/obj/structure/interactive/lighting/fixture/tube{dir = 1},/turf/simulated/floor/tile/morphing/engineering,/area/ghost/engineering)
"dr" = (/obj/structure/interactive/chair{dir = 4; icon_state = "chair"},/turf/simulated/floor/tile/morphing/engineering,/area/ghost/hall/south)
"ds" = (/turf/simulated/floor/tile/morphing/dark,/area/ghost/hall/entrance)
"dt" = (/obj/structure/interactive/lighting/fixture/tube,/turf/simulated/floor/tile/morphing/dark,/area/ghost/hall/entrance)
"du" = (/obj/structure/interactive/barricade{icon_state = "metal"; dir = 4},/turf/simulated/floor/tile/morphing/dark,/area/ghost/hall/entrance)
"dv" = (/obj/structure/interactive/lighting/fixture/tube{dir = 1},/turf/simulated/floor/tile/morphing/dark,/area/ghost/hall/entrance)
"dw" = (/obj/structure/interactive/door/airlock/lz_420/basement/bathroom,/turf/simulated/floor/tile/morphing/blue,/area/ghost/bathrooms/male)
"dx" = (/turf/simulated/floor/tile/morphing/red,/area/ghost/bathrooms/female)
"dy" = (/obj/structure/interactive/misc/sink{pixel_y = 32},/turf/simulated/floor/tile/morphing/red,/area/ghost/bathrooms/female)
"dz" = (/obj/structure/interactive/door/airlock/lz_420/basement/bathroom,/turf/simulated/floor/tile/morphing/red,/area/ghost/bathrooms/female)
"dA" = (/obj/structure/sign/restroom/female{icon_state = "female"; dir = 4},/turf/simulated/wall/metal,/area/ghost/bathrooms/female)
"dB" = (/obj/structure/sign/restroom/male{icon_state = "male"; dir = 4},/turf/simulated/wall/metal,/area/ghost/bathrooms/male)
"dC" = (/turf/simulated/floor/tile/morphing/engineering,/area/ghost/hall/south)
"dD" = (/obj/structure/interactive/lighting/fixture/tube{dir = 1},/turf/simulated/floor/tile/morphing/engineering,/area/ghost/hall/south)
"dE" = (/obj/structure/interactive/bed/sleeper/medical,/turf/simulated/floor/tile/morphing/medical,/area/ghost/medical)
"dF" = (/obj/structure/interactive/door/airlock/glass,/turf/simulated/floor/tile/morphing/medical,/area/ghost/medical)
"dG" = (/obj/structure/interactive/lighting/fixture/tube{dir = 8},/turf/simulated/floor/tile/morphing/medical,/area/ghost/medical)
"dH" = (/turf/simulated/floor/tile/morphing/medical,/area/ghost/hall/east)
"dI" = (/obj/structure/interactive/chair,/turf/simulated/floor/tile/morphing/medical,/area/ghost/medical)
"dJ" = (/obj/structure/interactive/lighting/fixture/tube{dir = 1},/turf/simulated/floor/tile/morphing/medical,/area/ghost/medical)
"dK" = (/obj/structure/interactive/door/airlock/glass,/turf/simulated/floor/tile/morphing/science,/area/ghost/science)
"dL" = (/obj/structure/interactive/door/airlock/glass,/turf/simulated/floor/tile/morphing/command,/area/ghost/command)
"dM" = (/obj/structure/interactive/door/airlock/glass,/turf/simulated/floor/tile/morphing/engineering,/area/ghost/engineering)
"dN" = (/obj/structure/scenery/fake_door/nocolide/blast_door{icon_state = "blast_opened"; dir = 4},/turf/simulated/floor/tile/morphing/dark,/area/ghost/hall/entrance)
"dO" = (/mob/living/simple/ghost,/turf/simulated/floor/tile/grey,/area/ghost/hall/west)
"dP" = (/obj/structure/interactive/vending/science/equipment,/turf/simulated/floor/tile/morphing/dark,/area/ghost/hall/entrance)
"dQ" = (/obj/structure/interactive/fire_closet{dir = 4},/turf/simulated/wall/metal/reinforced,/area/ghost/engineering)
"dR" = (/obj/marker/objective_spawn,/turf/simulated/floor/tile/morphing/science,/area/ghost/science)
"dS" = (/obj/marker/map_node,/turf/simulated/floor/tile/tint,/area/ghost/cafe)
"dT" = (/obj/marker/map_node,/turf/simulated/floor/plating,/area/ghost/maint/east)
"dU" = (/obj/marker/map_node,/turf/simulated/floor/plating,/area/ghost/maint/south)
"dV" = (/obj/marker/map_node,/turf/simulated/floor/plating,/area/ghost/maint/west)

(1,1,1) = {"
aaaaaaaaaaaaaaaaaaaaaaaaaaaaaaaaaaaaaaaaaaaaaaaaaaaaaaaaaaaaaaaaaaaaaaaaaaaaaaaaaaaaaaaaaaaaaaaaaaaaaaaaaaaaaaaaaaaaaaaaaaaaaaaa
aaaaaaaaaaaaaaaaaaaaaaaaaaaaaaaaaaaaaaaaaaaaaaaaaaaaaaaaaaaaaaaaaaaaaaaaaaaaaaaaaaaaaaaaaaaaaaaaaaaaaaaaaaaaaaaaaaaaaaaaaaaaaaaa
aaaaaaaaaaaaaaaaaaaaaaaaaaaaaaaaaaaaaaaaaaaaaaaaaaaaaaaaaaaaaaaaaaaaaaaaaaaaaaaaaaaaaaaaaaaaaaaaaaaaaaaaaaaaaaaaaaaaaaaaaaaaaaaa
aaaaaaaaaaaaaaaaaaaaaaaaaaaaaaaaaaaaaaaaaaaaaaaaaaaaaaaaaaaaaaaaaaaaaaaaaaaaaaaaaaaaaaaaaaaaaaaaaaaaaaaaaaaaaaaaaaaaaaaaaaaaaaaa
aaaaaaaaaaaaaaaaaaaaaaaaaaaaaaaaaaaaaaaaaaaaaaaaaaaaaaaaaaaaaaaaaaaaaaaaaaaaaaaaaaaaaaaaaaaaaaaaaaaaaaaaaaaaaaaaaaaaaaaaaaaaaaaa
aaaaaaaaaaaaaaaaaaaaaaaaaaaaaaaaaaaaaaaaaaaaaaaaaaaaaaaaaaaaaaaaaaaaaaaaaaaaaaaaaaaaaaaaaaaaaaaaaaaaaaaaaaaaaaaaaaaaaaaaaaaaaaaa
aaaaaaaaaaaaaaaaaaaaaaaaaaaaaaaaaaaaaaaaaaaaaaaaaaaaaaaaaaaaaaaaaaaaaaaaaaaaaaaaaaaaaaaaaaaaaaaaaaaaaaaaaaaaaaaaaaaaaaaaaaaaaaaa
aaaaaaaaaaaaaaaaaaaaaaaaaaaaaaaaaaaaaaaaaaaaaaaaaaaaaaaaaaaaaaaaaaaaaaaaaaaaaaaaaaaaaaaaaaaaaaaaaaaaaaaaaaaaaaaaaaaaaaaaaaaaaaaa
aaaaaaaaaaaaaaaaaaaaaaaaaaaaaaaaaaaaaaaaaaaaaaaaaaaaaaaaaaaaaaaaaaaaaaaaaaaaaaaaaaaaaaaaaaaaaaaaaaaaaaaaaaaaaaaaaaaaaaaaaaaaaaaa
aaaaaaaaaaaaaaaaaaaaaaaaaaaaaaaaaaaaaaaaaaaaaaaaaaaaaaaaaaaaaaaaaaaaaaaaaaaaaaaaaaaaaaaaaaaaaaaaaaaaaaaaaaaaaaaaaaaaaaaaaaaaaaaa
aaaaaaaaaaaaaaaaaaaaaaaaaaaaaaaaaaaaaaaaaaaaaaaaaaaaaaaaaaaaaaaaaaaaaaaaaaaaaaaaaaaaaaaaaaaaaaaaaaaaaaaaaaaaaaaaaaaaaaaaaaaaaaaa
aaaaaaaaaaaaaaaaaaaaaaaaaaaaaaaaaaaaaaaaaaaaaaaaaaaaaaaaaaaaaaaaaaaaaaaaaaaaaaaaaaaaaaaaaaaaaaaaaaaaaaaaaaaaaaaaaaaaaaaaaaaaaaaa
aaaaaaaaaaaaaaaaaaaaaaaaaaaaaaaaaaaaaaaaaaaaaaaaaaaaaaaaaaaaaaaaaaaaaaaaaaaaaaaaaaaaaaaaaaaaaaaaaaaaaaaaaaaaaaaaaaaaaaaaaaaaaaaa
aaaaaaaaaaaaaaaaaaaaaaaaaaaaaaaPaPaPaPaPaPaPaPaPaPaPaPaPaPaPaPaPaPaPaPaPaPaPaRaRaRaRaRaRaRaRaRaRaRaRaRaRaRaaaaaaaaaaaaaaaaaaaaaa
aaaaaaaaaaaaaaaaaaaaaaaaaaaaaaaPaPaPaPaPaPaPaPaPaPaPaPaPaPaPaPaPaPaPaPaPaPaPaRaRaRaRaRaRaRaRaRaRaRaRaRaRaRaaaaaaaaaaaaaaaaaaaaaa
aaaaaaaaaaaaaaaaaaaaaaaaaaaaaaaPaPaPaPaPaPaPaPaPaPaPaPdjbkbkbkbkbkdjbkbkblaSaubmbnbnbnbndTbnbnbnbnbndTaRaRaaaaaaaaaaaaaaaaaaaaaa
aaaaaaaaaaaaaaaaaaaaaaaaaaaaaaaPaPaPaPaPaPaPaPaPaPaPaPbkboboblboboblbobobpaSaSbXbXbXbYbXbXbXbXcabXbXbnaRaRaaaaaaaaaaaaaaaaaaaaaa
aaaaaaaaaaaaaaaaaaaaaaaaaaaaaaaPaPdjbkbkbkbkbkbkbkbkbkdjboaSaSbobkbkbkbkboaSaScbawawawawawawawawawbXbnaRaRaaaaaaaaaaaaaaaaaaaaaa
aaaaaaaaaaaaaaaaaaaaaaaaacacacaPaPbkbobobobobobsboboboblboaSaTbobkdjbkbkboaSaScbawavamamamamamamawbXbnaRaRaaaaaaaaaaaaaaaaaaaaaa
aaaaaaaaaaaaaaaaaaaaaaaaacacabaPaPblbtdPdtdudsdsdtdudsdsbhaSaSboaebkbkbkboaSaScbawawawawawawawawccbXbnaRaRaaaaaaaaaaaaaaaaaaaaaa
aaaaaaaaaaaaaaaaaaaaaaaaacacbhbgaqaodsdsaoataoaoaiataodsbhaSaSbtboafbobsboaSaScbcbcbbXbXaBbXcbcbbYbXbnaRaRaaaaaaaaaaaaaaaaaaaaaa
aaaaaaaaaaaaaaaaaaaaaaaaacacbibgaoaodsdsaoaoaoataoaoaodsdNaSaSaSaSaSaSaSaUaSaSaSaScGbXccawawawdEawbXdTaRaRaaaaaaaaaaaaaaaaaaaaaa
aaaaaaaaaaaaaaaaaaaaaaaaajacbibgaoaidsdsaoaoaiataoaoaidsdNaSauaSaVauaSaSaSaSauaSaSdidFawamamamamdGbXbnaRaRaaaaaaaaaaaaaaaaaaaaaa
aaaaaaaaaaaaaaaaaaaaaaaaacacbhbgbjaodsdsaoataoaoaiataodsbhaWaWazazaAazcAcAcAazazaXdHbXawamamamaCawbXbnaRaRaaaaaaaaaaaaaaaaaaaaaa
aaaaaaaaaaaaaaaaaaaaaaaaacacabaQaQbCbDdsdvdudsdsdvdudsdsbhaWaWazcdcEchcEchcgchcFaYdHcbawamamamamawbXbnaRaRaaaaaaaaaaaaaaaaaaaaaa
aaaaaaaaaaaaaaaaaaaaaaaaacacacaQaQbEbDbDbDbDbDbDbDbDbDbCbDaWaZazcjchcEchcEclcmazaYdHcbawamamamaCawbXbnaRaRaaaaaaaaaaaaaaaaaaaaaa
aaaaaaaaaaaaaaaaaaaaaaaaaaaaaaaQaQdVbEbEbEbEbEbEbEbEbEdVbDaWaWazcBdSchcEchcEchcIaYdHcbdIavcCamamawcabnaRaRaaaaaaaaaaaaaaaaaaaaaa
aaaaaaaaaaaaaaaaaaaaaaaaaaaaaaayayaFaFaFaFaFaFaFaFaFbFbDbDaWaWazcDchcEchcEchcEazaYdHbXawdJawawdJawbXbnaRaRaaaaaaaaaaaaaaaaaaaaaa
aaaaaaaaaaaaaaaaaaaaaaaaaaaaaaayaycPaHaLbubvbwbBcycMbaaWaWaWaWazazcJazazazazazazaXdHbXbXbXbXbXbXbXbXbnaRaRaaaaaaaaaaaaaaaaaaaaaa
aaaaaaaaaaaaaaaaaaaaaaaaaaaaaaayaycPcNbxcScScScScPcTbaaGaWaWaGbPbQbUbUbUbQbUbUbOaYckbmbnbnbnbnbnbnbndTaRaRaaaaaaaaaaaaaaaaaaaaaa
aaaaaaaaaaaaaaaaaaaaaaaaaaaaaaayaycPcScScScScScScPcTbaaWbPbPbPbPbUaKaKaKaKaKaKaKaYbbcOaDaDaDancZaDaDbnaRaRaaaaaaaaaaaaaaaaaaaaaa
aaaaaaaaaaaaaaaaaaaaaaaaaaaaaaayaycPcNcScSaIcScScPcTbaaWbPadadaJbUaKahaKakakakaKaYbbaDaEcuaMcucudRaDbnaRaRaaaaaaaaaaaaaaaaaaaaaa
aaaaaaaaaaaaaaaaaaaaaaaaaaaaaaayaycUcScScScScScScPcTbaaWbObUbUbQbQaKapaKararasaKaYcvdKcucQcQcQczcuddbnaRaRaaaaaaaaaaaaaaaaaaaaaa
aaaaaaaaaaaaaaaaaaaaaaaaaaaaaaaycYcPcPcPcPcPcPcVcWaFbaaWbPbUbUbUbUcqararararaNdBaYbbaDcucQcQcQcQcuaxbnaRaRaaaaaaaaaaaaaaaaaaaaaa
aaaaaaaaaaaaaaaaaaaaaaaaaaaaaaayayaFcTcTaFdeaFaFaFdgbaaGbPbPbSbObPcrcocodccocodwckbeaDcucucxcwcucuaDdTaRaRaaaaaaaaaaaaaaaaaaaaaa
aaaaaaaaaaaaaaaaaaaaaaaaaaaaaaayaycycPcPcPcPcWaFbababaaWbPbTbUbUbUcscscscscscscsaYbbaDaDcRcRaDcucuaDbnaRaRaaaaaaaaaaaaaaaaaaaaaa
aaaaaaaaaaaaaaaaaaaaaaaaaaaaaaayaycUcScScScSdaaFbadOaWaWbWbUbUbVbUcsdxdxdfdydydzckbbcOaEcucucucucuaDbnaRaRaaaaaaaaaaaaaaaaaaaaaa
aaaaaaaaaaaaaaaaaaaaaaaaaaaaaaaycYcPcScScScScPaFbaaWaWaWbPbUbUbUbUcscncncncncndAaYbbaDcQcQaOcQcQcuaxbnaRaRaaaaaaaaaaaaaaaaaaaaaa
aaaaaaaaaaaaaaaaaaaaaaaaaaaaaaayaydbcScScSaIcPdLbaaGaWaGbObUbUbZbUcscpcscpcscpcsaYcvcXcQcQcQcQczcuddbnaRaRaaaaaaaaaaaaaaaaaaaaaa
aaaaaaaaaaaaaaaaaaaaaaaaaaaaaaayaycPcPcPdhcPcPaFbaaWbfaWbPbUbUbUbUcsctcsctcsctcsaXbbaDcucucxcucucuaDbnaRaRaaaaaaaaaaaaaaaaaaaaaa
aaaaaaaaaaaaaaaaaaaaaaaaaaaaaaayayayayayaydkaFaFbaaWbNbObPbPbPbObPcscscscscscscsaYbbaDbraDaDaDaDaDaDbnaRaRaaaaaaaaaaaaaaaaaaaaaa
aaaaaaaaaaaaaaaaaaaaaaaaaaaaaabGbGbJbJbJbLdUbKbIaWaWbPbQbUbUbUbQbUbUbUbQbUbUbUbOaYckbmdTbnbnbnbnbnbndTaRaRaaaaaaaaaaaaaaaaaaaaaa
aaaaaaaaaaaaaaaaaaaaaaaaaaaaaabGbGbJbGbGbGbJbJbIaWaWbPbPbPbRbSbPbPbPbPbPbPbPbPbPaYaYbqbnbqbqbnbnbnbnbnaRaRaaaaaaaaaaaaaaaaaaaaaa
aaaaaaaaaaaaaaaaaaaaaaaaaaaaaabGbJbJbJbGbGbJdUbHbccebdbcbcbcbcbccebcbcbcbcbcbcbdcebcbqbnbybqbnbnbzbnbnaRaRaaaaaaaaaaaaaaaaaaaaaa
aaaaaaaaaaaaaaaaaaaaaaaaaaaaaabGbJbGbGbGbGbLbJbIdrdCdCdCdCdCdCdDdCdCdCdCdCdCdCdCdCdCbqbnbybqbnbnbzbnbnaRaRaaaaaaaaaaaaaaaaaaaaaa
aaaaaaaaaaaaaaaaaaaaaaaaaaaaaabGbLbGbGbGbGbGbJbMagdMagalalalagagagagagalalalalagcHagagbnaRaRaRaRaRaRbnbAaRaaaaaaaaaaaaaaaaaaaaaa
aaaaaaaaaaaaaaaaaaaaaaaaaaaaaabGbJbJbJbGbGbGbJbMcKdpdpdpdpdpdpdpdpdpdpdpdpdpdpdpdpcKagbnbnaRaRaRaRaRbnbnaRaaaaaaaaaaaaaaaaaaaaaa
aaaaaaaaaaaaaaaaaaaaaaaaaaaaaabGbJbGbJbGbGbGbJdQdpcLcLcLcLcLcLcLcLcLcLcLcLcLcLcLcLdlagbnbnaRaRbnbnaRbnbnaRaaaaaaaaaaaaaaaaaaaaaa
aaaaaaaaaaaaaaaaaaaaaaaaaaaaaabGbJbGbJbGbGbGdUdndpcfcLcLcLcLcLcLcfcLcLcLdmdocLcLcidpdndTbnbnbzbnbnaRbnbnaRaaaaaaaaaaaaaaaaaaaaaa
aaaaaaaaaaaaaaaaaaaaaaaaaaaaaabGbGbGbJbJbJbLbJbMdpdpdpdpdqdpdpdpdpdpdpdpdpdpdqdpdpdpagbnbnbnaRaRbzaRbnbnaRaaaaaaaaaaaaaaaaaaaaaa
aaaaaaaaaaaaaaaaaaaaaaaaaaaaaabGbGbGbJbGbGbGbJbMagagagagagagagagdnagagagagagagagagagagbnaRaRaRaRbnbnbnbnaRaaaaaaaaaaaaaaaaaaaaaa
aaaaaaaaaaaaaaaaaaaaaaaaaaaaaabGbGbGbJbJbJbJdUbJbJbJbJdUbJbJbJbJdUbJbJbJbJbJdUbJbJbJbJdTaRaRaRaRbnbnaRaRaRaaaaaaaaaaaaaaaaaaaaaa
aaaaaaaaaaaaaaaaaaaaaaaaaaaaaabGbGbGbGbGbGbGbGbGbGbGbGbGbGbGbGbGbGbGbGbGbGbGbGbGbGbGbGaRaRaRaRaRaRaRaRaRaRaaaaaaaaaaaaaaaaaaaaaa
aaaaaaaaaaaaaaaaaaaaaaaaaaaaaaaaaaaaaaaaaaaaaaaaaaaaaaaaaaaaaaaaaaaaaaaaaaaaaaaaaaaaaaaaaaaaaaaaaaaaaaaaaaaaaaaaaaaaaaaaaaaaaaaa
aaaaaaaaaaaaaaaaaaaaaaaaaaaaaaaaaaaaaaaaaaaaaaaaaaaaaaaaaaaaaaaaaaaaaaaaaaaaaaaaaaaaaaaaaaaaaaaaaaaaaaaaaaaaaaaaaaaaaaaaaaaaaaaa
aaaaaaaaaaaaaaaaaaaaaaaaaaaaaaaaaaaaaaaaaaaaaaaaaaaaaaaaaaaaaaaaaaaaaaaaaaaaaaaaaaaaaaaaaaaaaaaaaaaaaaaaaaaaaaaaaaaaaaaaaaaaaaaa
aaaaaaaaaaaaaaaaaaaaaaaaaaaaaaaaaaaaaaaaaaaaaaaaaaaaaaaaaaaaaaaaaaaaaaaaaaaaaaaaaaaaaaaaaaaaaaaaaaaaaaaaaaaaaaaaaaaaaaaaaaaaaaaa
aaaaaaaaaaaaaaaaaaaaaaaaaaaaaaaaaaaaaaaaaaaaaaaaaaaaaaaaaaaaaaaaaaaaaaaaaaaaaaaaaaaaaaaaaaaaaaaaaaaaaaaaaaaaaaaaaaaaaaaaaaaaaaaa
aaaaaaaaaaaaaaaaaaaaaaaaaaaaaaaaaaaaaaaaaaaaaaaaaaaaaaaaaaaaaaaaaaaaaaaaaaaaaaaaaaaaaaaaaaaaaaaaaaaaaaaaaaaaaaaaaaaaaaaaaaaaaaaa
aaaaaaaaaaaaaaaaaaaaaaaaaaaaaaaaaaaaaaaaaaaaaaaaaaaaaaaaaaaaaaaaaaaaaaaaaaaaaaaaaaaaaaaaaaaaaaaaaaaaaaaaaaaaaaaaaaaaaaaaaaaaaaaa
aaaaaaaaaaaaaaaaaaaaaaaaaaaaaaaaaaaaaaaaaaaaaaaaaaaaaaaaaaaaaaaaaaaaaaaaaaaaaaaaaaaaaaaaaaaaaaaaaaaaaaaaaaaaaaaaaaaaaaaaaaaaaaaa
aaaaaaaaaaaaaaaaaaaaaaaaaaaaaaaaaaaaaaaaaaaaaaaaaaaaaaaaaaaaaaaaaaaaaaaaaaaaaaaaaaaaaaaaaaaaaaaaaaaaaaaaaaaaaaaaaaaaaaaaaaaaaaaa
aaaaaaaaaaaaaaaaaaaaaaaaaaaaaaaaaaaaaaaaaaaaaaaaaaaaaaaaaaaaaaaaaaaaaaaaaaaaaaaaaaaaaaaaaaaaaaaaaaaaaaaaaaaaaaaaaaaaaaaaaaaaaaaa
aaaaaaaaaaaaaaaaaaaaaaaaaaaaaaaaaaaaaaaaaaaaaaaaaaaaaaaaaaaaaaaaaaaaaaaaaaaaaaaaaaaaaaaaaaaaaaaaaaaaaaaaaaaaaaaaaaaaaaaaaaaaaaaa
"}
