//MAP CONVERTED BY dmm2tgm.py THIS HEADER COMMENT PREVENTS RECONVERSION, DO NOT REMOVE
"a" = (
/turf/simulated/wall/dark,
/area/prefab/syndicate_base)
"b" = (
/turf/dmm_suite/clear_turf,
/area/dmm_suite/clear_area)
"c" = (
/turf/simulated/floor/plating,
/area/prefab/syndicate_base)
"d" = (
/obj/structure/interactive/door/airlock/syndicate,
/turf/simulated/floor/plating,
/area/prefab/syndicate_base)
"e" = (
/obj/structure/smooth/table/reinforced/dark,
/turf/simulated/floor/tile/morphing/red/dark,
/area/prefab/syndicate_base)
"f" = (
/turf/simulated/floor/tile/morphing/red/dark,
/area/prefab/syndicate_base)
"g" = (
/obj/structure/interactive/chair{
	icon_state = "chair";
	dir = 4
	},
/turf/simulated/floor/tile/morphing/red/dark,
/area/prefab/syndicate_base)
"h" = (
/obj/structure/interactive/potted_plant/office,
/turf/simulated/floor/tile/morphing/red/dark,
/area/prefab/syndicate_base)
"i" = (
/obj/structure/interactive/potted_plant/office,
/obj/structure/interactive/lighting/fixture/tube/syndicate,
/turf/simulated/floor/tile/morphing/red/dark,
/area/prefab/syndicate_base)
"j" = (
/obj/structure/smooth/table/reinforced/dark,
/obj/structure/interactive/lighting/fixture/tube/syndicate,
/turf/simulated/floor/tile/morphing/red/dark,
/area/prefab/syndicate_base)
"k" = (
/mob/living/advanced/npc/syndicate/scientist{
	icon_state = "directional";
	dir = 4
	},
/turf/simulated/floor/tile/dark,
/area/prefab/syndicate_base)
"l" = (
/turf/simulated/floor/tile/dark,
/area/prefab/syndicate_base)
"m" = (
/mob/living/advanced/npc/syndicate,
/turf/simulated/floor/tile/morphing/red/dark,
/area/prefab/syndicate_base)
"n" = (
/obj/marker/spawning/window,
/turf/simulated/floor/plating,
/area/prefab/syndicate_base)
"o" = (
/obj/structure/interactive/chair{
	icon_state = "chair";
	dir = 8
	},
/mob/living/advanced/npc/syndicate/scientist{
	icon_state = "directional";
	dir = 8
	},
/turf/simulated/floor/tile/dark,
/area/prefab/syndicate_base)
"p" = (
/obj/structure/interactive/chair,
/turf/simulated/floor/tile/morphing/red/dark,
/area/prefab/syndicate_base)
"q" = (
/mob/living/advanced/npc/syndicate/scientist,
/turf/simulated/floor/tile/morphing/red/dark,
/area/prefab/syndicate_base)
"r" = (
/obj/structure/smooth/table/reinforced/dark,
/obj/structure/interactive/lighting/fixture/tube/syndicate{
	icon_state = "preview";
	dir = 4
	},
/turf/simulated/floor/tile/morphing/red/dark,
/area/prefab/syndicate_base)
"s" = (
/obj/structure/interactive/chair{
	icon_state = "chair";
	dir = 8
	},
/turf/simulated/floor/tile/dark,
/area/prefab/syndicate_base)
"t" = (
/obj/structure/interactive/lighting/fixture/tube/syndicate{
	icon_state = "preview";
	dir = 8
	},
/turf/simulated/floor/tile/morphing/red/dark,
/area/prefab/syndicate_base)
"u" = (
/obj/structure/interactive/door/airlock/syndicate,
/turf/simulated/floor/tile/morphing/red/dark,
/area/prefab/syndicate_base)
"v" = (
/obj/structure/interactive/chair{
	icon_state = "chair";
	dir = 1
	},
/turf/simulated/floor/tile/dark,
/area/prefab/syndicate_base)
"w" = (
/mob/living/advanced/npc/syndicate{
	icon_state = "directional";
	dir = 4
	},
/turf/simulated/floor/tile/morphing/red/dark,
/area/prefab/syndicate_base)
"x" = (
/obj/structure/interactive/lighting/fixture/tube/syndicate{
	icon_state = "preview";
	dir = 4
	},
/turf/simulated/floor/tile/morphing/red/dark,
/area/prefab/syndicate_base)
"y" = (
/obj/structure/smooth/table/reinforced/dark,
/turf/simulated/floor/tile/dark,
/area/prefab/syndicate_base)
"z" = (
/mob/living/advanced/npc/syndicate/scientist,
/turf/simulated/floor/tile/dark,
/area/prefab/syndicate_base)
"A" = (
/mob/living/advanced/npc/syndicate/scientist{
	icon_state = "directional";
	dir = 8
	},
/turf/simulated/floor/tile/morphing/red/dark,
/area/prefab/syndicate_base)
"B" = (
/obj/structure/interactive/lighting/fixture/tube/syndicate{
	icon_state = "preview";
	dir = 8
	},
/mob/living/advanced/npc/syndicate{
	icon_state = "directional";
	dir = 8
	},
/turf/simulated/floor/tile/morphing/red/dark,
/area/prefab/syndicate_base)
"C" = (
/obj/structure/smooth/table/reinforced/dark,
/obj/structure/interactive/lighting/fixture/tube/syndicate{
	icon_state = "preview";
	dir = 8
	},
/turf/simulated/floor/tile/morphing/red/dark,
/area/prefab/syndicate_base)
"D" = (
/obj/structure/interactive/chair,
/turf/simulated/floor/tile/dark,
/area/prefab/syndicate_base)
"E" = (
/obj/structure/interactive/chair,
/mob/living/advanced/npc/syndicate/triple,
/turf/simulated/floor/tile/dark,
/area/prefab/syndicate_base)
"F" = (
/obj/structure/interactive/lighting/fixture/tube/syndicate,
/turf/simulated/floor/tile/morphing/red/dark,
/area/prefab/syndicate_base)
"G" = (
/obj/structure/interactive/chair{
	icon_state = "chair";
	dir = 8
	},
/turf/simulated/floor/tile/morphing/red/dark,
/area/prefab/syndicate_base)
"H" = (
/obj/structure/interactive/chair{
	icon_state = "chair";
	dir = 4
	},
/obj/structure/interactive/lighting/fixture/tube/syndicate{
	icon_state = "preview";
	dir = 4
	},
/turf/simulated/floor/tile/morphing/red/dark,
/area/prefab/syndicate_base)
"I" = (
/obj/structure/interactive/lighting/fixture/tube/syndicate{
	icon_state = "preview";
	dir = 8
	},
/turf/simulated/floor/plating,
/area/prefab/syndicate_base)
"J" = (
/obj/structure/interactive/chair{
	icon_state = "chair";
	dir = 8
	},
/obj/structure/interactive/lighting/fixture/tube/syndicate{
	icon_state = "preview";
	dir = 8
	},
/turf/simulated/floor/tile/morphing/red/dark,
/area/prefab/syndicate_base)
"K" = (
/obj/structure/smooth/table/reinforced/dark,
/obj/structure/interactive/lighting/fixture/tube/syndicate{
	icon_state = "preview";
	dir = 1
	},
/turf/simulated/floor/tile/morphing/red/dark,
/area/prefab/syndicate_base)
"L" = (
/mob/living/advanced/npc/syndicate{
	icon_state = "directional";
	dir = 8
	},
/turf/simulated/floor/tile/morphing/red/dark,
/area/prefab/syndicate_base)
"M" = (
/turf/dmm_suite/no_wall,
/area/dmm_suite/clear_area)
"N" = (
/mob/living/advanced/npc/syndicate/double{
	icon_state = "directional";
	dir = 8
	},
/turf/simulated/floor/plating,
/area/prefab/syndicate_base)
"O" = (
/turf/simulated/floor/tile/dark/er,
/area/prefab/syndicate_base)
"P" = (
/obj/structure/interactive/chair{
	icon_state = "chair";
	dir = 8
	},
/mob/living/advanced/npc/syndicate/quadruple{
	icon_state = "directional";
	dir = 8
	},
/turf/simulated/floor/tile/morphing/red/dark,
/area/prefab/syndicate_base)
"Q" = (
/turf/simulated/floor/tile,
/area/prefab/syndicate_base)
"R" = (
/obj/structure/interactive/lighting/fixture/tube/syndicate{
	icon_state = "preview";
	dir = 1
	},
/turf/simulated/floor/tile/morphing/red/dark,
/area/prefab/syndicate_base)
"S" = (
/obj/structure/smooth/table/reinforced/dark,
/obj/structure/interactive/misc/computer1,
/turf/simulated/floor/tile/morphing/red/dark,
/area/prefab/syndicate_base)
"T" = (
/obj/structure/smooth/table/reinforced/dark,
/obj/structure/interactive/misc/computer4,
/turf/simulated/floor/tile/dark,
/area/prefab/syndicate_base)
"U" = (
/obj/structure/interactive/chair{
	icon_state = "chair";
	dir = 4
	},
/turf/simulated/floor/tile/dark,
/area/prefab/syndicate_base)
"V" = (
/obj/structure/interactive/chair{
	icon_state = "chair";
	dir = 8
	},
/mob/living/advanced/npc/syndicate/double{
	icon_state = "directional";
	dir = 8
	},
/turf/simulated/floor/tile/dark,
/area/prefab/syndicate_base)
"W" = (
/obj/structure/interactive/chair{
	icon_state = "chair";
	dir = 4
	},
/mob/living/advanced/npc/syndicate/scientist{
	icon_state = "directional";
	dir = 4
	},
/turf/simulated/floor/tile/dark,
/area/prefab/syndicate_base)
"X" = (
/mob/living/advanced/npc/syndicate{
	icon_state = "directional";
	dir = 1
	},
/turf/simulated/floor/tile/morphing/red/dark,
/area/prefab/syndicate_base)
"Y" = (
/mob/living/advanced/npc/syndicate/scientist{
	icon_state = "directional";
	dir = 1
	},
/turf/simulated/floor/tile/morphing/red/dark,
/area/prefab/syndicate_base)
"Z" = (
/mob/living/advanced/npc/syndicate/scientist{
	icon_state = "directional";
	dir = 1
	},
/turf/simulated/floor/tile/dark,
/area/prefab/syndicate_base)

(1,1,1) = {"
b
b
b
b
b
b
b
b
b
b
b
b
b
b
b
b
b
b
b
b
b
b
b
b
b
b
b
b
b
b
b
b
M
M
M
M
M
M
M
M
M
b
b
b
b
b
b
b
b
b
b
b
b
b
b
b
b
b
b
b
b
b
b
b
"}
(2,1,1) = {"
b
b
b
b
b
b
b
b
b
b
b
b
b
b
b
b
b
b
b
b
b
b
b
b
b
b
b
b
b
b
b
b
M
M
M
M
M
M
M
M
M
b
b
b
b
b
b
b
b
b
b
b
b
b
b
b
b
b
b
b
b
b
b
b
"}
(3,1,1) = {"
b
b
b
b
b
b
b
b
b
b
b
b
b
b
b
b
b
b
b
b
b
b
b
b
b
b
b
b
b
b
b
b
M
M
M
M
M
M
M
M
M
M
b
b
b
b
b
b
b
b
b
b
b
b
b
b
b
b
b
b
b
b
b
b
"}
(4,1,1) = {"
b
b
b
b
b
b
b
b
b
b
b
b
b
b
b
b
b
b
b
b
b
b
b
b
b
b
b
b
b
b
b
b
M
M
M
M
M
M
M
M
M
M
b
b
b
b
b
b
b
b
b
b
b
b
b
b
b
b
b
b
b
b
b
b
"}
(5,1,1) = {"
b
b
b
b
b
b
b
b
b
b
b
b
b
b
b
b
b
b
b
b
b
b
b
b
b
b
b
b
b
b
b
M
M
M
M
M
M
M
M
M
M
M
M
b
b
b
b
b
b
b
b
b
b
b
b
b
b
b
b
b
b
b
b
b
"}
(6,1,1) = {"
b
b
b
b
b
b
b
b
b
b
b
b
b
b
b
b
b
b
b
b
b
b
b
b
b
b
b
b
b
b
b
M
M
M
M
M
M
M
M
M
M
M
M
M
b
b
b
b
b
b
b
b
b
b
b
b
b
b
b
b
b
b
b
b
"}
(7,1,1) = {"
b
b
b
b
b
b
b
b
b
b
b
b
b
b
b
b
b
b
b
b
b
b
b
b
b
b
b
b
b
b
M
M
M
M
M
M
M
M
M
M
M
M
M
M
M
b
b
b
b
b
b
b
b
b
b
b
b
b
b
b
b
b
b
b
"}
(8,1,1) = {"
b
b
b
b
b
b
b
b
b
b
b
b
b
b
b
b
b
b
b
b
b
b
b
b
b
b
b
b
b
b
M
M
M
M
M
M
M
M
M
M
M
M
M
M
M
b
b
b
b
b
b
b
b
b
b
b
b
b
b
b
b
b
b
b
"}
(9,1,1) = {"
b
b
b
b
b
b
b
b
b
b
b
b
b
b
b
b
b
b
b
b
b
b
b
b
b
b
b
b
b
M
M
M
c
c
c
c
c
c
c
c
c
M
M
M
M
M
b
b
b
b
b
b
b
b
b
b
b
b
b
b
b
b
b
b
"}
(10,1,1) = {"
b
b
b
b
b
b
b
b
b
b
b
b
b
b
b
b
b
b
b
b
b
b
b
b
b
b
b
b
b
M
M
M
c
c
c
c
c
c
c
c
c
M
M
M
M
M
b
b
b
b
b
b
b
b
b
b
b
b
b
b
b
b
b
b
"}
(11,1,1) = {"
b
b
b
b
b
b
b
b
b
b
b
b
b
b
b
b
b
b
b
b
b
b
b
b
b
b
b
b
M
M
M
M
I
N
c
c
I
c
c
N
I
M
M
M
M
M
M
b
b
b
b
b
b
b
b
b
b
b
b
b
b
b
b
b
"}
(12,1,1) = {"
b
b
b
b
b
b
b
b
b
b
b
b
b
b
b
b
b
b
b
b
b
b
b
b
b
b
b
b
M
M
M
M
a
a
u
u
a
u
u
a
a
M
M
M
M
M
M
b
b
b
b
b
b
b
b
b
b
b
b
b
b
b
b
b
"}
(13,1,1) = {"
b
b
b
b
b
b
b
b
b
b
b
b
b
b
b
b
b
b
b
b
b
b
b
b
b
b
b
b
M
a
a
a
a
h
f
f
x
f
f
h
a
a
a
a
M
M
M
M
b
b
b
b
b
b
b
b
b
b
b
b
b
b
b
b
"}
(14,1,1) = {"
b
b
b
b
b
b
b
b
b
b
b
b
b
b
b
b
b
b
b
b
b
b
b
b
b
b
b
b
M
a
h
x
e
f
l
l
l
l
l
f
S
x
h
a
M
M
M
M
b
b
b
b
b
b
b
b
b
b
b
b
b
b
b
b
"}
(15,1,1) = {"
b
b
b
b
b
b
b
b
b
b
b
b
b
b
b
b
b
b
b
b
b
b
b
b
b
b
b
b
M
a
f
E
y
l
l
l
l
l
l
l
T
l
f
a
M
M
M
b
b
b
b
b
b
b
b
b
b
b
b
b
b
b
b
b
"}
(16,1,1) = {"
b
b
b
b
b
b
b
b
b
b
b
b
b
b
b
b
b
b
b
b
b
b
b
b
b
b
b
b
M
a
f
l
y
l
l
l
l
l
l
l
y
V
f
a
M
M
b
b
b
b
b
b
b
b
b
b
b
b
b
b
b
b
b
b
"}
(17,1,1) = {"
b
b
b
b
b
b
b
b
b
b
b
b
b
b
b
b
b
b
b
b
b
b
b
b
b
b
b
b
M
a
h
f
e
f
l
l
l
l
l
f
e
f
h
a
M
b
b
b
b
b
b
b
b
b
b
b
b
b
b
b
b
b
b
b
"}
(18,1,1) = {"
b
b
b
b
b
b
b
b
b
b
b
b
b
b
b
b
b
b
b
b
b
b
b
b
b
b
b
b
b
a
a
a
a
F
l
l
l
l
l
f
a
a
a
a
b
b
b
b
b
b
b
b
b
b
b
b
b
b
b
b
b
b
b
b
"}
(19,1,1) = {"
b
b
b
b
b
b
b
b
b
b
b
b
b
b
b
b
b
b
b
b
b
b
b
b
b
b
b
b
b
b
b
b
a
h
f
f
t
f
f
h
a
b
b
b
b
b
b
b
b
b
b
b
b
b
b
b
b
b
b
b
b
b
b
b
"}
(20,1,1) = {"
b
b
b
b
b
b
b
b
b
b
b
b
a
a
a
a
a
a
a
a
a
a
a
a
a
a
a
a
a
a
a
a
a
a
u
u
a
u
u
a
a
a
a
b
b
b
b
b
b
b
b
b
b
b
b
b
b
b
b
b
b
b
b
b
"}
(21,1,1) = {"
b
b
b
b
b
b
b
b
b
b
b
b
a
c
c
c
c
c
c
c
c
c
c
c
c
c
c
c
c
c
d
f
x
h
f
f
f
f
f
h
H
g
a
a
a
a
a
a
a
a
b
b
b
b
b
b
b
b
b
b
b
b
b
b
"}
(22,1,1) = {"
b
b
b
b
b
b
b
b
b
b
b
b
a
c
c
c
c
a
a
a
a
a
a
a
a
a
a
a
a
a
a
f
l
l
l
l
l
l
l
l
l
f
a
e
f
x
A
f
e
a
b
b
b
b
b
b
b
b
b
b
b
b
b
b
"}
(23,1,1) = {"
b
b
b
b
b
b
b
b
b
b
b
b
a
c
c
c
c
a
e
h
x
f
f
f
f
f
h
r
e
e
a
f
l
O
O
O
O
O
O
O
l
f
n
e
l
l
l
l
e
a
b
b
b
b
b
b
b
b
b
b
b
b
b
b
"}
(24,1,1) = {"
b
b
b
b
b
b
b
b
b
b
b
b
a
c
c
c
c
a
e
v
l
l
l
l
l
l
l
l
D
e
n
q
l
O
Q
Q
Q
O
Q
O
l
f
n
e
s
l
l
l
e
a
b
b
b
b
b
b
b
b
b
b
b
b
b
b
"}
(25,1,1) = {"
b
b
b
b
b
b
b
b
b
b
b
b
a
c
c
c
c
a
e
l
l
y
y
y
y
y
l
l
l
e
n
f
l
O
Q
O
Q
O
Q
O
l
f
n
e
l
l
l
l
e
a
b
b
b
b
b
b
b
b
b
b
b
b
b
b
"}
(26,1,1) = {"
b
b
b
b
b
b
b
b
b
b
b
b
a
c
c
c
c
a
j
l
l
y
l
l
l
y
l
l
l
e
n
f
l
O
Q
O
Q
O
Q
O
l
f
n
e
l
l
l
l
e
a
b
b
b
b
b
b
b
b
b
b
b
b
b
b
"}
(27,1,1) = {"
b
b
b
b
b
b
b
b
b
b
b
b
a
c
c
c
c
a
e
l
l
y
y
y
y
y
l
l
l
e
n
f
l
O
Q
O
Q
Q
Q
O
l
f
n
e
l
l
l
l
e
a
b
b
b
b
b
b
b
b
b
b
b
b
b
b
"}
(28,1,1) = {"
b
b
b
b
b
b
b
b
b
b
b
b
a
c
c
c
c
a
m
l
l
l
l
s
o
l
l
l
l
f
a
F
l
O
O
O
O
O
O
O
l
f
a
q
l
l
l
Z
e
a
b
b
b
b
b
b
b
b
b
b
b
b
b
b
"}
(29,1,1) = {"
b
b
b
b
b
b
b
b
b
b
b
b
a
c
c
c
c
d
f
l
l
l
l
l
l
l
l
l
l
f
u
f
l
l
l
l
l
l
l
l
l
f
u
f
l
l
l
l
e
a
b
b
b
b
b
b
b
b
b
b
b
b
b
b
"}
(30,1,1) = {"
b
b
b
b
b
b
b
b
b
b
b
b
a
c
c
c
c
a
h
f
t
f
f
A
f
f
f
t
f
h
a
G
J
P
f
l
f
f
A
f
t
h
a
f
f
f
t
G
e
a
b
b
b
b
b
b
b
b
b
b
b
b
b
b
"}
(31,1,1) = {"
b
b
b
b
b
b
b
b
b
b
b
b
a
c
c
c
a
a
a
a
a
a
a
a
a
a
a
a
a
a
a
a
a
a
f
l
f
a
a
a
a
a
a
a
a
d
a
a
a
a
b
b
b
b
b
b
b
b
b
b
b
b
b
b
"}
(32,1,1) = {"
b
b
b
b
b
b
b
b
b
b
b
b
a
c
c
c
a
e
r
e
e
e
r
e
a
e
r
e
e
e
e
r
e
n
f
l
R
a
e
r
e
e
r
e
a
c
a
b
b
b
b
b
b
b
b
b
b
b
b
b
b
b
b
b
"}
(33,1,1) = {"
b
b
b
b
b
b
b
b
b
b
b
b
a
c
c
c
a
p
l
l
l
l
l
f
a
e
v
l
l
k
l
l
e
n
f
l
f
n
w
l
l
l
l
h
a
c
a
b
b
b
b
b
b
b
b
b
b
b
b
b
b
b
b
b
"}
(34,1,1) = {"
b
b
b
b
b
b
b
b
b
b
b
b
a
c
c
c
a
q
l
l
l
l
l
f
a
e
l
l
l
l
l
l
f
n
f
l
f
n
f
l
U
W
l
f
a
c
a
b
b
b
b
b
b
b
b
b
b
b
b
b
b
b
b
b
"}
(35,1,1) = {"
b
b
b
b
b
b
b
b
b
b
b
b
a
c
c
c
a
f
f
f
f
f
t
h
a
e
l
l
l
l
l
l
f
a
f
l
f
n
f
l
y
y
l
R
a
c
a
b
b
b
b
b
b
b
b
b
b
b
b
b
b
b
b
b
"}
(36,1,1) = {"
b
b
b
b
b
b
b
b
b
b
b
b
a
c
c
c
a
a
d
a
a
a
a
a
a
m
l
l
l
l
l
l
f
u
f
l
f
n
f
l
y
y
l
f
a
c
a
b
b
b
b
b
b
b
b
b
b
b
b
b
b
b
b
b
"}
(37,1,1) = {"
b
b
b
b
b
b
b
b
b
b
b
b
a
c
c
c
c
c
c
c
c
c
c
c
d
f
t
f
f
f
f
t
h
a
F
l
f
n
f
l
y
y
l
f
a
c
a
b
b
b
b
b
b
b
b
b
b
b
b
b
b
b
b
b
"}
(38,1,1) = {"
b
b
b
b
b
b
b
b
b
b
b
b
a
c
a
a
a
a
a
a
a
a
d
a
a
a
a
a
a
a
a
a
a
a
f
l
f
n
f
l
o
s
l
f
a
c
a
b
b
b
b
b
b
b
b
b
b
b
b
b
b
b
b
b
"}
(39,1,1) = {"
b
b
b
b
b
b
b
b
b
b
b
b
a
c
a
e
e
r
e
e
a
e
f
f
x
f
e
e
a
h
w
H
e
a
f
l
f
n
f
l
l
l
l
f
a
c
a
b
b
b
b
b
b
b
b
b
b
b
b
b
b
b
b
b
"}
(40,1,1) = {"
b
b
b
b
b
b
b
b
b
b
b
b
a
c
d
f
k
s
l
w
a
e
l
l
l
l
l
e
a
f
l
l
e
a
f
l
f
n
f
l
l
l
l
f
a
c
a
b
b
b
b
b
b
b
b
b
b
b
b
b
b
b
b
b
"}
(41,1,1) = {"
b
b
b
b
b
b
b
b
b
b
b
b
a
c
a
f
l
l
l
f
a
e
z
l
l
l
D
e
a
f
l
l
e
a
f
l
f
n
f
l
U
U
l
f
a
c
a
b
b
b
b
b
b
b
b
b
b
b
b
b
b
b
b
b
"}
(42,1,1) = {"
b
b
b
b
b
b
b
b
b
b
b
b
a
c
a
g
l
l
l
f
a
j
l
l
l
l
l
e
a
f
l
l
e
a
f
l
f
n
f
l
y
y
l
R
a
c
a
b
b
b
b
b
b
b
b
b
b
b
b
b
b
b
b
b
"}
(43,1,1) = {"
b
b
b
b
b
b
b
b
b
b
b
b
a
c
a
e
l
l
l
f
a
e
l
l
l
l
l
e
a
q
l
l
K
a
f
l
f
n
f
l
y
y
l
f
a
c
a
b
b
b
b
b
b
b
b
b
b
b
b
b
b
b
b
b
"}
(44,1,1) = {"
b
b
b
b
b
b
b
b
b
b
b
b
a
c
a
e
f
t
f
h
a
e
f
f
f
B
f
e
a
f
f
f
e
a
f
l
R
a
f
l
y
y
l
X
a
c
a
b
b
b
b
b
b
b
b
b
b
b
b
b
b
b
b
b
"}
(45,1,1) = {"
b
b
b
b
b
b
b
b
b
b
b
b
a
c
a
a
a
a
u
a
a
a
n
n
n
a
u
a
a
a
u
a
a
a
f
l
f
u
f
l
s
s
l
f
d
c
a
b
b
b
b
b
b
b
b
b
b
b
b
b
b
b
b
b
"}
(46,1,1) = {"
b
b
b
b
b
b
b
b
b
b
b
b
a
c
a
h
m
f
f
f
x
f
f
f
f
x
f
f
f
f
f
f
f
f
f
l
f
a
f
t
f
f
t
h
a
c
a
b
b
b
b
b
b
b
b
b
b
b
b
b
b
b
b
b
"}
(47,1,1) = {"
b
b
b
b
b
b
b
b
b
b
b
b
a
c
d
f
l
l
l
l
l
l
l
l
l
l
l
l
l
l
l
l
l
l
l
l
f
a
a
a
a
a
a
a
a
c
a
b
b
b
b
b
b
b
b
b
b
b
b
b
b
b
b
b
"}
(48,1,1) = {"
b
b
b
b
b
b
b
b
b
b
b
b
a
c
a
i
f
f
f
f
f
f
f
f
f
f
f
f
f
f
f
f
f
t
f
L
f
d
c
c
c
c
c
c
c
c
a
b
b
b
b
b
b
b
b
b
b
b
b
b
b
b
b
b
"}
(49,1,1) = {"
b
b
b
b
b
b
b
b
b
b
b
b
a
c
a
a
n
n
n
n
n
n
n
n
n
a
u
a
a
a
n
n
n
a
u
a
a
a
a
a
a
a
a
a
a
c
a
b
b
b
b
b
b
b
b
b
b
b
b
b
b
b
b
b
"}
(50,1,1) = {"
b
b
b
b
b
b
b
b
b
b
b
b
a
c
a
e
e
e
e
e
e
e
e
e
e
x
f
h
a
e
e
f
f
x
f
e
a
e
r
e
e
e
r
e
a
c
a
b
b
b
b
b
b
b
b
b
b
b
b
b
b
b
b
b
"}
(51,1,1) = {"
b
b
b
b
b
b
b
b
b
b
b
b
a
c
a
j
o
l
l
l
l
k
l
l
l
l
l
f
a
e
l
l
l
l
l
e
a
e
s
l
l
l
l
e
a
c
a
b
b
b
b
b
b
b
b
b
b
b
b
b
b
b
b
b
"}
(52,1,1) = {"
b
b
b
b
b
b
b
b
b
b
b
b
a
c
a
e
l
l
l
l
l
l
l
l
l
l
l
f
a
e
l
l
l
l
D
e
a
e
l
l
l
l
l
e
a
c
a
b
b
b
b
b
b
b
b
b
b
b
b
b
b
b
b
b
"}
(53,1,1) = {"
b
b
b
b
b
b
b
b
b
b
b
b
a
c
a
f
l
l
l
l
l
l
l
l
l
l
l
e
a
e
l
l
l
l
l
e
a
q
l
l
l
l
l
Y
a
c
a
b
b
b
b
b
b
b
b
b
b
b
b
b
b
b
b
b
"}
(54,1,1) = {"
b
b
b
b
b
b
b
b
b
b
b
b
a
c
a
f
l
l
l
l
l
l
l
l
l
l
D
e
a
e
v
l
l
l
l
f
a
f
l
l
l
l
l
f
a
c
a
b
b
b
b
b
b
b
b
b
b
b
b
b
b
b
b
b
"}
(55,1,1) = {"
b
b
b
b
b
b
b
b
b
b
b
b
a
c
a
h
f
t
f
f
f
f
A
e
e
C
e
e
a
e
l
l
l
l
l
f
u
f
l
l
l
l
l
R
a
c
a
b
b
b
b
b
b
b
b
b
b
b
b
b
b
b
b
b
"}
(56,1,1) = {"
b
b
b
b
b
b
b
b
b
b
b
b
a
c
a
a
d
a
a
a
a
a
a
a
a
a
a
a
a
e
f
f
L
t
f
h
a
G
t
A
f
f
f
h
a
c
a
b
b
b
b
b
b
b
b
b
b
b
b
b
b
b
b
b
"}
(57,1,1) = {"
b
b
b
b
b
b
b
b
b
b
b
b
a
c
c
c
c
c
c
c
c
c
c
c
c
c
c
c
a
a
d
a
a
a
a
a
a
a
a
a
a
a
d
a
a
c
a
b
b
b
b
b
b
b
b
b
b
b
b
b
b
b
b
b
"}
(58,1,1) = {"
b
b
b
b
b
b
b
b
b
b
b
b
a
a
a
a
a
a
a
a
a
a
a
a
a
a
a
c
c
c
c
c
c
c
c
c
c
c
c
c
c
c
c
c
c
c
a
b
b
b
b
b
b
b
b
b
b
b
b
b
b
b
b
b
"}
(59,1,1) = {"
b
b
b
b
b
b
b
b
b
b
b
b
b
b
b
b
b
b
b
b
b
b
b
b
b
b
a
a
a
a
a
a
a
a
a
a
a
a
a
a
a
a
a
a
a
a
a
b
b
b
b
b
b
b
b
b
b
b
b
b
b
b
b
b
"}
(60,1,1) = {"
b
b
b
b
b
b
b
b
b
b
b
b
b
b
b
b
b
b
b
b
b
b
b
b
b
b
b
b
b
b
b
b
b
b
b
b
b
b
b
b
b
b
b
b
b
b
b
b
b
b
b
b
b
b
b
b
b
b
b
b
b
b
b
b
"}
(61,1,1) = {"
b
b
b
b
b
b
b
b
b
b
b
b
b
b
b
b
b
b
b
b
b
b
b
b
b
b
b
b
b
b
b
b
b
b
b
b
b
b
b
b
b
b
b
b
b
b
b
b
b
b
b
b
b
b
b
b
b
b
b
b
b
b
b
b
"}
(62,1,1) = {"
b
b
b
b
b
b
b
b
b
b
b
b
b
b
b
b
b
b
b
b
b
b
b
b
b
b
b
b
b
b
b
b
b
b
b
b
b
b
b
b
b
b
b
b
b
b
b
b
b
b
b
b
b
b
b
b
b
b
b
b
b
b
b
b
"}
(63,1,1) = {"
b
b
b
b
b
b
b
b
b
b
b
b
b
b
b
b
b
b
b
b
b
b
b
b
b
b
b
b
b
b
b
b
b
b
b
b
b
b
b
b
b
b
b
b
b
b
b
b
b
b
b
b
b
b
b
b
b
b
b
b
b
b
b
b
"}
(64,1,1) = {"
b
b
b
b
b
b
b
b
b
b
b
b
b
b
b
b
b
b
b
b
b
b
b
b
b
b
b
b
b
b
b
b
b
b
b
b
b
b
b
b
b
b
b
b
b
b
b
b
b
b
b
b
b
b
b
b
b
b
b
b
b
b
b
b
"}
