//MAP CONVERTED BY dmm2tgm.py THIS HEADER COMMENT PREVENTS RECONVERSION, DO NOT REMOVE
"a" = (
/turf/simulated/wall/dark,
/area/dmm_suite/clear_area)
"b" = (
/turf/dmm_suite/clear_turf,
/area/dmm_suite/clear_area)
"c" = (
/turf/simulated/floor/tile/dark,
/area/dmm_suite/clear_area)
"d" = (
/turf/simulated/floor/plating,
/area/dmm_suite/clear_area)
"e" = (
/obj/marker/spawning/window,
/turf/simulated/floor/plating,
/area/dmm_suite/clear_area)
"f" = (
/obj/structure/interactive/door/airlock/syndicate,
/turf/simulated/floor/plating,
/area/dmm_suite/clear_area)
"g" = (
/obj/structure/smooth/table/reinforced/dark,
/turf/simulated/floor/tile/morphing/red/dark,
/area/dmm_suite/clear_area)
"h" = (
/turf/simulated/floor/tile/morphing/red/dark,
/area/dmm_suite/clear_area)
"i" = (
/obj/structure/interactive/door/airlock/syndicate,
/turf/simulated/floor/tile/morphing/red/dark,
/area/dmm_suite/clear_area)
"j" = (
/obj/structure/smooth/table/reinforced/dark,
/turf/simulated/floor/tile/dark,
/area/dmm_suite/clear_area)
"k" = (
/turf/simulated/floor/tile/dark/er,
/area/dmm_suite/clear_area)
"l" = (
/turf/simulated/floor/tile,
/area/dmm_suite/clear_area)
"m" = (
/obj/structure/interactive/chair{
	icon_state = "chair";
	dir = 4
	},
/turf/simulated/floor/tile/dark,
/area/dmm_suite/clear_area)
"n" = (
/obj/structure/interactive/chair{
	icon_state = "chair";
	dir = 8
	},
/turf/simulated/floor/tile/dark,
/area/dmm_suite/clear_area)
"o" = (
/obj/structure/interactive/chair{
	icon_state = "chair";
	dir = 4
	},
/turf/simulated/floor/tile/morphing/red/dark,
/area/dmm_suite/clear_area)
"p" = (
/obj/structure/interactive/potted_plant/office,
/turf/simulated/floor/tile/morphing/red/dark,
/area/dmm_suite/clear_area)
"q" = (
/obj/structure/interactive/chair,
/turf/simulated/floor/tile/morphing/red/dark,
/area/dmm_suite/clear_area)
"r" = (
/obj/structure/interactive/chair{
	icon_state = "chair";
	dir = 1
	},
/turf/simulated/floor/tile/dark,
/area/dmm_suite/clear_area)
"s" = (
/obj/structure/interactive/chair,
/turf/simulated/floor/tile/dark,
/area/dmm_suite/clear_area)
"t" = (
/obj/structure/interactive/chair{
	icon_state = "chair";
	dir = 8
	},
/turf/simulated/floor/tile/morphing/red/dark,
/area/dmm_suite/clear_area)
"u" = (
/obj/structure/smooth/table/reinforced/dark,
/obj/structure/interactive/misc/computer1,
/turf/simulated/floor/tile/morphing/red/dark,
/area/dmm_suite/clear_area)
"v" = (
/obj/structure/smooth/table/reinforced/dark,
/obj/structure/interactive/misc/computer4,
/turf/simulated/floor/tile/dark,
/area/dmm_suite/clear_area)
"w" = (
/mob/living/advanced/npc/syndicate/double{
	icon_state = "directional";
	dir = 8
	},
/turf/simulated/floor/plating,
/area/dmm_suite/clear_area)
"x" = (
/obj/structure/interactive/chair,
/mob/living/advanced/npc/syndicate/triple,
/turf/simulated/floor/tile/dark,
/area/dmm_suite/clear_area)
"y" = (
/obj/structure/interactive/chair{
	icon_state = "chair";
	dir = 8
	},
/mob/living/advanced/npc/syndicate/quadruple{
	icon_state = "directional";
	dir = 8
	},
/turf/simulated/floor/tile/morphing/red/dark,
/area/dmm_suite/clear_area)
"z" = (
/mob/living/advanced/npc/syndicate,
/turf/simulated/floor/tile/morphing/red/dark,
/area/dmm_suite/clear_area)
"A" = (
/mob/living/advanced/npc/syndicate{
	icon_state = "directional";
	dir = 4
	},
/turf/simulated/floor/tile/morphing/red/dark,
/area/dmm_suite/clear_area)
"B" = (
/mob/living/advanced/npc/syndicate{
	icon_state = "directional";
	dir = 8
	},
/turf/simulated/floor/tile/morphing/red/dark,
/area/dmm_suite/clear_area)
"C" = (
/mob/living/advanced/npc/syndicate{
	icon_state = "directional";
	dir = 1
	},
/turf/simulated/floor/tile/morphing/red/dark,
/area/dmm_suite/clear_area)
"D" = (
/mob/living/advanced/npc/syndicate/scientist,
/turf/simulated/floor/tile/morphing/red/dark,
/area/dmm_suite/clear_area)
"E" = (
/mob/living/advanced/npc/syndicate/scientist{
	icon_state = "directional";
	dir = 8
	},
/turf/simulated/floor/tile/morphing/red/dark,
/area/dmm_suite/clear_area)
"F" = (
/mob/living/advanced/npc/syndicate/scientist{
	icon_state = "directional";
	dir = 4
	},
/turf/simulated/floor/tile/dark,
/area/dmm_suite/clear_area)
"G" = (
/obj/structure/interactive/chair{
	icon_state = "chair";
	dir = 8
	},
/mob/living/advanced/npc/syndicate/scientist{
	icon_state = "directional";
	dir = 8
	},
/turf/simulated/floor/tile/dark,
/area/dmm_suite/clear_area)
"H" = (
/mob/living/advanced/npc/syndicate/scientist,
/turf/simulated/floor/tile/dark,
/area/dmm_suite/clear_area)
"I" = (
/obj/structure/interactive/chair{
	icon_state = "chair";
	dir = 4
	},
/mob/living/advanced/npc/syndicate/scientist{
	icon_state = "directional";
	dir = 4
	},
/turf/simulated/floor/tile/dark,
/area/dmm_suite/clear_area)
"J" = (
/mob/living/advanced/npc/syndicate/scientist{
	icon_state = "directional";
	dir = 1
	},
/turf/simulated/floor/tile/morphing/red/dark,
/area/dmm_suite/clear_area)
"K" = (
/mob/living/advanced/npc/syndicate/scientist{
	icon_state = "directional";
	dir = 1
	},
/turf/simulated/floor/tile/dark,
/area/dmm_suite/clear_area)
"L" = (
/obj/structure/interactive/chair{
	icon_state = "chair";
	dir = 8
	},
/mob/living/advanced/npc/syndicate/double{
	icon_state = "directional";
	dir = 8
	},
/turf/simulated/floor/tile/dark,
/area/dmm_suite/clear_area)
"M" = (
/turf/dmm_suite/no_wall,
/area/dmm_suite/clear_area)
"N" = (
/obj/structure/interactive/lighting/fixture/tube/syndicate{
	icon_state = "preview";
	dir = 4
	},
/turf/simulated/floor/tile/morphing/red/dark,
/area/dmm_suite/clear_area)
"O" = (
/obj/structure/smooth/table/reinforced/dark,
/obj/structure/interactive/lighting/fixture/tube/syndicate{
	icon_state = "preview";
	dir = 4
	},
/turf/simulated/floor/tile/morphing/red/dark,
/area/dmm_suite/clear_area)
"P" = (
/obj/structure/interactive/chair{
	icon_state = "chair";
	dir = 4
	},
/obj/structure/interactive/lighting/fixture/tube/syndicate{
	icon_state = "preview";
	dir = 4
	},
/turf/simulated/floor/tile/morphing/red/dark,
/area/dmm_suite/clear_area)
"Q" = (
/obj/structure/interactive/chair{
	icon_state = "chair";
	dir = 8
	},
/obj/structure/interactive/lighting/fixture/tube/syndicate{
	icon_state = "preview";
	dir = 8
	},
/turf/simulated/floor/tile/morphing/red/dark,
/area/dmm_suite/clear_area)
"R" = (
/obj/structure/interactive/lighting/fixture/tube/syndicate{
	icon_state = "preview";
	dir = 8
	},
/turf/simulated/floor/tile/morphing/red/dark,
/area/dmm_suite/clear_area)
"S" = (
/obj/structure/interactive/lighting/fixture/tube/syndicate{
	icon_state = "preview";
	dir = 8
	},
/turf/simulated/floor/plating,
/area/dmm_suite/clear_area)
"T" = (
/obj/structure/interactive/lighting/fixture/tube/syndicate{
	icon_state = "preview";
	dir = 8
	},
/mob/living/advanced/npc/syndicate{
	icon_state = "directional";
	dir = 8
	},
/turf/simulated/floor/tile/morphing/red/dark,
/area/dmm_suite/clear_area)
"U" = (
/obj/structure/smooth/table/reinforced/dark,
/obj/structure/interactive/lighting/fixture/tube/syndicate{
	icon_state = "preview";
	dir = 8
	},
/turf/simulated/floor/tile/morphing/red/dark,
/area/dmm_suite/clear_area)
"V" = (
/obj/structure/smooth/table/reinforced/dark,
/obj/structure/interactive/lighting/fixture/tube/syndicate,
/turf/simulated/floor/tile/morphing/red/dark,
/area/dmm_suite/clear_area)
"W" = (
/obj/structure/interactive/lighting/fixture/tube/syndicate,
/turf/simulated/floor/tile/morphing/red/dark,
/area/dmm_suite/clear_area)
"X" = (
/obj/structure/interactive/lighting/fixture/tube/syndicate{
	icon_state = "preview";
	dir = 1
	},
/turf/simulated/floor/tile/morphing/red/dark,
/area/dmm_suite/clear_area)
"Y" = (
/obj/structure/smooth/table/reinforced/dark,
/obj/structure/interactive/lighting/fixture/tube/syndicate{
	icon_state = "preview";
	dir = 1
	},
/turf/simulated/floor/tile/morphing/red/dark,
/area/dmm_suite/clear_area)
"Z" = (
/obj/structure/interactive/potted_plant/office,
/obj/structure/interactive/lighting/fixture/tube/syndicate,
/turf/simulated/floor/tile/morphing/red/dark,
/area/dmm_suite/clear_area)

(1,1,1) = {"
b
b
b
b
b
b
b
b
b
b
b
b
b
b
b
b
b
b
b
b
b
b
b
b
b
b
b
b
b
b
b
b
M
M
M
M
M
M
M
M
M
b
b
b
b
b
b
b
b
b
b
b
b
b
b
b
b
b
b
b
b
b
b
b
"}
(2,1,1) = {"
b
b
b
b
b
b
b
b
b
b
b
b
b
b
b
b
b
b
b
b
b
b
b
b
b
b
b
b
b
b
b
b
M
M
M
M
M
M
M
M
M
b
b
b
b
b
b
b
b
b
b
b
b
b
b
b
b
b
b
b
b
b
b
b
"}
(3,1,1) = {"
b
b
b
b
b
b
b
b
b
b
b
b
b
b
b
b
b
b
b
b
b
b
b
b
b
b
b
b
b
b
b
b
M
M
M
M
M
M
M
M
M
M
b
b
b
b
b
b
b
b
b
b
b
b
b
b
b
b
b
b
b
b
b
b
"}
(4,1,1) = {"
b
b
b
b
b
b
b
b
b
b
b
b
b
b
b
b
b
b
b
b
b
b
b
b
b
b
b
b
b
b
b
b
M
M
M
M
M
M
M
M
M
M
b
b
b
b
b
b
b
b
b
b
b
b
b
b
b
b
b
b
b
b
b
b
"}
(5,1,1) = {"
b
b
b
b
b
b
b
b
b
b
b
b
b
b
b
b
b
b
b
b
b
b
b
b
b
b
b
b
b
b
b
M
M
M
M
M
M
M
M
M
M
M
M
b
b
b
b
b
b
b
b
b
b
b
b
b
b
b
b
b
b
b
b
b
"}
(6,1,1) = {"
b
b
b
b
b
b
b
b
b
b
b
b
b
b
b
b
b
b
b
b
b
b
b
b
b
b
b
b
b
b
b
M
M
M
M
M
M
M
M
M
M
M
M
M
b
b
b
b
b
b
b
b
b
b
b
b
b
b
b
b
b
b
b
b
"}
(7,1,1) = {"
b
b
b
b
b
b
b
b
b
b
b
b
b
b
b
b
b
b
b
b
b
b
b
b
b
b
b
b
b
b
M
M
M
M
M
M
M
M
M
M
M
M
M
M
M
b
b
b
b
b
b
b
b
b
b
b
b
b
b
b
b
b
b
b
"}
(8,1,1) = {"
b
b
b
b
b
b
b
b
b
b
b
b
b
b
b
b
b
b
b
b
b
b
b
b
b
b
b
b
b
b
M
M
M
M
M
M
M
M
M
M
M
M
M
M
M
b
b
b
b
b
b
b
b
b
b
b
b
b
b
b
b
b
b
b
"}
(9,1,1) = {"
b
b
b
b
b
b
b
b
b
b
b
b
b
b
b
b
b
b
b
b
b
b
b
b
b
b
b
b
b
M
M
M
d
d
d
d
d
d
d
d
d
M
M
M
M
M
b
b
b
b
b
b
b
b
b
b
b
b
b
b
b
b
b
b
"}
(10,1,1) = {"
b
b
b
b
b
b
b
b
b
b
b
b
b
b
b
b
b
b
b
b
b
b
b
b
b
b
b
b
b
M
M
M
d
d
d
d
d
d
d
d
d
M
M
M
M
M
b
b
b
b
b
b
b
b
b
b
b
b
b
b
b
b
b
b
"}
(11,1,1) = {"
b
b
b
b
b
b
b
b
b
b
b
b
b
b
b
b
b
b
b
b
b
b
b
b
b
b
b
b
M
M
M
M
S
w
d
d
S
d
d
w
S
M
M
M
M
M
M
b
b
b
b
b
b
b
b
b
b
b
b
b
b
b
b
b
"}
(12,1,1) = {"
b
b
b
b
b
b
b
b
b
b
b
b
b
b
b
b
b
b
b
b
b
b
b
b
b
b
b
b
M
M
M
M
a
a
i
i
a
i
i
a
a
M
M
M
M
M
M
b
b
b
b
b
b
b
b
b
b
b
b
b
b
b
b
b
"}
(13,1,1) = {"
b
b
b
b
b
b
b
b
b
b
b
b
b
b
b
b
b
b
b
b
b
b
b
b
b
b
b
b
M
a
a
a
a
p
h
h
N
h
h
p
a
a
a
a
M
M
M
M
b
b
b
b
b
b
b
b
b
b
b
b
b
b
b
b
"}
(14,1,1) = {"
b
b
b
b
b
b
b
b
b
b
b
b
b
b
b
b
b
b
b
b
b
b
b
b
b
b
b
b
M
a
p
N
g
h
c
c
c
c
c
h
u
N
p
a
M
M
M
M
b
b
b
b
b
b
b
b
b
b
b
b
b
b
b
b
"}
(15,1,1) = {"
b
b
b
b
b
b
b
b
b
b
b
b
b
b
b
b
b
b
b
b
b
b
b
b
b
b
b
b
M
a
h
x
j
c
c
c
c
c
c
c
v
c
h
a
M
M
M
b
b
b
b
b
b
b
b
b
b
b
b
b
b
b
b
b
"}
(16,1,1) = {"
b
b
b
b
b
b
b
b
b
b
b
b
b
b
b
b
b
b
b
b
b
b
b
b
b
b
b
b
M
a
h
c
j
c
c
c
c
c
c
c
j
L
h
a
M
M
b
b
b
b
b
b
b
b
b
b
b
b
b
b
b
b
b
b
"}
(17,1,1) = {"
b
b
b
b
b
b
b
b
b
b
b
b
b
b
b
b
b
b
b
b
b
b
b
b
b
b
b
b
M
a
p
h
g
h
c
c
c
c
c
h
g
h
p
a
M
b
b
b
b
b
b
b
b
b
b
b
b
b
b
b
b
b
b
b
"}
(18,1,1) = {"
b
b
b
b
b
b
b
b
b
b
b
b
b
b
b
b
b
b
b
b
b
b
b
b
b
b
b
b
b
a
a
a
a
W
c
c
c
c
c
h
a
a
a
a
b
b
b
b
b
b
b
b
b
b
b
b
b
b
b
b
b
b
b
b
"}
(19,1,1) = {"
b
b
b
b
b
b
b
b
b
b
b
b
b
b
b
b
b
b
b
b
b
b
b
b
b
b
b
b
b
b
b
b
a
p
h
h
R
h
h
p
a
b
b
b
b
b
b
b
b
b
b
b
b
b
b
b
b
b
b
b
b
b
b
b
"}
(20,1,1) = {"
b
b
b
b
b
b
b
b
b
b
b
b
a
a
a
a
a
a
a
a
a
a
a
a
a
a
a
a
a
a
a
a
a
a
i
i
a
i
i
a
a
a
a
b
b
b
b
b
b
b
b
b
b
b
b
b
b
b
b
b
b
b
b
b
"}
(21,1,1) = {"
b
b
b
b
b
b
b
b
b
b
b
b
a
d
d
d
d
d
d
d
d
d
d
d
d
d
d
d
d
d
f
h
N
p
h
h
h
h
h
p
P
o
a
a
a
a
a
a
a
a
b
b
b
b
b
b
b
b
b
b
b
b
b
b
"}
(22,1,1) = {"
b
b
b
b
b
b
b
b
b
b
b
b
a
d
d
d
d
a
a
a
a
a
a
a
a
a
a
a
a
a
a
h
c
c
c
c
c
c
c
c
c
h
a
g
h
N
E
h
g
a
b
b
b
b
b
b
b
b
b
b
b
b
b
b
"}
(23,1,1) = {"
b
b
b
b
b
b
b
b
b
b
b
b
a
d
d
d
d
a
g
p
N
h
h
h
h
h
p
O
g
g
a
h
c
k
k
k
k
k
k
k
c
h
e
g
c
c
c
c
g
a
b
b
b
b
b
b
b
b
b
b
b
b
b
b
"}
(24,1,1) = {"
b
b
b
b
b
b
b
b
b
b
b
b
a
d
d
d
d
a
g
r
c
c
c
c
c
c
c
c
s
g
e
D
c
k
l
l
l
k
l
k
c
h
e
g
n
c
c
c
g
a
b
b
b
b
b
b
b
b
b
b
b
b
b
b
"}
(25,1,1) = {"
b
b
b
b
b
b
b
b
b
b
b
b
a
d
d
d
d
a
g
c
c
j
j
j
j
j
c
c
c
g
e
h
c
k
l
k
l
k
l
k
c
h
e
g
c
c
c
c
g
a
b
b
b
b
b
b
b
b
b
b
b
b
b
b
"}
(26,1,1) = {"
b
b
b
b
b
b
b
b
b
b
b
b
a
d
d
d
d
a
V
c
c
j
c
c
c
j
c
c
c
g
e
h
c
k
l
k
l
k
l
k
c
h
e
g
c
c
c
c
g
a
b
b
b
b
b
b
b
b
b
b
b
b
b
b
"}
(27,1,1) = {"
b
b
b
b
b
b
b
b
b
b
b
b
a
d
d
d
d
a
g
c
c
j
j
j
j
j
c
c
c
g
e
h
c
k
l
k
l
l
l
k
c
h
e
g
c
c
c
c
g
a
b
b
b
b
b
b
b
b
b
b
b
b
b
b
"}
(28,1,1) = {"
b
b
b
b
b
b
b
b
b
b
b
b
a
d
d
d
d
a
z
c
c
c
c
n
G
c
c
c
c
h
a
W
c
k
k
k
k
k
k
k
c
h
a
D
c
c
c
K
g
a
b
b
b
b
b
b
b
b
b
b
b
b
b
b
"}
(29,1,1) = {"
b
b
b
b
b
b
b
b
b
b
b
b
a
d
d
d
d
f
h
c
c
c
c
c
c
c
c
c
c
h
i
h
c
c
c
c
c
c
c
c
c
h
i
h
c
c
c
c
g
a
b
b
b
b
b
b
b
b
b
b
b
b
b
b
"}
(30,1,1) = {"
b
b
b
b
b
b
b
b
b
b
b
b
a
d
d
d
d
a
p
h
R
h
h
E
h
h
h
R
h
p
a
t
Q
y
h
c
h
h
E
h
R
p
a
h
h
h
R
t
g
a
b
b
b
b
b
b
b
b
b
b
b
b
b
b
"}
(31,1,1) = {"
b
b
b
b
b
b
b
b
b
b
b
b
a
d
d
d
a
a
a
a
a
a
a
a
a
a
a
a
a
a
a
a
a
a
h
c
h
a
a
a
a
a
a
a
a
f
a
a
a
a
b
b
b
b
b
b
b
b
b
b
b
b
b
b
"}
(32,1,1) = {"
b
b
b
b
b
b
b
b
b
b
b
b
a
d
d
d
a
g
O
g
g
g
O
g
a
g
O
g
g
g
g
O
g
e
h
c
X
a
g
O
g
g
O
g
a
d
a
b
b
b
b
b
b
b
b
b
b
b
b
b
b
b
b
b
"}
(33,1,1) = {"
b
b
b
b
b
b
b
b
b
b
b
b
a
d
d
d
a
q
c
c
c
c
c
h
a
g
r
c
c
F
c
c
g
e
h
c
h
e
A
c
c
c
c
p
a
d
a
b
b
b
b
b
b
b
b
b
b
b
b
b
b
b
b
b
"}
(34,1,1) = {"
b
b
b
b
b
b
b
b
b
b
b
b
a
d
d
d
a
D
c
c
c
c
c
h
a
g
c
c
c
c
c
c
h
e
h
c
h
e
h
c
m
I
c
h
a
d
a
b
b
b
b
b
b
b
b
b
b
b
b
b
b
b
b
b
"}
(35,1,1) = {"
b
b
b
b
b
b
b
b
b
b
b
b
a
d
d
d
a
h
h
h
h
h
R
p
a
g
c
c
c
c
c
c
h
a
h
c
h
e
h
c
j
j
c
X
a
d
a
b
b
b
b
b
b
b
b
b
b
b
b
b
b
b
b
b
"}
(36,1,1) = {"
b
b
b
b
b
b
b
b
b
b
b
b
a
d
d
d
a
a
f
a
a
a
a
a
a
z
c
c
c
c
c
c
h
i
h
c
h
e
h
c
j
j
c
h
a
d
a
b
b
b
b
b
b
b
b
b
b
b
b
b
b
b
b
b
"}
(37,1,1) = {"
b
b
b
b
b
b
b
b
b
b
b
b
a
d
d
d
d
d
d
d
d
d
d
d
f
h
R
h
h
h
h
R
p
a
W
c
h
e
h
c
j
j
c
h
a
d
a
b
b
b
b
b
b
b
b
b
b
b
b
b
b
b
b
b
"}
(38,1,1) = {"
b
b
b
b
b
b
b
b
b
b
b
b
a
d
a
a
a
a
a
a
a
a
f
a
a
a
a
a
a
a
a
a
a
a
h
c
h
e
h
c
G
n
c
h
a
d
a
b
b
b
b
b
b
b
b
b
b
b
b
b
b
b
b
b
"}
(39,1,1) = {"
b
b
b
b
b
b
b
b
b
b
b
b
a
d
a
g
g
O
g
g
a
g
h
h
N
h
g
g
a
p
A
P
g
a
h
c
h
e
h
c
c
c
c
h
a
d
a
b
b
b
b
b
b
b
b
b
b
b
b
b
b
b
b
b
"}
(40,1,1) = {"
b
b
b
b
b
b
b
b
b
b
b
b
a
d
f
h
F
n
c
A
a
g
c
c
c
c
c
g
a
h
c
c
g
a
h
c
h
e
h
c
c
c
c
h
a
d
a
b
b
b
b
b
b
b
b
b
b
b
b
b
b
b
b
b
"}
(41,1,1) = {"
b
b
b
b
b
b
b
b
b
b
b
b
a
d
a
h
c
c
c
h
a
g
H
c
c
c
s
g
a
h
c
c
g
a
h
c
h
e
h
c
m
m
c
h
a
d
a
b
b
b
b
b
b
b
b
b
b
b
b
b
b
b
b
b
"}
(42,1,1) = {"
b
b
b
b
b
b
b
b
b
b
b
b
a
d
a
o
c
c
c
h
a
V
c
c
c
c
c
g
a
h
c
c
g
a
h
c
h
e
h
c
j
j
c
X
a
d
a
b
b
b
b
b
b
b
b
b
b
b
b
b
b
b
b
b
"}
(43,1,1) = {"
b
b
b
b
b
b
b
b
b
b
b
b
a
d
a
g
c
c
c
h
a
g
c
c
c
c
c
g
a
D
c
c
Y
a
h
c
h
e
h
c
j
j
c
h
a
d
a
b
b
b
b
b
b
b
b
b
b
b
b
b
b
b
b
b
"}
(44,1,1) = {"
b
b
b
b
b
b
b
b
b
b
b
b
a
d
a
g
h
R
h
p
a
g
h
h
h
T
h
g
a
h
h
h
g
a
h
c
X
a
h
c
j
j
c
C
a
d
a
b
b
b
b
b
b
b
b
b
b
b
b
b
b
b
b
b
"}
(45,1,1) = {"
b
b
b
b
b
b
b
b
b
b
b
b
a
d
a
a
a
a
i
a
a
a
e
e
e
a
i
a
a
a
i
a
a
a
h
c
h
i
h
c
n
n
c
h
f
d
a
b
b
b
b
b
b
b
b
b
b
b
b
b
b
b
b
b
"}
(46,1,1) = {"
b
b
b
b
b
b
b
b
b
b
b
b
a
d
a
p
z
h
h
h
N
h
h
h
h
N
h
h
h
h
h
h
h
h
h
c
h
a
h
R
h
h
R
p
a
d
a
b
b
b
b
b
b
b
b
b
b
b
b
b
b
b
b
b
"}
(47,1,1) = {"
b
b
b
b
b
b
b
b
b
b
b
b
a
d
f
h
c
c
c
c
c
c
c
c
c
c
c
c
c
c
c
c
c
c
c
c
h
a
a
a
a
a
a
a
a
d
a
b
b
b
b
b
b
b
b
b
b
b
b
b
b
b
b
b
"}
(48,1,1) = {"
b
b
b
b
b
b
b
b
b
b
b
b
a
d
a
Z
h
h
h
h
h
h
h
h
h
h
h
h
h
h
h
h
h
R
h
B
h
f
d
d
d
d
d
d
d
d
a
b
b
b
b
b
b
b
b
b
b
b
b
b
b
b
b
b
"}
(49,1,1) = {"
b
b
b
b
b
b
b
b
b
b
b
b
a
d
a
a
e
e
e
e
e
e
e
e
e
a
i
a
a
a
e
e
e
a
i
a
a
a
a
a
a
a
a
a
a
d
a
b
b
b
b
b
b
b
b
b
b
b
b
b
b
b
b
b
"}
(50,1,1) = {"
b
b
b
b
b
b
b
b
b
b
b
b
a
d
a
g
g
g
g
g
g
g
g
g
g
N
h
p
a
g
g
h
h
N
h
g
a
g
O
g
g
g
O
g
a
d
a
b
b
b
b
b
b
b
b
b
b
b
b
b
b
b
b
b
"}
(51,1,1) = {"
b
b
b
b
b
b
b
b
b
b
b
b
a
d
a
V
G
c
c
c
c
F
c
c
c
c
c
h
a
g
c
c
c
c
c
g
a
g
n
c
c
c
c
g
a
d
a
b
b
b
b
b
b
b
b
b
b
b
b
b
b
b
b
b
"}
(52,1,1) = {"
b
b
b
b
b
b
b
b
b
b
b
b
a
d
a
g
c
c
c
c
c
c
c
c
c
c
c
h
a
g
c
c
c
c
s
g
a
g
c
c
c
c
c
g
a
d
a
b
b
b
b
b
b
b
b
b
b
b
b
b
b
b
b
b
"}
(53,1,1) = {"
b
b
b
b
b
b
b
b
b
b
b
b
a
d
a
h
c
c
c
c
c
c
c
c
c
c
c
g
a
g
c
c
c
c
c
g
a
D
c
c
c
c
c
J
a
d
a
b
b
b
b
b
b
b
b
b
b
b
b
b
b
b
b
b
"}
(54,1,1) = {"
b
b
b
b
b
b
b
b
b
b
b
b
a
d
a
h
c
c
c
c
c
c
c
c
c
c
s
g
a
g
r
c
c
c
c
h
a
h
c
c
c
c
c
h
a
d
a
b
b
b
b
b
b
b
b
b
b
b
b
b
b
b
b
b
"}
(55,1,1) = {"
b
b
b
b
b
b
b
b
b
b
b
b
a
d
a
p
h
R
h
h
h
h
E
g
g
U
g
g
a
g
c
c
c
c
c
h
i
h
c
c
c
c
c
X
a
d
a
b
b
b
b
b
b
b
b
b
b
b
b
b
b
b
b
b
"}
(56,1,1) = {"
b
b
b
b
b
b
b
b
b
b
b
b
a
d
a
a
f
a
a
a
a
a
a
a
a
a
a
a
a
g
h
h
B
R
h
p
a
t
R
E
h
h
h
p
a
d
a
b
b
b
b
b
b
b
b
b
b
b
b
b
b
b
b
b
"}
(57,1,1) = {"
b
b
b
b
b
b
b
b
b
b
b
b
a
d
d
d
d
d
d
d
d
d
d
d
d
d
d
d
a
a
f
a
a
a
a
a
a
a
a
a
a
a
f
a
a
d
a
b
b
b
b
b
b
b
b
b
b
b
b
b
b
b
b
b
"}
(58,1,1) = {"
b
b
b
b
b
b
b
b
b
b
b
b
a
a
a
a
a
a
a
a
a
a
a
a
a
a
a
d
d
d
d
d
d
d
d
d
d
d
d
d
d
d
d
d
d
d
a
b
b
b
b
b
b
b
b
b
b
b
b
b
b
b
b
b
"}
(59,1,1) = {"
b
b
b
b
b
b
b
b
b
b
b
b
b
b
b
b
b
b
b
b
b
b
b
b
b
b
a
a
a
a
a
a
a
a
a
a
a
a
a
a
a
a
a
a
a
a
a
b
b
b
b
b
b
b
b
b
b
b
b
b
b
b
b
b
"}
(60,1,1) = {"
b
b
b
b
b
b
b
b
b
b
b
b
b
b
b
b
b
b
b
b
b
b
b
b
b
b
b
b
b
b
b
b
b
b
b
b
b
b
b
b
b
b
b
b
b
b
b
b
b
b
b
b
b
b
b
b
b
b
b
b
b
b
b
b
"}
(61,1,1) = {"
b
b
b
b
b
b
b
b
b
b
b
b
b
b
b
b
b
b
b
b
b
b
b
b
b
b
b
b
b
b
b
b
b
b
b
b
b
b
b
b
b
b
b
b
b
b
b
b
b
b
b
b
b
b
b
b
b
b
b
b
b
b
b
b
"}
(62,1,1) = {"
b
b
b
b
b
b
b
b
b
b
b
b
b
b
b
b
b
b
b
b
b
b
b
b
b
b
b
b
b
b
b
b
b
b
b
b
b
b
b
b
b
b
b
b
b
b
b
b
b
b
b
b
b
b
b
b
b
b
b
b
b
b
b
b
"}
(63,1,1) = {"
b
b
b
b
b
b
b
b
b
b
b
b
b
b
b
b
b
b
b
b
b
b
b
b
b
b
b
b
b
b
b
b
b
b
b
b
b
b
b
b
b
b
b
b
b
b
b
b
b
b
b
b
b
b
b
b
b
b
b
b
b
b
b
b
"}
(64,1,1) = {"
b
b
b
b
b
b
b
b
b
b
b
b
b
b
b
b
b
b
b
b
b
b
b
b
b
b
b
b
b
b
b
b
b
b
b
b
b
b
b
b
b
b
b
b
b
b
b
b
b
b
b
b
b
b
b
b
b
b
b
b
b
b
b
b
"}
