"a" = (/turf/dmm_suite/clear_turf,/area/dmm_suite/clear_area)
"b" = (/obj/marker/map_node/x2,/turf/simulated/floor/xeno,/area/mission/prefab/misc/xenomorph_hive)
"c" = (/turf/simulated/floor/xeno,/area/mission/prefab/misc/xenomorph_hive)
"d" = (/turf/simulated/wall/xeno,/area/mission/prefab/misc/xenomorph_hive)
"e" = (/obj/structure/interactive/crate/chest/filled,/turf/simulated/floor/xeno,/area/mission/prefab/misc/xenomorph_hive)
"f" = (/mob/living/simple/xeno/drone,/turf/simulated/floor/xeno,/area/mission/prefab/misc/xenomorph_hive)
"g" = (/mob/living/simple/xeno/hunter,/turf/simulated/floor/xeno,/area/mission/prefab/misc/xenomorph_hive)
"h" = (/mob/living/simple/xeno/sentinel,/turf/simulated/floor/xeno,/area/mission/prefab/misc/xenomorph_hive)
"i" = (/obj/marker/map_node,/turf/simulated/floor/xeno,/area/mission/prefab/misc/xenomorph_hive)
"j" = (/obj/marker/map_node/x3,/turf/simulated/floor/xeno,/area/mission/prefab/misc/xenomorph_hive)
"k" = (/turf/dmm_suite/no_wall,/area/dmm_suite/clear_area)
"l" = (/obj/marker/map_node/x4,/turf/simulated/floor/xeno,/area/mission/prefab/misc/xenomorph_hive)
"m" = (/obj/marker/objective_spawn,/turf/simulated/floor/xeno,/area/mission/prefab/misc/xenomorph_hive)
"n" = (/mob/living/simple/xeno/queen,/turf/simulated/floor/xeno,/area/mission/prefab/misc/xenomorph_hive)
"o" = (/obj/marker/lobby,/turf/simulated/floor/xeno,/area/mission/prefab/misc/xenomorph_hive)
"p" = (/turf/dmm_suite/clear_turf,/area/mission/prefab/misc/xenomorph_hive)
"q" = (/obj/marker/map_node/x2,/turf/dmm_suite/no_wall,/area/dmm_suite/clear_area)
"r" = (/obj/marker/map_node/x3,/turf/dmm_suite/no_wall,/area/dmm_suite/clear_area)
"s" = (/obj/marker/smart_clear_turf,/turf/dmm_suite/no_wall,/area/dmm_suite/clear_area)
"t" = (/obj/marker/map_node,/mob/living/simple/xeno/hunter,/turf/simulated/floor/xeno,/area/mission/prefab/misc/xenomorph_hive)
"x" = (/obj/item/weapon/melee/tool/welder,/turf/simulated/floor/xeno,/area/dmm_suite/clear_area)
"B" = (/turf/simulated/floor/xeno,/area/dmm_suite/clear_area)
"E" = (/obj/item/clothing/back/flamethrower{contraband = 1;desc_extended = "A bulky back-mounted canister with a flamethrower attached. The attached flamethrower spews flames that ignite anything they hit and the ground they pass. This one is caked in Xenomorph resin.";name = "resin-coated flamethrower canister"},/obj/item/weapon/ranged/energy/flamethrower{contraband = 1;name = "resin-coated flamethrower"},/turf/simulated/floor/xeno,/area/dmm_suite/clear_area)
"H" = (/obj/structure/interactive/crate/chest/filled,/turf/simulated/floor/xeno,/area/dmm_suite/clear_area)
"M" = (/mob/living/simple/xeno/hunter,/turf/simulated/floor/xeno,/area/dmm_suite/clear_area)
"P" = (/turf/simulated/wall/xeno,/area/dmm_suite/clear_area)
"S" = (/mob/living/simple/xeno/drone,/turf/simulated/floor/xeno,/area/dmm_suite/clear_area)

(1,1,1) = {"
aaaaaaaaaaaaaaaaaaaaaaaaaaaaaaaaaaaaaaaaaaaaaaaaaaaaaaaaaaaaaaaa
aaaaaaaaaaaaaaaaaaaaaaaaaaaaaaaaaaaaaaaaaaaaaaaaaaaaaaaaaaaaaaaa
aaaaaaaaaaaaaaaaaaaaaaaaaaaaaaaakkkkaaaaaaaaaaaaaaaaaaaaaaaaaaaa
aaaaaaaaaaaaaaaaaaaaaaaaaaaaaaakkbckkkaaaaaaaaaaaaaaaaaaaaaaaaaa
aaaaaaaaaaaaaaaaaaaaaaaaaaaaaakkccccskaaaaaaaaaaaaaaaaaaaaaaaaaa
aaaaaaaaaaaaaaaaaaaaaaaaaaaaakkcccccckaaaaaaaaaaaaaaaaaaaaaaaaaa
aaaaaaaaaaaaaaaaaaaaaaaaakkkkkbcccccckaaaaaaaaaaaaaaaaaaaaaaaaaa
aaaaaakkdddddddddaaaaaaaaaddcccccddcckaaaaaaaaaaaaaaaaaaaaaaaaaa
aaaaakksdcccccccdaaaaaaaaadcccdddedckkaaaaaaaaaaaaaaaaaaaaaaaaaa
aaaakkkcdcccccccdaaaaaaaaadcccfcccdkkaaaaaaaaaaaaaaaaaaaaaaaaaaa
aaaakkccccccccccdaaaaaaaaadcccccccdaaaaaaaaaaaaaaaaaaaaaaaaaaaaa
aaaakkccccccfcccdaaaaaaaaadddcbcccdaakkkkkkkkkkkkkaaaaaaaaaaaaaa
aaaakkcbccgcccccdddddddaaadccgccccddddddddddddddkkaaaaaaaaaaaaaa
aaaakkccccccbccccccccedaaadcccccccccccccdccccccdckkkaaaaaaaaaaaa
aaaakkccccccchccccccccdaaadccccccccbccccdccccccccckkaaaaaaaaaaaa
aaaakkkccccccccbfcccccdaaadddcccfcccccgicifcbcdcccbkaaaaaaaaaaaa
aaaakkksdcccccccccccccdaaaaadcccicccccccdcccccccccckaaaaaaaaaaaa
aaaaaakkdddddcccccicccdaaaaaddddcddddcccdccccccdccckaaaaaaaaaaaa
aaaaaaakkkkkddddddcddddddaaadcccicccddddddddddddccskaaaaaaaaaaaa
aaaaaaakkkkkdcccccicccccdaaadcccccccdaaakkkkccccckkkaaaaaaaaaaaa
aaaaaaaaaaaadccccgccccccdaaadcccbfccddddkkkkkkkkkkkkaaaaaaaaaaaa
aaaaaaaaaaaadccccccfccccdaaadcccccccdccdddddddddddkkaaaaaaaaaaaa
aaaaaaddddddddddccjcccccdaaadcccccciciccccccccccedkaaaaaaaaaaaaa
aaaaaadeccccccdcccccccccdaaadcccciccdcccccfccccccdddddaaaaaaaaaa
aaaaaadccccfccdcccccccccdaaadddddcdddccccccccccccccccdaaaaaaaaaa
aaaaaadcccbccicihcicccccdaaaaaadcicefccbcccccccccccccdaaaaaaaaaa
aaaaaadcccccccdcciccccccdaaaaaadcccccccchcccccfcccjccdaaaaaaaaaa
aaaaaadgccccccdddcdddddddaaaaaadchcccccccccclcfccccccdaaaaaaaaaa
aaaaaadddddddddcciceddddddaaaaadcccccccccccccccccccccdaaaaaaaaaa
aaaaaaaaaaaaaadccgcccccccdddddddmccccnoccccfcccccccccdaaaaaaaaaa
aaaaaaaaaaaaaadccicccccccccccdcccccccccccccccccccccccdaaaaaaaaaa
aaaaaaaaakkkkkdcccccchcbcccccdccchccccccccccccddddddddaaaaaaaaaa
aaaaaaaakscdddddddddccccccgciciccbcgcclcccccccdkkkkkkkkaaaaaaaaa
aaaaaaaakccdcccccccdcccccccccdcccccccccchccddddkkkaaaaaaaaaaaaaa
aaaaaaakkccccccccccdchcccccccdcccccccccccccdkkkkkaaaaaaaaaaaaaaa
aaaaaaakkcccccccccfdcccccdddddddddcccciccccdkkaaaaaaaaaakkkkkaka
aaaaaaakcjcccfjccciciccccdpppppppdddddcddddddddddddddakkkccckkka
aaaaaaakcccccccccccdcccdddddddddddecccicdcccccccccccdkkkcccccskk
aaaaaaakcccccccccccdcccdadccccccccccccccdcccccccccccddddddddcckk
aaaaaaaksccdcccccccdcccdadccccccccfccccddcccccccccccdccccccdccck
aaaaaaaakkcdddddddddddddadcccccccccccccdcccccchcccccdcdccgccccck
aaaaaaaakkkkkkkkaaaaaaaaadccfcclhccccciciccccclcccficidcbccbccbk
aaaaaaaaaaaaaaaaaaaaaaaaadcccccccccccccdccccccccccccdcdccccccckk
aaaaaaaaaaaaaaaaaaaaaaaaadcccccccccccccdcccfccccccccdccccccdckka
aaaaaaaaaaaaaaaaaaaaaaaaadcccccccccccccdccccccccccccddddddddkkka
aaaaaaaaaaaaaaaaaaaaaaaaadcccgcccfcccccdccccciccccccdkkkkkkkkkkk
aaaaaaaaaaaaaaaaaaaaaaaaadcccciccccccccddddddcdddddddkkkkkkkkkka
aaaaaaaaaaaaaaaaaaaaaaaaadddddcdddddddddadecctccdkakkkkkkkkkkaaa
aaaaaakkkkkkkkkaaaaaaaaaadccccieddddaaaakdccccccdkaaaaakkkkkkaaa
aaaaakkkkkkkkkkaaaaaaakkkdcccfcccccdaaakkddcbcdddkkaaaaakkkkaaaa
aaaakkkkkPPPkkkaaaaakkkkkdcccccccccdaaakkdccccdcdckkaaaaaaaaaaaa
aaaakkkPPPPPPPkkaaakkkkkkdcccccccccdaaakkdcccfdcdckkaaaaaaaaaaaa
aaakkPPPPBBPPPkkaaakkkkkkdcccciccccdaaakkdccccccdckkaaaaaaaaaaaa
aaakkPPxSBBSEPkkaaakkqkkddddddcdddddaaakkdddccbcdckkaaaaaaaaaaaa
aaakkPPBBBBBBPkkaakkkkkcdccccdicccedaaakkkcccccccckkaaaaaaaaaaaa
aaakkPHBBBSBBBkkakkkkkccdccccccgcccdaaakkkkccccccskkaaaaaaaaaaaa
aaakkPBBPPPBBBkkBkkkscccdddddcccccfdaaaakkkscccckkkaaaaaaaaaaaaa
aaakkPPPPPPBBBkkakkkkcccdcccdddccccdaaaaakkkkkkkkkaaaaaaaaaaaaaa
aaakkkPPkkPBBBkkaBkkkqccccbcfccccccdaaaaakkkkkrkkkkaaaaaaaaaaaaa
aaaakkkkkkPMBBBkakkkkkccccccccccdccdaaaaaakkkkkkkaaaaaaaaaaaaaaa
aaaakkkkkkPPPBBkaakkkkkcdcccccccddddaaaaaaakkkkkkkkaaaaaaaaaaaaa
aaaaaaaakkkkPPPkaaakkkkkdddddddddaaaaaaaaaaaaaaaaaaaaaaaaaaaaaaa
aaaaaaaaaakkkkkkaaaaakkkkkkkkkaaaaaaaaaaaaaaaaaaaaaaaaaaaaaaaaaa
aaaaaaaaaaaaaaaaaaaaaaaaaaaaaaaaaaaaaaaaaaaaaaaaaaaaaaaaaaaaaaaa
"}
