//MAP CONVERTED BY dmm2tgm.py THIS HEADER COMMENT PREVENTS RECONVERSION, DO NOT REMOVE
"a" = (
/turf/simulated/floor/sidewalk,
/area/dmm_suite/clear_area)
"b" = (
/obj/decal/road_marking/dotted_line{
	icon_state = "1";
	dir = 4
	},
/turf/simulated/floor/road,
/area/dmm_suite/clear_area)
"c" = (
/obj/marker/blob,
/turf/simulated/floor/road,
/area/dmm_suite/clear_area)
"e" = (
/obj/structure/interactive/stopsign{
	icon_state = "sign";
	dir = 8
	},
/turf/simulated/floor/sidewalk,
/area/dmm_suite/clear_area)
"f" = (
/obj/decal/road_marking/solid_stop{
	icon_state = "1";
	dir = 8
	},
/turf/simulated/floor/road,
/area/dmm_suite/clear_area)
"g" = (
/obj/decal/road_marking/solid_cross,
/turf/simulated/floor/road,
/area/dmm_suite/clear_area)
"h" = (
/obj/decal/road_marking/solid_cross,
/turf/dmm_suite/clear_turf,
/area/dmm_suite/clear_area)
"i" = (
/obj/decal/road_marking/solid_line/offset/yellow,
/turf/simulated/floor/road,
/area/dmm_suite/clear_area)
"k" = (
/obj/decal/road_marking/dotted_line/half{
	icon_state = "1";
	dir = 8
	},
/turf/simulated/floor/road,
/area/dmm_suite/clear_area)
"o" = (
/obj/structure/interactive/lighting/roadlamp{
	icon_state = "lamp";
	dir = 8
	},
/turf/simulated/floor/sidewalk,
/area/dmm_suite/clear_area)
"p" = (
/obj/decal/road_marking/solid_line/offset/yellow{
	icon_state = "1";
	dir = 1
	},
/turf/simulated/floor/road,
/area/dmm_suite/clear_area)
"q" = (
/obj/decal/road_marking/solid_cross{
	icon_state = "1";
	dir = 4
	},
/turf/simulated/floor/road,
/area/dmm_suite/clear_area)
"r" = (
/turf/simulated/floor/road,
/area/dmm_suite/clear_area)
"t" = (
/obj/decal/road_marking/solid_stop{
	icon_state = "1";
	dir = 4
	},
/turf/simulated/floor/road,
/area/dmm_suite/clear_area)
"u" = (
/obj/decal/road_marking/solid_stop{
	icon_state = "1";
	dir = 1
	},
/turf/simulated/floor/road,
/area/dmm_suite/clear_area)
"v" = (
/obj/structure/interactive/lighting/roadlamp,
/obj/marker/prefab/city/parking{
	dir = 9
	},
/turf/dmm_suite/clear_turf,
/area/dmm_suite/clear_area)
"x" = (
/obj/decal/road_marking/solid_line{
	dir = 10
	},
/turf/simulated/floor/road,
/area/dmm_suite/clear_area)
"y" = (
/obj/decal/road_marking/dotted_line/half{
	icon_state = "1";
	dir = 1
	},
/obj/decal/road_marking/dotted_line/half{
	icon_state = "1";
	dir = 4
	},
/turf/simulated/floor/road,
/area/dmm_suite/clear_area)
"z" = (
/turf/dmm_suite/clear_turf,
/area/dmm_suite/clear_area)
"A" = (
/obj/marker/prefab/city/store{
	dir = 1
	},
/turf/dmm_suite/clear_turf,
/area/dmm_suite/clear_area)
"F" = (
/obj/structure/interactive/lighting/roadlamp{
	icon_state = "lamp";
	dir = 4
	},
/turf/dmm_suite/clear_turf,
/area/dmm_suite/clear_area)
"G" = (
/obj/structure/interactive/lighting/roadlamp{
	icon_state = "lamp";
	dir = 1
	},
/turf/simulated/floor/sidewalk,
/area/dmm_suite/clear_area)
"H" = (
/obj/marker/prefab/city/store{
	dir = 4
	},
/turf/dmm_suite/clear_turf,
/area/dmm_suite/clear_area)
"I" = (
/obj/decal/road_marking/solid_line{
	dir = 5
	},
/turf/simulated/floor/road,
/area/dmm_suite/clear_area)
"L" = (
/obj/decal/road_marking/solid_line/offset/yellow{
	icon_state = "1";
	dir = 4
	},
/turf/simulated/floor/road,
/area/dmm_suite/clear_area)
"N" = (
/obj/decal/road_marking/dotted_line/half{
	icon_state = "1";
	dir = 1
	},
/turf/simulated/floor/road,
/area/dmm_suite/clear_area)
"O" = (
/obj/decal/road_marking/dotted_line/half,
/obj/decal/road_marking/dotted_line/half{
	icon_state = "1";
	dir = 8
	},
/turf/simulated/floor/road,
/area/dmm_suite/clear_area)
"P" = (
/obj/marker/prefab/city/parking{
	dir = 6
	},
/turf/dmm_suite/clear_turf,
/area/dmm_suite/clear_area)
"Q" = (
/obj/decal/road_marking/solid_line,
/turf/simulated/floor/road,
/area/dmm_suite/clear_area)
"R" = (
/obj/decal/road_marking/solid_line{
	icon_state = "1";
	dir = 4
	},
/turf/simulated/floor/road,
/area/dmm_suite/clear_area)
"S" = (
/obj/decal/road_marking/hazard/yellow,
/turf/simulated/floor/road,
/area/dmm_suite/clear_area)
"T" = (
/obj/decal/road_marking/solid_line/offset/yellow{
	icon_state = "1";
	dir = 8
	},
/turf/simulated/floor/road,
/area/dmm_suite/clear_area)
"U" = (
/obj/decal/road_marking/solid_stop,
/turf/simulated/floor/road,
/area/dmm_suite/clear_area)
"V" = (
/obj/structure/interactive/stopsign,
/turf/simulated/floor/sidewalk,
/area/dmm_suite/clear_area)
"W" = (
/obj/structure/interactive/stopsign{
	icon_state = "sign";
	dir = 1
	},
/turf/dmm_suite/clear_turf,
/area/dmm_suite/clear_area)
"X" = (
/obj/decal/road_marking/dotted_line/half,
/turf/simulated/floor/road,
/area/dmm_suite/clear_area)
"Y" = (
/obj/decal/road_marking/dotted_line/half{
	icon_state = "1";
	dir = 4
	},
/turf/simulated/floor/road,
/area/dmm_suite/clear_area)
"Z" = (
/obj/structure/interactive/stopsign{
	icon_state = "sign";
	dir = 4
	},
/turf/dmm_suite/clear_turf,
/area/dmm_suite/clear_area)

(1,1,1) = {"
z
z
z
z
z
z
z
z
z
z
z
z
z
z
z
z
H
a
R
r
X
N
r
R
a
z
z
z
z
z
z
z
z
z
z
z
z
z
z
z
z
z
"}
(2,1,1) = {"
z
z
z
z
z
z
z
z
z
z
z
z
z
z
z
z
z
a
R
r
X
N
r
R
a
z
z
z
z
z
z
z
z
z
z
z
z
z
z
z
A
z
"}
(3,1,1) = {"
z
z
z
z
z
z
z
z
z
z
z
z
z
z
z
z
z
a
R
r
X
N
r
R
a
z
z
z
z
z
z
z
z
z
z
z
z
z
z
z
z
z
"}
(4,1,1) = {"
z
z
z
z
z
z
z
z
z
z
z
z
z
z
z
z
z
a
R
r
X
N
r
R
a
z
z
z
z
z
z
z
z
z
z
z
z
z
z
z
z
z
"}
(5,1,1) = {"
z
z
z
z
z
z
z
z
z
z
z
z
z
z
z
z
z
a
R
r
X
N
r
R
a
z
z
z
z
z
z
z
z
z
z
z
z
z
z
z
z
z
"}
(6,1,1) = {"
z
z
z
z
z
z
z
z
z
z
z
z
z
z
z
z
z
a
R
r
X
N
r
R
a
z
z
z
z
z
z
z
z
z
z
z
z
z
z
z
z
z
"}
(7,1,1) = {"
z
z
z
z
z
z
z
z
z
z
z
z
z
z
z
z
z
a
R
r
X
N
r
R
a
z
z
z
z
z
z
z
z
z
z
z
z
z
z
z
z
z
"}
(8,1,1) = {"
z
z
z
z
z
z
z
z
z
z
z
z
z
z
z
z
z
a
R
r
X
N
r
R
a
z
z
z
z
z
z
z
z
z
z
z
z
z
z
z
z
z
"}
(9,1,1) = {"
z
z
z
z
z
z
z
z
z
z
z
z
z
z
z
z
z
a
R
r
X
N
r
R
a
z
z
z
z
z
z
z
z
z
z
z
z
z
z
z
z
z
"}
(10,1,1) = {"
z
z
z
z
z
z
z
z
z
z
z
z
z
z
z
z
z
a
R
r
X
N
r
R
a
z
z
z
z
z
z
z
z
z
z
z
z
z
z
z
z
z
"}
(11,1,1) = {"
z
z
z
z
z
z
z
z
z
z
z
z
z
z
z
z
z
a
R
r
X
N
r
R
a
z
z
z
z
z
z
z
z
z
z
z
z
z
z
z
z
z
"}
(12,1,1) = {"
z
z
z
z
z
z
z
z
z
z
z
z
z
z
z
z
z
a
R
r
X
N
r
R
a
z
z
z
z
z
z
z
z
z
z
z
z
z
z
z
z
z
"}
(13,1,1) = {"
z
z
z
z
z
z
z
z
z
z
z
z
z
z
z
z
z
a
R
r
X
N
r
R
a
z
z
z
z
z
z
z
z
z
z
z
z
z
z
z
z
z
"}
(14,1,1) = {"
z
z
z
z
z
z
z
z
z
z
z
z
z
z
z
z
z
a
R
r
X
T
r
R
a
z
z
z
z
z
z
z
z
z
z
z
z
z
z
z
z
z
"}
(15,1,1) = {"
z
z
z
z
z
z
z
z
z
z
z
z
z
z
z
z
z
a
R
r
X
T
r
R
a
z
z
z
z
z
z
z
z
z
z
z
z
z
z
z
z
z
"}
(16,1,1) = {"
z
z
z
z
z
z
z
z
z
z
z
z
z
z
z
z
z
a
R
r
X
T
r
R
e
z
z
z
z
z
z
z
z
z
z
z
z
z
z
z
z
z
"}
(17,1,1) = {"
a
a
a
a
a
a
a
a
z
z
z
z
z
z
z
z
z
P
R
r
r
f
f
f
G
z
z
z
z
z
z
z
z
z
z
z
z
z
z
z
z
z
"}
(18,1,1) = {"
a
S
S
S
S
S
S
S
z
z
z
z
z
z
z
z
z
z
q
q
q
q
q
q
a
a
a
a
a
a
a
a
a
a
a
a
a
a
a
a
a
a
"}
(19,1,1) = {"
Q
Q
Q
Q
Q
Q
Q
I
z
z
z
z
z
z
z
z
z
z
r
r
r
r
r
r
g
Q
Q
Q
Q
Q
Q
Q
Q
Q
Q
Q
Q
Q
Q
Q
Q
Q
"}
(20,1,1) = {"
r
r
r
r
r
r
r
R
z
z
z
z
z
z
z
z
z
h
r
r
r
r
r
r
g
r
r
r
r
r
r
r
r
r
r
r
r
r
r
r
r
r
"}
(21,1,1) = {"
Y
Y
Y
Y
Y
r
r
R
z
z
z
z
z
z
z
z
z
h
r
r
r
r
r
r
g
r
Y
Y
Y
Y
Y
Y
Y
Y
Y
Y
Y
Y
Y
Y
Y
Y
"}
(22,1,1) = {"
k
k
k
k
O
N
r
R
z
z
z
z
z
z
z
z
z
h
r
r
r
c
r
r
g
U
i
i
i
k
k
k
k
k
k
k
k
k
k
k
k
k
"}
(23,1,1) = {"
r
r
r
r
X
N
r
R
z
z
z
z
z
z
z
z
z
h
r
r
r
r
r
r
g
U
r
r
r
r
r
r
r
r
r
r
r
r
r
r
r
r
"}
(24,1,1) = {"
Q
Q
I
r
X
N
r
R
z
z
z
z
z
z
z
z
z
z
r
r
r
r
r
r
g
U
Q
Q
Q
Q
Q
Q
Q
Q
Q
Q
Q
Q
Q
Q
Q
Q
"}
(25,1,1) = {"
a
a
R
r
X
N
r
R
z
z
z
z
z
z
z
z
z
z
q
q
q
q
q
q
a
o
V
a
a
a
a
a
a
a
a
a
a
a
a
a
a
a
"}
(26,1,1) = {"
z
a
R
r
X
N
r
R
z
z
z
z
z
z
z
z
z
v
t
t
t
r
r
R
a
z
z
z
z
z
z
z
z
z
z
z
z
z
z
z
A
z
"}
(27,1,1) = {"
z
a
R
r
X
N
r
R
z
z
z
z
z
z
z
z
z
Z
R
r
L
N
r
R
a
z
z
z
z
z
z
z
z
z
z
z
z
z
z
z
z
z
"}
(28,1,1) = {"
z
a
R
r
X
N
r
R
z
z
z
z
z
z
z
z
z
z
R
r
L
N
r
R
a
z
z
z
z
z
z
z
z
z
z
z
z
z
z
z
z
z
"}
(29,1,1) = {"
z
a
R
r
X
N
r
b
h
z
z
z
z
z
z
z
z
z
R
r
L
N
r
R
a
z
z
z
z
z
z
z
z
z
z
z
z
z
z
z
z
z
"}
(30,1,1) = {"
z
a
R
r
X
N
r
b
h
z
z
z
z
z
z
z
z
z
R
r
X
N
r
R
a
z
z
z
z
z
z
z
z
z
z
z
z
z
z
z
z
z
"}
(31,1,1) = {"
z
a
R
r
X
N
r
b
h
z
z
z
z
z
z
z
z
z
R
r
X
N
r
R
a
z
z
z
z
z
z
z
z
z
z
z
z
z
z
z
z
z
"}
(32,1,1) = {"
z
a
R
r
X
N
r
b
h
z
z
z
z
z
z
z
z
z
R
r
X
N
r
R
a
z
z
z
z
z
z
z
z
z
z
z
z
z
z
z
z
z
"}
(33,1,1) = {"
z
a
R
r
X
N
r
R
z
z
z
z
z
z
z
z
z
z
R
r
X
N
r
R
a
z
z
z
z
z
z
z
z
z
z
z
z
z
z
z
z
z
"}
(34,1,1) = {"
z
a
R
r
X
N
r
R
z
z
z
z
z
z
z
z
z
z
R
r
X
N
r
R
a
z
z
z
z
z
z
z
z
z
z
z
z
z
z
z
z
z
"}
(35,1,1) = {"
z
a
R
r
X
N
r
R
z
z
z
z
z
z
z
W
F
z
R
r
X
N
r
R
a
z
z
z
z
z
z
z
z
z
z
z
z
z
z
z
z
z
"}
(36,1,1) = {"
z
a
R
r
X
N
r
x
Q
Q
Q
Q
Q
Q
Q
Q
u
g
r
r
X
N
r
R
a
z
z
z
z
z
z
z
z
z
z
z
z
z
z
z
z
z
"}
(37,1,1) = {"
z
a
R
r
X
N
r
r
r
r
r
r
r
r
r
r
u
g
r
r
X
N
r
R
a
z
z
z
z
z
z
z
z
z
z
z
z
z
z
z
z
z
"}
(38,1,1) = {"
z
a
R
r
X
y
Y
Y
Y
Y
Y
Y
Y
p
p
p
u
g
r
r
X
N
r
R
a
z
z
z
z
z
z
z
z
z
z
z
z
z
z
z
z
z
"}
(39,1,1) = {"
z
a
R
r
r
k
k
k
k
k
k
k
k
k
k
k
r
g
r
r
X
N
r
R
a
z
z
z
z
z
z
z
z
z
z
z
z
z
z
z
z
z
"}
(40,1,1) = {"
z
a
R
r
r
r
r
r
r
r
r
r
r
r
r
r
r
g
r
r
X
N
r
R
a
z
z
z
z
z
z
z
z
z
z
z
z
z
z
z
z
z
"}
(41,1,1) = {"
z
a
x
Q
Q
Q
Q
Q
Q
Q
Q
Q
Q
Q
Q
Q
Q
g
r
r
X
N
r
R
a
z
z
z
z
z
z
z
z
z
z
z
z
z
z
z
z
z
"}
(42,1,1) = {"
z
a
a
a
a
a
a
a
a
a
a
a
a
a
a
a
a
a
R
r
X
N
r
R
a
z
z
z
z
z
z
z
z
z
z
z
z
z
z
z
z
z
"}
