//MAP CONVERTED BY dmm2tgm.py THIS HEADER COMMENT PREVENTS RECONVERSION, DO NOT REMOVE
"a" = (
/obj/decal/road_marking/solid_line,
/turf/simulated/floor/road,
/area/dmm_suite/clear_area)
"d" = (
/obj/structure/interactive/lighting/roadlamp,
/turf/simulated/floor/sidewalk,
/area/dmm_suite/clear_area)
"g" = (
/obj/decal/road_marking/solid_cross{
	icon_state = "1";
	dir = 4
	},
/turf/simulated/floor/road,
/area/dmm_suite/clear_area)
"i" = (
/obj/structure/interactive/stopsign{
	icon_state = "sign";
	dir = 4
	},
/turf/simulated/floor/sidewalk,
/area/dmm_suite/clear_area)
"j" = (
/obj/marker/blob,
/turf/simulated/floor/road,
/area/dmm_suite/clear_area)
"k" = (
/turf/dmm_suite/clear_turf,
/area/dmm_suite/clear_area)
"l" = (
/obj/decal/road_marking/solid_cross,
/turf/simulated/floor/road,
/area/dmm_suite/clear_area)
"s" = (
/obj/structure/interactive/lighting/roadlamp{
	icon_state = "lamp";
	dir = 8
	},
/turf/simulated/floor/sidewalk,
/area/dmm_suite/clear_area)
"v" = (
/obj/decal/road_marking/dotted_line/half{
	icon_state = "1";
	dir = 1
	},
/turf/simulated/floor/road,
/area/dmm_suite/clear_area)
"w" = (
/obj/decal/road_marking/solid_stop{
	icon_state = "1";
	dir = 4
	},
/turf/simulated/floor/road,
/area/dmm_suite/clear_area)
"x" = (
/turf/simulated/floor/road,
/area/dmm_suite/clear_area)
"y" = (
/obj/structure/interactive/stopsign{
	icon_state = "sign";
	dir = 8
	},
/turf/simulated/floor/sidewalk,
/area/dmm_suite/clear_area)
"A" = (
/obj/structure/interactive/lighting/roadlamp{
	icon_state = "lamp";
	dir = 4
	},
/turf/simulated/floor/sidewalk,
/area/dmm_suite/clear_area)
"C" = (
/obj/marker/prefab/city/store,
/turf/dmm_suite/clear_turf,
/area/dmm_suite/clear_area)
"D" = (
/obj/decal/road_marking/solid_line/offset/yellow{
	icon_state = "1";
	dir = 1
	},
/turf/simulated/floor/road,
/area/dmm_suite/clear_area)
"E" = (
/obj/marker/prefab/city/store{
	dir = 1
	},
/turf/dmm_suite/clear_turf,
/area/dmm_suite/clear_area)
"F" = (
/obj/decal/road_marking/solid_line/offset/yellow{
	icon_state = "1";
	dir = 4
	},
/turf/simulated/floor/road,
/area/dmm_suite/clear_area)
"G" = (
/obj/decal/road_marking/solid_stop{
	icon_state = "1";
	dir = 8
	},
/turf/simulated/floor/road,
/area/dmm_suite/clear_area)
"H" = (
/obj/decal/road_marking/solid_line/offset/yellow,
/turf/simulated/floor/road,
/area/dmm_suite/clear_area)
"I" = (
/obj/decal/road_marking/dotted_line/half,
/turf/simulated/floor/road,
/area/dmm_suite/clear_area)
"O" = (
/obj/decal/road_marking/dotted_line/half{
	icon_state = "1";
	dir = 4
	},
/turf/simulated/floor/road,
/area/dmm_suite/clear_area)
"P" = (
/obj/decal/road_marking/solid_stop{
	icon_state = "1";
	dir = 1
	},
/turf/simulated/floor/road,
/area/dmm_suite/clear_area)
"Q" = (
/obj/structure/interactive/stopsign,
/turf/simulated/floor/sidewalk,
/area/dmm_suite/clear_area)
"R" = (
/obj/structure/interactive/lighting/roadlamp{
	icon_state = "lamp";
	dir = 1
	},
/turf/simulated/floor/sidewalk,
/area/dmm_suite/clear_area)
"S" = (
/obj/decal/road_marking/solid_line/offset/yellow{
	icon_state = "1";
	dir = 8
	},
/turf/simulated/floor/road,
/area/dmm_suite/clear_area)
"U" = (
/turf/simulated/floor/sidewalk,
/area/dmm_suite/clear_area)
"V" = (
/obj/decal/road_marking/dotted_line/half{
	icon_state = "1";
	dir = 8
	},
/turf/simulated/floor/road,
/area/dmm_suite/clear_area)
"W" = (
/obj/decal/road_marking/solid_line{
	icon_state = "1";
	dir = 4
	},
/turf/simulated/floor/road,
/area/dmm_suite/clear_area)
"X" = (
/obj/decal/road_marking/solid_stop,
/turf/simulated/floor/road,
/area/dmm_suite/clear_area)
"Z" = (
/obj/structure/interactive/stopsign{
	icon_state = "sign";
	dir = 1
	},
/turf/simulated/floor/sidewalk,
/area/dmm_suite/clear_area)

(1,1,1) = {"
k
k
k
k
k
k
k
k
k
k
k
k
k
k
k
k
k
U
W
x
I
v
x
W
U
k
k
k
k
k
k
k
k
k
k
k
k
k
k
k
k
k
"}
(2,1,1) = {"
k
k
k
k
k
k
k
k
k
k
k
k
k
k
k
k
C
U
W
x
I
v
x
W
U
k
k
k
k
k
k
k
k
k
k
k
k
k
k
k
E
k
"}
(3,1,1) = {"
k
k
k
k
k
k
k
k
k
k
k
k
k
k
k
k
k
U
W
x
I
v
x
W
U
k
k
k
k
k
k
k
k
k
k
k
k
k
k
k
k
k
"}
(4,1,1) = {"
k
k
k
k
k
k
k
k
k
k
k
k
k
k
k
k
k
U
W
x
I
v
x
W
U
k
k
k
k
k
k
k
k
k
k
k
k
k
k
k
k
k
"}
(5,1,1) = {"
k
k
k
k
k
k
k
k
k
k
k
k
k
k
k
k
k
U
W
x
I
v
x
W
U
k
k
k
k
k
k
k
k
k
k
k
k
k
k
k
k
k
"}
(6,1,1) = {"
k
k
k
k
k
k
k
k
k
k
k
k
k
k
k
k
k
U
W
x
I
v
x
W
U
k
k
k
k
k
k
k
k
k
k
k
k
k
k
k
k
k
"}
(7,1,1) = {"
k
k
k
k
k
k
k
k
k
k
k
k
k
k
k
k
k
U
W
x
I
v
x
W
U
k
k
k
k
k
k
k
k
k
k
k
k
k
k
k
k
k
"}
(8,1,1) = {"
k
k
k
k
k
k
k
k
k
k
k
k
k
k
k
k
k
U
W
x
I
v
x
W
U
k
k
k
k
k
k
k
k
k
k
k
k
k
k
k
k
k
"}
(9,1,1) = {"
k
k
k
k
k
k
k
k
k
k
k
k
k
k
k
k
k
U
W
x
I
v
x
W
U
k
k
k
k
k
k
k
k
k
k
k
k
k
k
k
k
k
"}
(10,1,1) = {"
k
k
k
k
k
k
k
k
k
k
k
k
k
k
k
k
k
U
W
x
I
v
x
W
U
k
k
k
k
k
k
k
k
k
k
k
k
k
k
k
k
k
"}
(11,1,1) = {"
k
k
k
k
k
k
k
k
k
k
k
k
k
k
k
k
k
U
W
x
I
v
x
W
U
k
k
k
k
k
k
k
k
k
k
k
k
k
k
k
k
k
"}
(12,1,1) = {"
k
k
k
k
k
k
k
k
k
k
k
k
k
k
k
k
k
U
W
x
I
v
x
W
U
k
k
k
k
k
k
k
k
k
k
k
k
k
k
k
k
k
"}
(13,1,1) = {"
k
k
k
k
k
k
k
k
k
k
k
k
k
k
k
k
k
U
W
x
I
v
x
W
U
k
k
k
k
k
k
k
k
k
k
k
k
k
k
k
k
k
"}
(14,1,1) = {"
k
k
k
k
k
k
k
k
k
k
k
k
k
k
k
k
k
U
W
x
I
S
x
W
U
k
k
k
k
k
k
k
k
k
k
k
k
k
k
k
k
k
"}
(15,1,1) = {"
k
k
k
k
k
k
k
k
k
k
k
k
k
k
k
k
k
U
W
x
I
S
x
W
U
k
k
k
k
k
k
k
k
k
k
k
k
k
k
k
k
k
"}
(16,1,1) = {"
k
k
k
k
k
k
k
k
k
k
k
k
k
k
k
k
k
U
W
x
I
S
x
W
y
k
k
k
k
k
k
k
k
k
k
k
k
k
k
k
k
k
"}
(17,1,1) = {"
k
k
k
k
k
k
k
k
k
k
k
k
k
k
k
k
k
U
W
x
x
G
G
G
R
k
k
k
k
k
k
k
k
k
k
k
k
k
k
k
k
k
"}
(18,1,1) = {"
U
U
U
U
U
U
U
U
U
U
U
U
U
U
U
Z
A
U
g
g
g
g
g
g
U
U
U
U
U
U
U
U
U
U
U
U
U
U
U
U
U
U
"}
(19,1,1) = {"
a
a
a
a
a
a
a
a
a
a
a
a
a
a
a
a
P
l
x
x
x
x
x
x
l
a
a
a
a
a
a
a
a
a
a
a
a
a
a
a
a
a
"}
(20,1,1) = {"
x
x
x
x
x
x
x
x
x
x
x
x
x
x
x
x
P
l
x
x
x
x
x
x
l
x
x
x
x
x
x
x
x
x
x
x
x
x
x
x
x
x
"}
(21,1,1) = {"
O
O
O
O
O
O
O
O
O
O
O
O
O
D
D
D
P
l
x
x
x
x
x
x
l
x
O
O
O
O
O
O
O
O
O
O
O
O
O
O
O
O
"}
(22,1,1) = {"
V
V
V
V
V
V
V
V
V
V
V
V
V
V
V
V
x
l
x
x
x
j
x
x
l
X
H
H
H
V
V
V
V
V
V
V
V
V
V
V
V
V
"}
(23,1,1) = {"
x
x
x
x
x
x
x
x
x
x
x
x
x
x
x
x
x
l
x
x
x
x
x
x
l
X
x
x
x
x
x
x
x
x
x
x
x
x
x
x
x
x
"}
(24,1,1) = {"
a
a
a
a
a
a
a
a
a
a
a
a
a
a
a
a
a
l
x
x
x
x
x
x
l
X
a
a
a
a
a
a
a
a
a
a
a
a
a
a
a
a
"}
(25,1,1) = {"
U
U
U
U
U
U
U
U
U
U
U
U
U
U
U
U
U
U
g
g
g
g
g
g
U
s
Q
U
U
U
U
U
U
U
U
U
U
U
U
U
U
U
"}
(26,1,1) = {"
k
k
k
k
k
k
k
k
k
k
k
k
k
k
k
k
C
d
w
w
w
x
x
W
U
k
k
k
k
k
k
k
k
k
k
k
k
k
k
k
E
k
"}
(27,1,1) = {"
k
k
k
k
k
k
k
k
k
k
k
k
k
k
k
k
k
i
W
x
F
v
x
W
U
k
k
k
k
k
k
k
k
k
k
k
k
k
k
k
k
k
"}
(28,1,1) = {"
k
k
k
k
k
k
k
k
k
k
k
k
k
k
k
k
k
U
W
x
F
v
x
W
U
k
k
k
k
k
k
k
k
k
k
k
k
k
k
k
k
k
"}
(29,1,1) = {"
k
k
k
k
k
k
k
k
k
k
k
k
k
k
k
k
k
U
W
x
F
v
x
W
U
k
k
k
k
k
k
k
k
k
k
k
k
k
k
k
k
k
"}
(30,1,1) = {"
k
k
k
k
k
k
k
k
k
k
k
k
k
k
k
k
k
U
W
x
I
v
x
W
U
k
k
k
k
k
k
k
k
k
k
k
k
k
k
k
k
k
"}
(31,1,1) = {"
k
k
k
k
k
k
k
k
k
k
k
k
k
k
k
k
k
U
W
x
I
v
x
W
U
k
k
k
k
k
k
k
k
k
k
k
k
k
k
k
k
k
"}
(32,1,1) = {"
k
k
k
k
k
k
k
k
k
k
k
k
k
k
k
k
k
U
W
x
I
v
x
W
U
k
k
k
k
k
k
k
k
k
k
k
k
k
k
k
k
k
"}
(33,1,1) = {"
k
k
k
k
k
k
k
k
k
k
k
k
k
k
k
k
k
U
W
x
I
v
x
W
U
k
k
k
k
k
k
k
k
k
k
k
k
k
k
k
k
k
"}
(34,1,1) = {"
k
k
k
k
k
k
k
k
k
k
k
k
k
k
k
k
k
U
W
x
I
v
x
W
U
k
k
k
k
k
k
k
k
k
k
k
k
k
k
k
k
k
"}
(35,1,1) = {"
k
k
k
k
k
k
k
k
k
k
k
k
k
k
k
k
k
U
W
x
I
v
x
W
U
k
k
k
k
k
k
k
k
k
k
k
k
k
k
k
k
k
"}
(36,1,1) = {"
k
k
k
k
k
k
k
k
k
k
k
k
k
k
k
k
k
U
W
x
I
v
x
W
U
k
k
k
k
k
k
k
k
k
k
k
k
k
k
k
k
k
"}
(37,1,1) = {"
k
k
k
k
k
k
k
k
k
k
k
k
k
k
k
k
k
U
W
x
I
v
x
W
U
k
k
k
k
k
k
k
k
k
k
k
k
k
k
k
k
k
"}
(38,1,1) = {"
k
k
k
k
k
k
k
k
k
k
k
k
k
k
k
k
k
U
W
x
I
v
x
W
U
k
k
k
k
k
k
k
k
k
k
k
k
k
k
k
k
k
"}
(39,1,1) = {"
k
k
k
k
k
k
k
k
k
k
k
k
k
k
k
k
k
U
W
x
I
v
x
W
U
k
k
k
k
k
k
k
k
k
k
k
k
k
k
k
k
k
"}
(40,1,1) = {"
k
k
k
k
k
k
k
k
k
k
k
k
k
k
k
k
k
U
W
x
I
v
x
W
U
k
k
k
k
k
k
k
k
k
k
k
k
k
k
k
k
k
"}
(41,1,1) = {"
k
k
k
k
k
k
k
k
k
k
k
k
k
k
k
k
k
U
W
x
I
v
x
W
U
k
k
k
k
k
k
k
k
k
k
k
k
k
k
k
k
k
"}
(42,1,1) = {"
k
k
k
k
k
k
k
k
k
k
k
k
k
k
k
k
k
U
W
x
I
v
x
W
U
k
k
k
k
k
k
k
k
k
k
k
k
k
k
k
k
k
"}
