//MAP CONVERTED BY dmm2tgm.py THIS HEADER COMMENT PREVENTS RECONVERSION, DO NOT REMOVE
"a" = (
/turf/dmm_suite/clear_turf,
/area/dmm_suite/clear_area)
"b" = (
/turf/simulated/wall/shuttle,
/area/dmm_suite/clear_area)
"c" = (
/obj/structure/interactive/door/airlock/shuttle,
/turf/simulated/floor/tile/shuttle,
/area/dmm_suite/clear_area)
"d" = (
/obj/structure/interactive/reagent_tank/water,
/turf/simulated/floor/plating/shuttle,
/area/dmm_suite/clear_area)
"e" = (
/turf/simulated/floor/plating/shuttle,
/area/dmm_suite/clear_area)
"f" = (
/obj/structure/smooth/table/rack/grey,
/turf/simulated/floor/plating/shuttle,
/area/dmm_suite/clear_area)
"g" = (
/obj/structure/interactive/reagent_tank/ethanol,
/turf/simulated/floor/plating/shuttle,
/area/dmm_suite/clear_area)
"h" = (
/obj/structure/shuttle_engine/large{
	dir = 4
	},
/turf/simulated/floor/plating/shuttle,
/area/dmm_suite/clear_area)
"i" = (
/obj/structure/interactive/computer/arcade/bubbletwist,
/turf/simulated/floor/tile/shuttle,
/area/dmm_suite/clear_area)
"j" = (
/turf/simulated/floor/tile/shuttle,
/area/dmm_suite/clear_area)
"k" = (
/turf/simulated/floor/tile/shuttle/purple,
/area/dmm_suite/clear_area)
"l" = (
/obj/structure/interactive/lighting/fixture/tube/station,
/turf/simulated/floor/tile/shuttle/purple,
/area/dmm_suite/clear_area)
"m" = (
/obj/structure/interactive/vending/mining/golem,
/turf/simulated/floor/tile/shuttle/purple,
/area/dmm_suite/clear_area)
"n" = (
/obj/structure/interactive/lighting/fixture/tube/station{
	dir = 1;
	icon_state = "preview"
	},
/turf/simulated/floor/tile/shuttle,
/area/dmm_suite/clear_area)
"o" = (
/obj/structure/interactive/lighting/fixture/tube/station/strong,
/turf/simulated/floor/tile/shuttle/purple,
/area/dmm_suite/clear_area)
"p" = (
/obj/structure/interactive/lighting/fixture/tube/station{
	dir = 8;
	icon_state = "preview"
	},
/obj/structure/smooth/table/rack/grey,
/obj/item/weapon/melee/tool/pickaxe,
/obj/item/weapon/melee/tool/pickaxe,
/turf/simulated/floor/tile/shuttle,
/area/dmm_suite/clear_area)
"q" = (
/obj/marker/spawning/window/extra,
/turf/simulated/floor/plating/shuttle,
/area/dmm_suite/clear_area)
"r" = (
/obj/structure/interactive/lighting/fixture/tube/station,
/turf/simulated/floor/tile/shuttle,
/area/dmm_suite/clear_area)
"s" = (
/obj/structure/interactive/statue/director,
/turf/simulated/floor/tile/shuttle,
/area/dmm_suite/clear_area)
"t" = (
/obj/structure/smooth/table/wood,
/turf/simulated/floor/tile/shuttle,
/area/dmm_suite/clear_area)
"u" = (
/obj/structure/interactive/lighting/fixture/tube/station/strong{
	dir = 1;
	icon_state = "preview"
	},
/turf/simulated/floor/tile/shuttle/purple,
/area/dmm_suite/clear_area)
"v" = (
/obj/structure/interactive/lighting/fixture/tube/station{
	dir = 1;
	icon_state = "preview"
	},
/turf/simulated/floor/tile/shuttle/purple,
/area/dmm_suite/clear_area)
"w" = (
/obj/structure/smooth/table/wood,
/turf/simulated/floor/tile/shuttle/purple,
/area/dmm_suite/clear_area)
"x" = (
/obj/structure/smooth/table/wood,
/obj/structure/interactive/lighting/fixture/tube/station{
	dir = 1;
	icon_state = "preview"
	},
/turf/simulated/floor/tile/shuttle/purple,
/area/dmm_suite/clear_area)
"y" = (
/obj/structure/smooth/table/wood,
/obj/item/analyzer/health,
/turf/simulated/floor/tile/shuttle/purple,
/area/dmm_suite/clear_area)
"z" = (
/obj/item/ball/soccer,
/turf/simulated/floor/tile/shuttle,
/area/dmm_suite/clear_area)
"A" = (
/obj/structure/smooth/table/rack/grey,
/obj/item/broom,
/obj/item/broom,
/turf/simulated/floor/plating/shuttle,
/area/dmm_suite/clear_area)
"B" = (
/obj/structure/smooth/table/wood,
/obj/item/clothing/back/storage/backpack/medical,
/turf/simulated/floor/tile/shuttle/purple,
/area/dmm_suite/clear_area)
"C" = (
/obj/structure/smooth/table/rack/grey,
/obj/item/clothing/belt/storage/tool/filled,
/obj/item/clothing/belt/storage/tool/filled,
/turf/simulated/floor/plating/shuttle,
/area/dmm_suite/clear_area)
"D" = (
/obj/structure/smooth/table/rack/grey,
/obj/item/clothing/glasses/meson,
/obj/item/clothing/glasses/meson,
/obj/item/clothing/glasses/meson,
/turf/simulated/floor/plating/shuttle,
/area/dmm_suite/clear_area)
"E" = (
/obj/structure/smooth/table/rack/grey,
/obj/item/clothing/head/helmet/welding,
/obj/item/clothing/head/helmet/welding,
/turf/simulated/floor/plating/shuttle,
/area/dmm_suite/clear_area)
"F" = (
/obj/structure/smooth/table/rack/grey,
/obj/item/clothing/head/light/hardhat,
/obj/item/clothing/head/light/hardhat,
/turf/simulated/floor/plating/shuttle,
/area/dmm_suite/clear_area)
"G" = (
/obj/structure/smooth/table/wood,
/obj/item/clothing/mask/sterile,
/obj/item/clothing/mask/sterile,
/turf/simulated/floor/tile/shuttle/purple,
/area/dmm_suite/clear_area)
"H" = (
/obj/marker/antag/golem,
/turf/simulated/floor/tile/shuttle,
/area/dmm_suite/clear_area)
"I" = (
/obj/structure/smooth/table/rack/grey,
/obj/item/flare,
/obj/item/flare,
/obj/item/flare,
/obj/item/flare,
/turf/simulated/floor/plating/shuttle,
/area/dmm_suite/clear_area)
"J" = (
/obj/marker/lobby,
/turf/simulated/floor/tile/shuttle,
/area/dmm_suite/clear_area)
"K" = (
/obj/marker/objective_spawn,
/turf/simulated/floor/tile/shuttle,
/area/dmm_suite/clear_area)

(1,1,1) = {"
a
a
a
a
a
a
a
a
a
a
a
a
a
a
a
a
a
a
a
a
a
a
a
a
a
a
a
a
a
a
a
a
"}
(2,1,1) = {"
a
a
a
a
a
a
a
a
a
a
a
a
a
a
a
a
a
a
a
a
a
a
a
a
a
a
a
a
a
a
a
a
"}
(3,1,1) = {"
a
a
a
a
a
a
a
a
a
a
a
a
a
a
a
a
a
a
a
a
a
a
a
a
a
a
a
a
a
a
a
a
"}
(4,1,1) = {"
a
a
a
a
a
a
a
a
a
a
a
a
a
b
b
b
b
b
b
b
a
a
a
a
a
a
a
a
a
a
a
a
"}
(5,1,1) = {"
a
a
a
a
a
a
a
a
a
a
a
a
a
b
o
q
s
q
u
b
a
a
a
a
a
a
a
a
a
a
a
a
"}
(6,1,1) = {"
a
a
a
a
a
a
a
a
a
a
a
a
a
b
k
q
q
q
k
b
a
a
a
a
a
a
a
a
a
a
a
a
"}
(7,1,1) = {"
a
a
a
a
a
a
a
a
a
a
a
a
a
b
k
H
t
H
k
b
a
a
a
a
a
a
a
a
a
a
a
a
"}
(8,1,1) = {"
a
a
a
a
a
a
a
a
a
a
a
a
a
b
k
H
K
H
k
b
a
a
a
a
a
a
a
a
a
a
a
a
"}
(9,1,1) = {"
a
a
a
a
a
a
a
a
a
a
a
a
a
b
k
H
j
H
k
b
a
a
a
a
a
a
a
a
a
a
a
a
"}
(10,1,1) = {"
a
a
a
a
a
a
a
a
a
a
a
a
a
b
l
H
j
H
v
b
a
a
a
a
a
a
a
a
a
a
a
a
"}
(11,1,1) = {"
a
a
a
a
a
a
a
b
b
b
b
b
c
b
k
j
j
j
k
b
c
b
b
b
b
b
a
a
a
a
a
a
"}
(12,1,1) = {"
a
a
a
a
a
a
a
b
d
d
b
i
j
b
k
j
j
j
k
b
j
j
b
d
d
b
a
a
a
a
a
a
"}
(13,1,1) = {"
a
a
a
a
a
a
a
c
e
e
b
z
j
b
k
j
j
j
k
b
j
j
b
e
e
c
a
a
a
a
a
a
"}
(14,1,1) = {"
a
a
a
a
a
a
a
b
A
e
b
j
j
b
k
j
j
j
k
b
j
j
b
e
e
b
a
a
a
a
a
a
"}
(15,1,1) = {"
a
a
a
a
a
a
a
b
C
e
b
j
n
b
l
j
j
j
v
b
r
j
b
e
e
b
a
a
a
a
a
a
"}
(16,1,1) = {"
a
a
a
a
a
a
a
b
D
e
c
j
j
b
b
c
c
c
b
b
j
j
c
e
e
b
a
a
a
a
a
a
"}
(17,1,1) = {"
a
a
a
a
a
a
a
b
E
e
b
j
j
b
k
j
j
j
k
b
j
j
b
e
e
b
a
a
a
a
a
a
"}
(18,1,1) = {"
a
a
a
a
a
a
a
b
F
e
b
j
j
b
k
j
J
j
k
b
j
j
b
e
e
b
a
a
a
a
a
a
"}
(19,1,1) = {"
a
a
a
a
a
a
a
b
f
e
b
b
c
b
l
j
j
j
v
b
c
b
b
e
e
b
a
a
a
a
a
a
"}
(20,1,1) = {"
a
a
a
a
a
a
a
b
f
e
c
k
k
k
k
j
j
j
k
k
k
k
c
e
e
b
a
a
a
a
a
a
"}
(21,1,1) = {"
a
a
a
a
a
a
a
b
f
e
c
k
j
j
j
j
j
j
j
j
j
k
c
e
e
b
a
a
a
a
a
a
"}
(22,1,1) = {"
a
a
a
a
a
a
a
b
f
e
b
k
j
j
j
j
j
j
j
j
j
w
b
e
e
b
a
a
a
a
a
a
"}
(23,1,1) = {"
a
a
a
a
a
a
a
b
I
e
b
l
j
j
j
j
j
j
j
j
j
x
b
e
e
b
a
a
a
a
a
a
"}
(24,1,1) = {"
a
a
a
a
a
a
a
c
e
e
b
k
j
j
p
j
j
j
p
j
j
w
b
e
e
c
a
a
a
a
a
a
"}
(25,1,1) = {"
a
a
a
a
a
a
a
b
e
e
b
k
j
j
b
c
c
c
b
j
j
w
b
e
e
b
a
a
a
a
a
a
"}
(26,1,1) = {"
a
a
a
a
a
a
a
b
g
g
b
m
m
k
b
j
j
j
b
y
B
G
b
g
g
b
a
a
a
a
a
a
"}
(27,1,1) = {"
a
a
a
a
a
a
a
b
b
b
b
b
b
b
b
r
j
n
b
b
b
b
b
b
b
b
a
a
a
a
a
a
"}
(28,1,1) = {"
a
a
a
a
a
a
a
b
e
h
e
h
e
h
b
j
j
j
b
e
h
e
h
e
h
b
a
a
a
a
a
a
"}
(29,1,1) = {"
a
a
a
a
a
a
a
b
e
e
e
e
e
e
b
c
c
c
b
e
e
e
e
e
e
b
a
a
a
a
a
a
"}
(30,1,1) = {"
a
a
a
a
a
a
a
a
a
a
a
a
a
a
a
a
a
a
a
a
a
a
a
a
a
a
a
a
a
a
a
a
"}
(31,1,1) = {"
a
a
a
a
a
a
a
a
a
a
a
a
a
a
a
a
a
a
a
a
a
a
a
a
a
a
a
a
a
a
a
a
"}
(32,1,1) = {"
a
a
a
a
a
a
a
a
a
a
a
a
a
a
a
a
a
a
a
a
a
a
a
a
a
a
a
a
a
a
a
a
"}
