//MAP CONVERTED BY dmm2tgm.py THIS HEADER COMMENT PREVENTS RECONVERSION, DO NOT REMOVE
"a" = (
/turf/dmm_suite/clear_turf,
/area/dmm_suite/clear_area)
"b" = (
/turf/simulated/wall/metal/reinforced,
/area/dmm_suite/clear_area)
"c" = (
/obj/structure/interactive/the_curse,
/obj/marker/map_node,
/turf/simulated/floor/plating/shuttle,
/area/dmm_suite/clear_area)
"d" = (
/turf/simulated/floor/plating/shuttle,
/area/dmm_suite/clear_area)
"e" = (
/obj/structure/interactive/door/airlock/external,
/obj/marker/map_node,
/turf/simulated/floor/plating/shuttle,
/area/dmm_suite/clear_area)
"f" = (
/turf/dmm_suite/no_wall,
/area/dmm_suite/clear_area)
"g" = (
/obj/marker/map_node,
/turf/dmm_suite/no_wall,
/area/dmm_suite/clear_area)
"h" = (
/obj/marker/lobby,
/turf/simulated/floor/plating/shuttle,
/area/dmm_suite/clear_area)

(1,1,1) = {"
a
a
a
a
a
a
a
a
a
a
a
a
a
a
a
a
"}
(2,1,1) = {"
a
a
a
a
a
a
a
a
a
a
a
a
a
a
a
a
"}
(3,1,1) = {"
a
a
a
a
a
a
a
a
a
a
a
a
a
a
a
a
"}
(4,1,1) = {"
a
a
a
a
a
a
a
a
a
a
a
a
a
a
a
a
"}
(5,1,1) = {"
a
a
a
b
b
b
b
b
b
b
f
f
f
f
a
a
"}
(6,1,1) = {"
a
a
a
b
d
d
d
d
d
b
b
b
b
f
f
a
"}
(7,1,1) = {"
a
a
a
b
d
d
d
d
d
b
d
d
b
f
f
f
"}
(8,1,1) = {"
a
a
a
b
d
d
c
h
d
e
d
d
e
f
f
g
"}
(9,1,1) = {"
a
a
a
b
d
d
d
d
d
b
d
d
b
f
f
f
"}
(10,1,1) = {"
a
a
a
b
d
d
d
d
d
b
b
b
b
f
f
a
"}
(11,1,1) = {"
a
a
a
b
b
b
b
b
b
b
f
f
f
f
a
a
"}
(12,1,1) = {"
a
a
a
a
a
a
a
a
a
a
a
a
a
a
a
a
"}
(13,1,1) = {"
a
a
a
a
a
a
a
a
a
a
a
a
a
a
a
a
"}
(14,1,1) = {"
a
a
a
a
a
a
a
a
a
a
a
a
a
a
a
a
"}
(15,1,1) = {"
a
a
a
a
a
a
a
a
a
a
a
a
a
a
a
a
"}
(16,1,1) = {"
a
a
a
a
a
a
a
a
a
a
a
a
a
a
a
a
"}
