"a" = (/turf/dmm_suite/clear_turf,/area/dmm_suite/clear_area)
"b" = (/turf/simulated/wall/cult,/area/mission/prefab/misc/cult_hall)
"c" = (/turf/simulated/floor/cult,/area/mission/prefab/misc/cult_hall)
"d" = (/obj/marker/objective_spawn,/turf/simulated/floor/cult,/area/mission/prefab/misc/cult_hall)
"e" = (/obj/structure/interactive/fountain,/turf/simulated/floor/cult,/area/mission/prefab/misc/cult_hall)
"f" = (/obj/structure/interactive/lighting/cult_pylon,/turf/simulated/floor/cult,/area/mission/prefab/misc/cult_hall)
"g" = (/mob/living/advanced/npc/cultist/old,/turf/simulated/floor/cult,/area/mission/prefab/misc/cult_hall)
"h" = (/obj/marker/map_node/x2,/turf/simulated/floor/cult,/area/mission/prefab/misc/cult_hall)
"i" = (/obj/marker/smart_clear_turf,/turf/simulated/floor/cult,/area/mission/prefab/misc/cult_hall)
"j" = (/obj/marker/map_node,/turf/simulated/floor/cult,/area/mission/prefab/misc/cult_hall)

(1,1,1) = {"
aabbbbbbbbbbbaaa
aabccccdccccbaaa
aabecfcccfcebaaa
aabccgcccgccbaaa
aabeccchcccebaaa
aabcccccccccbaaa
aabecgcccgcebaaa
aabcccccccccbaaa
aabecccccccebaaa
aabcccccccccbaaa
aabeccchcccebaaa
aabcccccccccbaaa
aabecccccccebaaa
aabccfcccfccbaaa
aabecccccccebaaa
aabbbbijibbbbaaa
"}
