//MAP CONVERTED BY dmm2tgm.py THIS HEADER COMMENT PREVENTS RECONVERSION, DO NOT REMOVE
"a" = (
/turf/dmm_suite/clear_turf,
/area/dmm_suite/clear_area)
"b" = (
/turf/simulated/wall/cult,
/area/dmm_suite/clear_area)
"d" = (
/obj/structure/interactive/fountain,
/turf/simulated/floor/cult,
/area/dmm_suite/clear_area)
"e" = (
/turf/simulated/floor/cult,
/area/dmm_suite/clear_area)
"f" = (
/obj/structure/interactive/lighting/cult_pylon,
/turf/simulated/floor/cult,
/area/dmm_suite/clear_area)
"g" = (
/mob/living/advanced/npc/cultist/old,
/turf/simulated/floor/cult,
/area/dmm_suite/clear_area)
"h" = (
/obj/marker/map_node,
/turf/simulated/floor/cult,
/area/dmm_suite/clear_area)
"i" = (
/obj/marker/objective_spawn,
/turf/simulated/floor/cult,
/area/dmm_suite/clear_area)

(1,1,1) = {"
a
a
a
a
a
a
a
a
a
a
a
a
a
a
a
a
"}
(2,1,1) = {"
a
a
a
a
a
a
a
a
a
a
a
a
a
a
a
a
"}
(3,1,1) = {"
b
b
b
b
b
b
b
b
b
b
b
b
b
b
b
b
"}
(4,1,1) = {"
b
e
d
e
d
e
d
e
d
e
d
e
d
e
d
b
"}
(5,1,1) = {"
b
e
e
e
e
e
e
e
e
e
e
e
e
e
e
b
"}
(6,1,1) = {"
b
e
f
g
e
e
g
e
e
e
e
e
e
f
e
b
"}
(7,1,1) = {"
b
e
e
e
e
e
e
e
e
e
e
e
e
e
e
e
"}
(8,1,1) = {"
b
i
e
h
e
e
e
e
e
e
h
e
e
e
e
h
"}
(9,1,1) = {"
b
e
e
e
e
e
e
e
e
e
e
e
e
e
e
e
"}
(10,1,1) = {"
b
e
f
g
e
e
g
e
e
e
e
e
e
f
e
b
"}
(11,1,1) = {"
b
e
e
e
e
e
e
e
e
e
e
e
e
e
e
b
"}
(12,1,1) = {"
b
e
d
e
d
e
d
e
d
e
d
e
d
e
d
b
"}
(13,1,1) = {"
b
b
b
b
b
b
b
b
b
b
b
b
b
b
b
b
"}
(14,1,1) = {"
a
a
a
a
a
a
a
a
a
a
a
a
a
a
a
a
"}
(15,1,1) = {"
a
a
a
a
a
a
a
a
a
a
a
a
a
a
a
a
"}
(16,1,1) = {"
a
a
a
a
a
a
a
a
a
a
a
a
a
a
a
a
"}
