"a" = (/turf/dmm_suite/clear_turf,/area/dmm_suite/clear_area)
"b" = (/turf/simulated/floor/colored/ash/rocky,/area/dmm_suite/clear_area)
"c" = (/turf/simulated/wall/boss,/area/dmm_suite/clear_area)
"d" = (/obj/structure/table/simple/boss,/obj/marker/spawning/random/ashwalker,/turf/simulated/floor/boss,/area/dmm_suite/clear_area)
"e" = (/turf/simulated/floor/colored/ash/necro,/area/dmm_suite/clear_area)
"f" = (/turf/simulated/floor/boss,/area/dmm_suite/clear_area)
"g" = (/obj/structure/table/cooking/bonfire,/turf/simulated/floor/boss,/area/dmm_suite/clear_area)
"h" = (/obj/structure/table/simple/boss,/turf/simulated/floor/boss,/area/dmm_suite/clear_area)
"i" = (/obj/structure/interactive/fountain,/turf/simulated/floor/colored/ash/necro,/area/dmm_suite/clear_area)
"j" = (/turf/simulated/floor/colored/ash/dark,/area/dmm_suite/clear_area)
"k" = (/obj/structure/table/simple/boss,/obj/marker/spawning/random/ashwalker,/turf/simulated/floor/colored/ash/rocky,/area/dmm_suite/clear_area)
"l" = (/mob/living/advanced/npc/ashwalker/hunter,/turf/simulated/floor/colored/ash/rocky,/area/dmm_suite/clear_area)
"m" = (/obj/structure/interactive/plant/porcini_mushroom,/turf/simulated/floor/colored/ash/dark,/area/dmm_suite/clear_area)
"n" = (/obj/structure/table/simple/boss,/turf/simulated/floor/colored/ash/rocky,/area/dmm_suite/clear_area)
"o" = (/mob/living/advanced/npc/ashwalker/assassin,/turf/simulated/floor/colored/ash/necro,/area/dmm_suite/clear_area)
"p" = (/obj/structure/interactive/plant/embershroom_mushroom,/turf/simulated/floor/colored/ash/dark,/area/dmm_suite/clear_area)
"q" = (/turf/dmm_suite/no_wall,/area/dmm_suite/clear_area)
"r" = (/obj/marker/map_node/x2,/turf/simulated/floor/colored/ash/necro,/area/dmm_suite/clear_area)
"s" = (/obj/marker/map_node,/turf/dmm_suite/no_wall,/area/dmm_suite/clear_area)
"t" = (/obj/marker/map_node/x2,/turf/dmm_suite/no_wall,/area/dmm_suite/clear_area)
"u" = (/obj/marker/map_node,/turf/simulated/floor/colored/ash/necro,/area/dmm_suite/clear_area)

(1,1,1) = {"
aaaaaaaaaaaaaaaa
aaaaaaaaabbbaaaa
aaaaaaccaccbbbaa
aaabbbbbbkcbbaaa
aabbccaacfcjjjja
abcccdbuebcjmmma
abcghhfeabcjjjja
abcffkqebccjpppa
aacccnbboeelbbaa
aaabccbreqrebbaa
aaaagqqqeqqqqbaa
sqqqqqqiqqqqqqqs
qqqqqqqqqqqqqqqq
aaqqqtqqqqtqqaaa
aaaqqqqqqqqqaaaa
aaaaqqqqqqqaaaaa
"}
