"a" = (/turf/dmm_suite/clear_turf,/area/dmm_suite/clear_area)
"b" = (/turf/simulated/wall/boss,/area/dmm_suite/clear_area)
"c" = (/turf/simulated/floor/boss,/area/dmm_suite/clear_area)
"d" = (/turf/simulated/floor/colored/ash/necro,/area/dmm_suite/clear_area)
"e" = (/obj/marker/objective_spawn,/turf/dmm_suite/no_wall,/area/dmm_suite/clear_area)
"f" = (/obj/structure/interactive/door/wood,/turf/dmm_suite/no_wall,/area/dmm_suite/clear_area)
"g" = (/obj/structure/interactive/plant/cactus_fruit,/turf/dmm_suite/no_wall,/area/dmm_suite/clear_area)
"h" = (/obj/structure/interactive/basalt,/turf/dmm_suite/no_wall,/area/dmm_suite/clear_area)
"i" = (/turf/dmm_suite/no_wall,/area/dmm_suite/clear_area)
"j" = (/obj/structure/interactive/plant/embershroom_mushroom,/turf/dmm_suite/no_wall,/area/dmm_suite/clear_area)
"k" = (/obj/structure/interactive/plant/inocybe_mushroom,/turf/dmm_suite/no_wall,/area/dmm_suite/clear_area)
"l" = (/obj/structure/table/simple/boss,/obj/marker/spawning/random/ashwalker,/turf/dmm_suite/no_wall,/area/dmm_suite/clear_area)
"m" = (/obj/structure/table/simple/boss,/turf/simulated/floor/colored/ash/necro,/area/dmm_suite/clear_area)
"n" = (/obj/structure/table/simple/boss,/obj/marker/spawning/random/ashwalker,/turf/simulated/floor/colored/ash/necro,/area/dmm_suite/clear_area)
"o" = (/obj/marker/spawning/random/ashwalker,/turf/simulated/floor/boss,/area/dmm_suite/clear_area)
"p" = (/mob/living/advanced/npc/ashwalker/assassin,/turf/dmm_suite/no_wall,/area/dmm_suite/clear_area)
"q" = (/obj/marker/map_node,/mob/living/advanced/npc/ashwalker/warrior,/turf/simulated/floor/colored/ash/necro,/area/dmm_suite/clear_area)
"r" = (/mob/living/advanced/npc/ashwalker,/turf/simulated/floor/colored/ash/necro,/area/dmm_suite/clear_area)
"s" = (/mob/living/advanced/npc/ashwalker/hunter,/turf/simulated/floor/colored/ash/necro,/area/dmm_suite/clear_area)
"t" = (/mob/living/advanced/npc/ashwalker/warrior,/turf/dmm_suite/no_wall,/area/dmm_suite/clear_area)
"u" = (/obj/structure/table/cooking/bonfire,/turf/simulated/floor/boss,/area/dmm_suite/clear_area)
"v" = (/obj/marker/map_node,/turf/dmm_suite/no_wall,/area/dmm_suite/clear_area)
"w" = (/obj/marker/map_node,/turf/simulated/floor/boss,/area/dmm_suite/clear_area)
"x" = (/obj/marker/map_node,/turf/simulated/floor/colored/ash/necro,/area/dmm_suite/clear_area)
"y" = (/obj/marker/smart_clear_turf,/turf/dmm_suite/no_wall,/area/dmm_suite/clear_area)
"z" = (/obj/marker/smart_clear_turf,/turf/simulated/floor/colored/ash/necro,/area/dmm_suite/clear_area)

(1,1,1) = {"
aaaaaaaaaaaaaaaa
adddddddddddddda
adbbbbbbbbbbbbda
adbccccccccccbda
adbcpelmmnndcbda
adbcxiiiiddqcbda
iibcccccvccccbda
iibbbbbbfbbbbbdi
iydrddddvddsddzi
iividdviidxdddxi
iiggggithiibbbbi
iiiiiiviiivbuobi
aajjkkiiiiviwoba
aaaaaaiiiiibocba
aaaaaaiiiiibbbba
aaaaaaiiiiiaaaaa
"}
