//MAP CONVERTED BY dmm2tgm.py THIS HEADER COMMENT PREVENTS RECONVERSION, DO NOT REMOVE
"a" = (
/turf/dmm_suite/clear_turf,
/area/dmm_suite/clear_area)
"b" = (
/turf/simulated/floor/sidewalk,
/area/dmm_suite/clear_area)
"c" = (
/obj/decal/road_marking/solid_line{
	icon_state = "1";
	dir = 4
	},
/turf/simulated/floor/road,
/area/dmm_suite/clear_area)
"d" = (
/turf/simulated/floor/road,
/area/dmm_suite/clear_area)
"e" = (
/obj/decal/road_marking/dotted_line/half,
/turf/simulated/floor/road,
/area/dmm_suite/clear_area)
"f" = (
/obj/decal/road_marking/dotted_line/half{
	icon_state = "1";
	dir = 1
	},
/turf/simulated/floor/road,
/area/dmm_suite/clear_area)
"g" = (
/obj/marker/map_node/x4,
/obj/decal/road_marking/dotted_line/half{
	icon_state = "1";
	dir = 1
	},
/turf/simulated/floor/road,
/area/dmm_suite/clear_area)
"h" = (
/turf/dmm_suite/no_wall,
/area/dmm_suite/clear_area)
"i" = (
/obj/marker/prefab/house,
/turf/dmm_suite/no_wall,
/area/dmm_suite/clear_area)
"j" = (
/obj/structure/short_wall/wood,
/turf/dmm_suite/no_wall,
/area/dmm_suite/clear_area)
"k" = (
/obj/structure/interactive/plant/cabbage/crop,
/turf/simulated/floor/colored/dirt/soil,
/area/dmm_suite/clear_area)
"l" = (
/obj/structure/interactive/plant/corn/crop,
/turf/simulated/floor/colored/dirt/soil,
/area/dmm_suite/clear_area)
"m" = (
/mob/living/simple/passive/cow,
/turf/dmm_suite/no_wall,
/area/dmm_suite/clear_area)
"n" = (
/mob/living/simple/passive/chicken,
/turf/dmm_suite/no_wall,
/area/dmm_suite/clear_area)
"o" = (
/mob/living/advanced/npc/goblin,
/turf/dmm_suite/no_wall,
/area/dmm_suite/clear_area)

(1,1,1) = {"
a
j
j
j
j
j
j
j
j
j
j
j
j
j
j
j
j
j
j
j
j
j
j
j
j
j
j
j
j
j
j
j
j
j
j
j
j
j
j
j
j
j
j
j
j
j
j
j
j
j
j
j
j
j
j
a
b
c
d
e
f
d
c
b
"}
(2,1,1) = {"
a
j
a
a
a
a
a
a
a
a
a
a
a
a
a
a
a
a
a
a
a
a
a
a
a
a
a
j
h
h
h
h
h
h
h
h
h
h
h
h
h
h
h
h
h
h
h
h
h
h
h
h
h
h
j
a
b
c
d
e
f
d
c
b
"}
(3,1,1) = {"
a
j
a
a
a
a
a
a
a
a
a
a
a
a
a
a
a
a
a
a
a
a
a
a
a
a
a
j
h
l
l
l
l
l
l
l
l
l
l
l
l
l
l
l
l
l
l
l
l
l
l
l
l
h
j
a
b
c
d
e
f
d
c
b
"}
(4,1,1) = {"
a
j
a
a
a
a
a
a
a
a
a
a
a
a
a
a
a
a
a
a
a
a
a
a
a
a
a
j
h
h
o
h
h
h
h
h
h
h
h
h
h
h
h
h
h
h
h
h
h
h
h
h
h
h
j
a
b
c
d
e
g
d
c
b
"}
(5,1,1) = {"
a
j
a
a
a
a
a
a
a
a
a
a
a
a
a
a
a
a
a
a
a
a
a
a
a
a
a
j
h
l
l
l
l
l
l
l
l
l
l
l
l
l
l
l
l
l
l
l
l
l
l
l
l
h
j
a
b
c
d
e
f
d
c
b
"}
(6,1,1) = {"
a
j
a
a
a
j
j
j
j
j
j
a
a
a
a
a
a
a
a
a
a
a
a
a
a
a
a
j
h
h
h
h
h
h
h
h
h
h
h
h
h
h
h
h
h
h
h
h
h
h
h
h
h
h
j
a
b
c
d
e
f
d
c
b
"}
(7,1,1) = {"
a
j
a
a
a
j
n
h
h
h
j
a
a
a
a
a
a
a
a
a
a
a
a
a
a
a
a
j
h
l
l
l
l
l
l
l
l
l
l
l
l
l
l
l
l
l
l
l
l
l
l
l
l
h
j
a
b
c
d
e
f
d
c
b
"}
(8,1,1) = {"
a
j
a
a
a
j
h
n
n
h
h
h
h
h
a
a
a
a
a
a
a
a
a
a
a
a
a
j
h
h
h
h
h
h
h
h
h
h
h
h
h
h
h
h
h
h
h
h
h
h
h
h
h
h
j
a
b
c
d
e
f
d
c
b
"}
(9,1,1) = {"
a
j
a
a
a
j
h
h
h
h
h
h
h
h
a
a
a
a
a
a
a
a
a
a
a
a
a
j
h
l
l
l
l
l
l
l
l
l
l
l
l
l
l
l
l
l
l
l
l
l
l
l
l
h
j
a
b
c
d
e
f
d
c
b
"}
(10,1,1) = {"
a
j
a
a
a
j
n
h
h
h
j
a
h
h
h
a
a
a
a
a
a
a
a
a
a
a
a
j
h
h
h
h
h
h
h
h
h
h
h
h
h
h
h
h
h
h
h
h
h
h
h
h
h
h
j
a
b
c
d
e
f
d
c
b
"}
(11,1,1) = {"
a
j
a
a
a
j
h
n
h
n
j
a
h
h
h
h
a
a
a
a
a
a
a
a
a
a
a
j
h
l
l
l
l
l
l
l
l
l
l
l
l
l
l
l
l
l
l
l
l
l
l
l
l
h
j
a
b
c
d
e
g
d
c
b
"}
(12,1,1) = {"
a
j
a
a
a
j
j
j
j
j
j
a
a
a
h
h
h
a
a
a
a
a
a
a
a
a
a
j
h
h
h
h
h
h
h
h
h
h
h
h
h
h
h
h
h
h
h
h
h
h
h
h
h
h
j
a
b
c
d
e
f
d
c
b
"}
(13,1,1) = {"
a
j
a
a
a
a
a
a
a
a
a
a
a
a
h
h
h
h
a
a
a
a
a
a
a
a
a
j
h
l
l
l
l
l
l
l
l
l
l
l
l
l
l
l
l
l
l
l
l
l
l
l
l
h
j
a
b
c
d
e
f
d
c
b
"}
(14,1,1) = {"
a
j
a
a
a
a
a
a
a
a
a
a
a
a
h
h
h
h
a
a
a
a
a
a
a
a
a
j
h
h
h
h
h
h
h
h
h
h
h
h
h
h
h
h
o
h
h
h
h
h
h
h
h
h
j
a
b
c
d
e
f
d
c
b
"}
(15,1,1) = {"
a
j
a
a
a
a
a
a
a
a
a
a
a
a
a
h
h
h
a
a
a
a
a
a
a
a
a
j
h
l
l
l
l
l
l
l
l
l
l
l
l
l
l
l
l
l
l
l
l
l
l
l
l
h
j
a
b
c
d
e
f
d
c
b
"}
(16,1,1) = {"
a
j
a
a
a
a
a
a
a
a
a
a
a
a
a
a
h
h
h
a
a
a
a
a
a
a
a
j
h
h
h
h
h
h
h
h
h
h
h
h
h
h
h
h
h
h
h
h
h
h
h
h
h
h
j
a
b
c
d
e
f
d
c
b
"}
(17,1,1) = {"
a
j
a
a
a
a
a
a
a
a
a
a
a
a
a
a
a
h
h
h
a
a
a
a
a
a
a
j
h
l
l
l
l
l
l
l
l
l
l
l
l
l
l
l
l
l
l
l
l
l
l
l
l
h
j
a
b
c
d
e
f
d
c
b
"}
(18,1,1) = {"
a
j
a
a
a
a
a
a
a
a
a
a
a
a
a
a
a
a
h
h
h
a
a
a
a
a
a
j
h
h
h
o
h
h
h
h
h
h
h
h
h
h
h
h
h
h
h
h
h
h
h
h
h
h
j
a
b
c
d
e
g
d
c
b
"}
(19,1,1) = {"
a
j
a
a
a
a
a
a
a
a
a
a
a
a
a
a
a
a
h
h
h
a
a
a
a
a
a
j
h
l
l
l
l
l
l
l
l
l
l
l
l
l
l
l
l
l
l
l
l
l
l
l
l
h
j
a
b
c
d
e
f
d
c
b
"}
(20,1,1) = {"
a
j
a
a
a
a
a
a
a
a
a
a
a
a
a
a
a
a
a
h
h
h
h
h
h
a
a
j
h
h
h
h
h
h
h
h
h
h
h
h
h
h
h
h
h
h
h
h
h
h
h
h
h
h
j
a
b
c
d
e
f
d
c
b
"}
(21,1,1) = {"
a
j
a
a
a
a
a
a
a
a
a
a
a
a
a
a
a
a
a
a
a
h
h
h
h
a
a
j
h
l
l
l
l
l
l
l
l
l
l
l
l
l
l
l
l
l
l
l
l
l
l
l
l
h
j
a
b
c
d
e
f
d
c
b
"}
(22,1,1) = {"
a
j
a
a
a
a
a
a
a
a
a
a
a
a
a
a
a
a
a
a
a
a
h
h
h
h
a
h
h
h
h
h
h
h
h
h
h
h
h
h
h
h
h
h
h
h
h
h
h
h
h
h
h
h
j
a
b
c
d
e
f
d
c
b
"}
(23,1,1) = {"
a
j
a
a
a
a
a
a
a
a
a
a
a
a
a
a
a
a
a
a
a
a
a
a
h
h
a
h
h
l
l
l
l
l
l
l
l
l
l
l
l
l
l
l
l
l
l
l
l
l
l
l
l
h
j
a
b
c
d
e
f
d
c
b
"}
(24,1,1) = {"
a
j
a
a
a
a
a
a
a
a
a
a
a
a
a
a
a
a
a
a
a
i
a
a
h
h
a
h
h
h
h
h
h
h
h
h
h
h
h
h
h
h
h
h
h
h
h
h
h
h
h
h
h
h
j
a
b
c
d
e
f
d
c
b
"}
(25,1,1) = {"
a
j
a
a
a
a
a
a
a
a
a
a
a
a
a
a
a
a
a
a
a
h
h
a
h
h
a
j
h
l
l
l
l
l
l
l
l
l
l
l
l
l
l
l
l
l
l
l
l
l
l
l
l
h
j
a
b
c
d
e
g
d
c
b
"}
(26,1,1) = {"
a
j
a
a
a
a
a
a
a
a
a
a
h
h
h
h
h
h
h
h
a
h
h
h
h
h
a
j
h
h
h
h
o
h
h
h
h
h
h
h
h
h
h
h
h
h
h
h
h
h
h
h
h
h
j
a
b
c
d
e
f
d
c
b
"}
(27,1,1) = {"
a
j
a
a
a
a
a
a
a
a
a
a
h
h
h
h
h
h
h
h
h
h
h
h
h
h
a
j
h
h
h
h
h
h
h
h
h
h
h
h
h
h
h
h
h
h
h
h
h
h
h
h
h
h
j
a
b
c
d
e
f
d
c
b
"}
(28,1,1) = {"
a
j
a
a
a
a
a
a
a
a
a
a
h
h
h
h
h
h
h
h
h
h
h
h
h
h
a
j
j
j
j
j
j
j
j
j
j
j
j
j
j
j
j
j
j
j
j
j
j
j
j
j
j
j
j
a
b
c
d
e
f
d
c
b
"}
(29,1,1) = {"
a
j
a
a
a
a
a
a
a
a
a
a
h
h
h
h
h
h
h
h
h
h
h
h
h
h
h
h
h
h
h
h
h
h
h
h
h
h
h
h
h
h
h
h
h
h
h
h
h
h
h
h
h
h
h
h
h
c
d
e
f
d
c
b
"}
(30,1,1) = {"
a
j
a
a
a
a
a
a
a
a
a
a
h
h
h
h
h
h
h
h
h
h
h
h
h
h
h
h
h
h
h
h
h
h
h
h
h
h
h
h
h
h
h
h
h
h
h
h
h
h
h
h
h
h
h
h
h
c
d
e
f
d
c
b
"}
(31,1,1) = {"
a
j
a
a
a
a
a
a
a
a
a
a
h
h
h
h
h
h
h
h
h
h
h
h
h
h
h
h
h
h
h
h
h
h
h
h
h
h
h
h
h
h
h
h
h
h
h
h
h
h
h
h
h
h
h
h
h
c
d
e
f
d
c
b
"}
(32,1,1) = {"
a
j
a
a
a
a
a
a
a
a
a
a
h
h
h
h
h
h
h
h
h
h
h
h
h
h
h
h
h
h
h
h
h
h
h
h
h
h
h
h
h
h
h
h
h
h
h
h
h
h
h
h
h
h
h
h
h
c
d
e
g
d
c
b
"}
(33,1,1) = {"
a
j
a
a
a
a
a
a
a
a
a
a
h
h
h
h
h
h
h
h
h
h
h
h
h
h
h
h
h
h
h
h
h
h
h
h
h
h
h
h
h
h
h
h
h
h
h
h
h
h
h
h
h
h
h
h
h
c
d
e
f
d
c
b
"}
(34,1,1) = {"
a
j
a
a
a
a
a
a
a
a
a
a
h
h
h
h
h
h
h
h
h
h
h
h
h
h
h
h
h
h
h
h
h
h
h
h
h
h
h
h
h
h
h
h
h
h
h
h
h
h
h
h
h
h
h
h
h
c
d
e
f
d
c
b
"}
(35,1,1) = {"
a
j
a
a
a
a
a
a
a
a
a
a
h
h
h
h
h
h
h
h
h
h
h
h
h
h
h
j
j
j
j
j
j
j
j
j
j
j
j
j
j
j
j
j
j
j
j
j
j
j
j
j
j
j
j
a
b
c
d
e
f
d
c
b
"}
(36,1,1) = {"
a
j
a
a
a
a
a
a
a
a
a
a
h
h
h
h
h
h
h
h
h
h
h
h
h
h
h
j
h
h
h
h
h
h
h
h
h
h
h
h
h
h
h
h
h
h
h
h
h
h
h
h
h
h
j
a
b
c
d
e
f
d
c
b
"}
(37,1,1) = {"
a
j
a
a
a
a
a
a
a
a
a
a
h
h
h
h
h
h
h
h
a
h
h
h
h
h
h
j
h
h
h
h
h
h
h
h
h
h
h
h
h
h
h
h
h
h
h
h
h
h
h
h
h
h
j
a
b
c
d
e
f
d
c
b
"}
(38,1,1) = {"
a
j
a
a
a
a
a
a
a
a
a
a
a
a
a
a
a
a
a
h
h
h
h
h
h
a
a
j
h
k
k
k
k
k
k
k
k
k
k
k
k
k
k
k
k
k
k
k
k
k
k
k
k
h
j
a
b
c
d
e
f
d
c
b
"}
(39,1,1) = {"
a
j
a
a
a
a
a
a
a
a
a
a
a
a
a
a
a
a
h
h
h
h
h
h
a
a
a
h
h
h
o
h
h
h
h
h
h
h
h
h
h
h
h
h
h
h
h
h
h
h
h
h
h
h
j
a
b
c
d
e
g
d
c
b
"}
(40,1,1) = {"
a
j
a
a
a
a
a
a
a
a
a
a
a
a
a
a
a
h
h
h
h
h
h
h
a
a
a
h
h
k
k
k
k
k
k
k
k
k
k
k
k
k
k
k
k
k
k
k
k
k
k
k
k
h
j
a
b
c
d
e
f
d
c
b
"}
(41,1,1) = {"
a
j
a
a
a
a
a
a
a
a
a
a
a
a
a
h
h
h
h
h
h
h
h
a
a
a
a
h
h
h
h
h
h
h
h
h
h
h
h
h
h
o
h
h
h
h
h
h
h
h
h
h
h
h
j
a
b
c
d
e
f
d
c
b
"}
(42,1,1) = {"
a
j
a
a
a
a
a
a
a
a
a
a
a
a
h
h
h
h
h
h
h
h
a
a
a
a
a
j
h
k
k
k
k
k
k
k
k
k
k
k
k
k
k
k
k
k
k
k
k
k
k
k
k
h
j
a
b
c
d
e
f
d
c
b
"}
(43,1,1) = {"
a
j
a
a
a
a
a
a
a
a
a
a
a
a
h
h
h
h
h
h
a
a
a
a
a
a
a
j
h
h
h
h
h
h
h
h
h
h
h
h
h
h
h
h
h
h
h
h
h
h
h
h
h
h
j
a
b
c
d
e
f
d
c
b
"}
(44,1,1) = {"
a
j
a
a
a
a
a
a
a
a
a
a
a
a
h
h
h
h
h
a
a
a
a
a
a
a
a
j
h
k
k
k
k
k
k
k
k
k
k
k
k
k
k
k
k
k
k
k
k
k
k
k
k
h
j
a
b
c
d
e
f
d
c
b
"}
(45,1,1) = {"
a
j
a
a
a
a
a
a
a
a
a
a
a
a
h
h
h
h
a
a
a
a
a
a
a
a
a
j
h
h
h
h
h
h
h
h
h
h
h
h
h
h
h
h
h
h
h
h
h
h
h
h
h
h
j
a
b
c
d
e
f
d
c
b
"}
(46,1,1) = {"
a
j
a
a
a
a
a
a
j
j
j
j
j
j
h
h
h
j
j
j
j
j
j
a
a
a
a
j
h
k
k
k
k
k
k
k
k
k
k
k
k
k
k
k
k
k
k
k
k
k
k
k
k
h
j
a
b
c
d
e
g
d
c
b
"}
(47,1,1) = {"
a
j
a
a
a
a
a
a
j
h
h
h
h
h
h
h
h
h
h
h
h
h
j
a
a
a
a
j
h
h
h
h
h
h
h
h
h
h
h
h
h
h
h
h
h
h
h
h
h
h
h
h
h
h
j
a
b
c
d
e
f
d
c
b
"}
(48,1,1) = {"
a
j
a
a
a
a
a
a
j
h
h
h
h
h
h
h
h
h
h
h
h
h
j
a
a
a
a
j
h
k
k
k
k
k
k
k
k
k
k
k
k
k
k
k
k
k
k
k
k
k
k
k
k
h
j
a
b
c
d
e
f
d
c
b
"}
(49,1,1) = {"
a
j
a
a
a
a
a
a
j
h
h
m
h
h
h
m
h
h
h
m
h
h
j
a
a
a
a
j
h
h
h
h
h
h
h
h
h
h
h
h
h
h
h
h
h
h
h
h
h
h
h
h
h
h
j
a
b
c
d
e
f
d
c
b
"}
(50,1,1) = {"
a
j
a
a
a
a
a
a
j
h
h
h
h
h
h
h
h
h
h
h
h
h
j
a
a
a
a
j
h
k
k
k
k
k
k
k
k
k
k
k
k
k
k
k
k
k
k
k
k
k
k
k
k
h
j
a
b
c
d
e
f
d
c
b
"}
(51,1,1) = {"
a
j
a
a
a
a
a
a
j
h
h
h
h
h
h
h
h
h
h
h
h
h
j
a
a
a
a
j
h
h
h
h
h
h
h
h
h
h
o
h
h
h
h
h
h
h
h
h
h
h
h
h
h
h
j
a
b
c
d
e
f
d
c
b
"}
(52,1,1) = {"
a
j
a
a
a
a
a
a
j
h
h
h
h
h
h
h
h
h
h
h
h
h
j
a
a
a
a
j
h
k
k
k
k
k
k
k
k
k
k
k
k
k
k
k
k
k
k
k
k
k
k
k
k
h
j
a
b
c
d
e
f
d
c
b
"}
(53,1,1) = {"
a
j
a
a
a
a
a
a
j
h
h
h
h
m
h
h
h
m
h
h
m
h
j
a
a
a
a
j
h
h
h
h
h
h
h
h
h
h
h
h
h
h
h
h
h
h
h
h
h
h
h
h
h
h
j
a
b
c
d
e
g
d
c
b
"}
(54,1,1) = {"
a
j
a
a
a
a
a
a
j
h
h
h
h
h
h
h
h
h
h
h
h
h
j
a
a
a
a
j
h
k
k
k
k
k
k
k
k
k
k
k
k
k
k
k
k
k
k
k
k
k
k
k
k
h
j
a
b
c
d
e
f
d
c
b
"}
(55,1,1) = {"
a
j
a
a
a
a
a
a
j
h
h
h
h
h
h
h
h
h
h
h
h
h
j
a
a
a
a
j
h
h
h
o
h
h
h
h
h
h
h
h
h
h
o
h
h
h
h
h
h
h
h
h
h
h
j
a
b
c
d
e
f
d
c
b
"}
(56,1,1) = {"
a
j
a
a
a
a
a
a
j
h
h
h
h
h
h
h
h
h
h
h
h
h
j
a
a
a
a
j
h
k
k
k
k
k
k
k
k
k
k
k
k
k
k
k
k
k
k
k
k
k
k
k
k
h
j
a
b
c
d
e
f
d
c
b
"}
(57,1,1) = {"
a
j
a
a
a
a
a
a
j
j
j
j
j
j
j
j
j
j
j
j
j
j
j
a
a
a
a
j
h
h
h
h
h
h
h
h
h
h
h
h
h
h
h
h
h
h
h
h
h
h
h
h
h
h
j
a
b
c
d
e
f
d
c
b
"}
(58,1,1) = {"
a
j
a
a
a
a
a
a
a
a
a
a
a
a
a
a
a
a
a
a
a
a
a
a
a
a
a
j
h
k
k
k
k
k
k
k
k
k
k
k
k
k
k
k
k
k
k
k
k
k
k
k
k
h
j
a
b
c
d
e
f
d
c
b
"}
(59,1,1) = {"
a
j
a
a
a
a
a
a
a
a
a
a
a
a
a
a
a
a
a
a
a
a
a
a
a
a
a
j
h
h
h
h
h
h
h
h
h
h
h
h
h
h
h
h
h
h
h
h
h
h
h
h
h
h
j
a
b
c
d
e
f
d
c
b
"}
(60,1,1) = {"
a
j
a
a
a
a
a
a
a
a
a
a
a
a
a
a
a
a
a
a
a
a
a
a
a
a
a
j
h
k
k
k
k
k
k
k
k
k
k
k
k
k
k
k
k
k
k
k
k
k
k
k
k
h
j
a
b
c
d
e
g
d
c
b
"}
(61,1,1) = {"
a
j
a
a
a
a
a
a
a
a
a
a
a
a
a
a
a
a
a
a
a
a
a
a
a
a
a
j
h
h
h
h
h
h
h
h
h
h
h
h
h
h
h
h
h
h
h
h
h
h
h
h
h
h
j
a
b
c
d
e
f
d
c
b
"}
(62,1,1) = {"
a
j
a
a
a
a
a
a
a
a
a
a
a
a
a
a
a
a
a
a
a
a
a
a
a
a
a
j
h
k
k
k
k
k
k
k
k
k
k
k
k
k
k
k
k
k
k
k
k
k
k
k
k
h
j
a
b
c
d
e
f
d
c
b
"}
(63,1,1) = {"
a
j
a
a
a
a
a
a
a
a
a
a
a
a
a
a
a
a
a
a
a
a
a
a
a
a
a
j
h
h
h
h
h
h
h
h
h
h
h
h
h
h
h
h
h
h
h
h
h
h
h
h
h
h
j
a
b
c
d
e
f
d
c
b
"}
(64,1,1) = {"
a
j
j
j
j
j
j
j
j
j
j
j
j
j
j
j
j
j
j
j
j
j
j
j
j
j
j
j
j
j
j
j
j
j
j
j
j
j
j
j
j
j
j
j
j
j
j
j
j
j
j
j
j
j
j
a
b
c
d
e
f
d
c
b
"}
