"a" = (/turf/dmm_suite/clear_turf,/area/dmm_suite/clear_area)
"b" = (/turf/simulated/floor/sidewalk,/area/dmm_suite/clear_area)
"c" = (/obj/decal/road_marking/solid_line{icon_state = "1"; dir = 4},/turf/simulated/floor/road,/area/dmm_suite/clear_area)
"d" = (/turf/simulated/floor/road,/area/dmm_suite/clear_area)
"e" = (/obj/decal/road_marking/dotted_line/half,/turf/simulated/floor/road,/area/dmm_suite/clear_area)
"f" = (/obj/decal/road_marking/dotted_line/half{icon_state = "1"; dir = 1},/turf/simulated/floor/road,/area/dmm_suite/clear_area)
"g" = (/obj/marker/map_node/x4,/obj/decal/road_marking/dotted_line/half{icon_state = "1"; dir = 1},/turf/simulated/floor/road,/area/dmm_suite/clear_area)
"h" = (/turf/dmm_suite/no_wall,/area/dmm_suite/clear_area)
"i" = (/obj/marker/prefab/house,/turf/dmm_suite/no_wall,/area/dmm_suite/clear_area)
"j" = (/obj/structure/short_wall/wood,/turf/dmm_suite/no_wall,/area/dmm_suite/clear_area)
"k" = (/obj/structure/interactive/plant/cabbage/crop,/turf/simulated/floor/colored/dirt/soil,/area/dmm_suite/clear_area)
"l" = (/obj/structure/interactive/plant/corn/crop,/turf/simulated/floor/colored/dirt/soil,/area/dmm_suite/clear_area)
"m" = (/mob/living/simple/passive/cow,/turf/dmm_suite/no_wall,/area/dmm_suite/clear_area)
"n" = (/mob/living/simple/passive/chicken,/turf/dmm_suite/no_wall,/area/dmm_suite/clear_area)
"o" = (/mob/living/advanced/npc/goblin,/turf/dmm_suite/no_wall,/area/dmm_suite/clear_area)

(1,1,1) = {"
aaaaaaaaaaaaaaaaaaaaaaaaaaaaaaaaaaaaaaaaaaaaaaaaaaaaaaaaaaaaaaaa
jjjjjjjjjjjjjjjjjjjjjjjjjjjjjjjjjjjjjjjjjjjjjjjjjjjjjjjjjjjjjjjj
jaaaaaaaaaaaaaaaaaaaaaaaaaaaaaaaaaaaaaaaaaaaaaaaaaaaaaaaaaaaaaaj
jaaaaaaaaaaaaaaaaaaaaaaaaaaaaaaaaaaaaaaaaaaaaaaaaaaaaaaaaaaaaaaj
jaaaaaaaaaaaaaaaaaaaaaaaaaaaaaaaaaaaaaaaaaaaaaaaaaaaaaaaaaaaaaaj
jaaaajjjjjjjaaaaaaaaaaaaaaaaaaaaaaaaaaaaaaaaaaaaaaaaaaaaaaaaaaaj
jaaaajnhhnhjaaaaaaaaaaaaaaaaaaaaaaaaaaaaaaaaaaaaaaaaaaaaaaaaaaaj
jaaaajhnhhnjaaaaaaaaaaaaaaaaaaaaaaaaaaaaaaaaaaaaaaaaaaaaaaaaaaaj
jaaaajhnhhhjaaaaaaaaaaaaaaaaaaaaaaaaaaaaaaaaajjjjjjjjjjjjaaaaaaj
jaaaajhhhhnjaaaaaaaaaaaaaaaaaaaaaaaaaaaaaaaaajhhhhhhhhhhjaaaaaaj
jaaaajjhhjjjaaaaaaaaaaaaaaaaaaaaaaaaaaaaaaaaajhhhhhhhhhhjaaaaaaj
jaaaaaahhaaaaaaaaaaaaaaaaaaaaaaaaaaaaaaaaaaaajhhmhhhhhhhjaaaaaaj
jaaaaaahhhhaaaaaaaaaaaaaahhhhhhhhhhhhaaaaaaaajhhhhhhhhhhjaaaaaaj
jaaaaaahhhhaaaaaaaaaaaaaahhhhhhhhhhhhaaaaaaaajhhhhhhmhhhjaaaaaaj
jaaaaaaaahhhhhaaaaaaaaaaahhhhhhhhhhhhaaaahhhhhhhhhhhhhhhjaaaaaaj
jaaaaaaaaahhhhhaaaaaaaaaahhhhhhhhhhhhaaahhhhhhhhmhhhhhhhjaaaaaaj
jaaaaaaaaaahhhhhaaaaaaaaahhhhhhhhhhhhaaahhhhhhhhhhhhhhhhjaaaaaaj
jaaaaaaaaaaahhhhhaaaaaaaahhhhhhhhhhhhaahhhhhhjhhhhhhmhhhjaaaaaaj
jaaaaaaaaaaaaaahhhhaaaaaahhhhhhhhhhhhahhhhhhajhhhhhhhhhhjaaaaaaj
jaaaaaaaaaaaaaaahhhhaaaaahhhhhhhhhhhhhhhhhhaajhhmhhhhhhhjaaaaaaj
jaaaaaaaaaaaaaaaahhhaaaaaahhhhhhhhhhahhhhhaaajhhhhhhmhhhjaaaaaaj
jaaaaaaaaaaaaaaaaaahhaaihhhhhhhhhhhhhhhhhhaaajhhhhhhhhhhjaaaaaaj
jaaaaaaaaaaaaaaaaaahhhaahhhhhhhhhhhhhhhhhaaaajjjjjjjjjjjjaaaaaaj
jaaaaaaaaaaaaaaaaaahhhaaahhhhhhhhhhhhhhhaaaaaaaaaaaaaaaaaaaaaaaj
jaaaaaaaaaaaaaaaaaahhhhhhhhhhhhhhhhhhhaaaaaaaaaaaaaaaaaaaaaaaaaj
jaaaaaaaaaaaaaaaaaaaahhhhhhhhhhhhhhhhaaaaaaaaaaaaaaaaaaaaaaaaaaj
jaaaaaaaaaaaaaaaaaaaaaaaaaaahhhhhhhhhaaaaaaaaaaaaaaaaaaaaaaaaaaj
jjjjjjjjjjjjjjjjjjjjjhhhjjjjhhhhhhjjjjhhhjjjjjjjjjjjjjjjjjjjjjjj
jhhhhhhhhhhhhhhhhhhhhhhhhhhjhhhhhhjhhhhhhhhhhhhhhhhhhhhhhhhhhhhj
jhlhlhlhlhlhlhlhlhlhlhlhlhhjhhhhhhjhhkhkhkhkhkhkhkhkhkhkhkhkhkhj
jhlolhlhlhlhlhlhlhlhlhlhlhhjhhhhhhjhhkokhkhkhkhkhkhkhkhkhkhkhkhj
jhlhlhlhlhlhlhlhlolhlhlhlhhjhhhhhhjhhkhkhkhkhkhkhkhkhkokhkhkhkhj
jhlhlhlhlhlhlhlhlhlhlhlhlohjhhhhhhjhhkhkhkhkhkhkhkhkhkhkhkhkhkhj
jhlhlhlhlhlhlhlhlhlhlhlhlhhjhhhhhhjhhkhkhkhkhkhkhkhkhkhkhkhkhkhj
jhlhlhlhlhlhlhlhlhlhlhlhlhhjhhhhhhjhhkhkhkhkhkhkhkhkhkhkhkhkhkhj
jhlhlhlhlhlhlhlhlhlhlhlhlhhjhhhhhhjhhkhkhkhkhkhkhkhkhkhkhkhkhkhj
jhlhlhlhlhlhlhlhlhlhlhlhlhhjhhhhhhjhhkhkhkhkhkhkhkhkhkhkhkhkhkhj
jhlhlhlhlhlhlhlhlhlhlhlhlhhjhhhhhhjhhkhkhkhkhkhkhkhkhkhkhkhkhkhj
jhlhlhlhlhlhlhlhlhlhlhlhlhhjhhhhhhjhhkhkhkhkhkhkhkokhkhkhkhkhkhj
jhlhlhlhlhlhlhlhlhlhlhlhlhhjhhhhhhjhhkhkhkhkhkhkhkhkhkhkhkhkhkhj
jhlhlhlhlhlhlhlhlhlhlhlhlhhjhhhhhhjhhkhkhkhkhkhkhkhkhkhkhkhkhkhj
jhlhlhlhlhlhlhlhlhlhlhlhlhhjhhhhhhjhhkhkokhkhkhkhkhkhkhkhkhkhkhj
jhlhlhlhlhlhlhlhlhlhlhlhlhhjhhhhhhjhhkhkhkhkhkhkhkhkhkokhkhkhkhj
jhlhlhlhlhlhlhlhlhlhlhlhlhhjhhhhhhjhhkhkhkhkhkhkhkhkhkhkhkhkhkhj
jhlhlhlhlhlhlolhlhlhlhlhlhhjhhhhhhjhhkhkhkhkhkhkhkhkhkhkhkhkhkhj
jhlhlhlhlhlhlhlhlhlhlhlhlhhjhhhhhhjhhkhkhkhkhkhkhkhkhkhkhkhkhkhj
jhlhlhlhlhlhlhlhlhlhlhlhlhhjhhhhhhjhhkhkhkhkhkhkhkhkhkhkhkhkhkhj
jhlhlhlhlhlhlhlhlhlhlhlhlhhjhhhhhhjhhkhkhkhkhkhkhkhkhkhkhkhkhkhj
jhlhlhlhlhlhlhlhlhlhlhlhlhhjhhhhhhjhhkhkhkhkhkhkhkhkhkhkhkhkhkhj
jhlhlhlhlhlhlhlhlhlhlhlhlhhjhhhhhhjhhkhkhkhkhkhkhkhkhkhkhkhkhkhj
jhlhlhlhlhlhlhlhlhlhlhlhlhhjhhhhhhjhhkhkhkhkhkhkhkhkhkhkhkhkhkhj
jhlhlhlhlhlhlhlhlhlhlhlhlhhjhhhhhhjhhkhkhkhkhkhkhkhkhkhkhkhkhkhj
jhlhlhlhlhlhlhlhlhlhlhlhlhhjhhhhhhjhhkhkhkhkhkhkhkhkhkhkhkhkhkhj
jhhhhhhhhhhhhhhhhhhhhhhhhhhjhhhhhhjhhhhhhhhhhhhhhhhhhhhhhhhhhhhj
jjjjjjjjjjjjjjjjjjjjjjjjjjjjhhhhhhjjjjjjjjjjjjjjjjjjjjjjjjjjjjjj
aaaaaaaaaaaaaaaaaaaaaaaaaaaahhhhhhaaaaaaaaaaaaaaaaaaaaaaaaaaaaaa
bbbbbbbbbbbbbbbbbbbbbbbbbbbbhhhhhhbbbbbbbbbbbbbbbbbbbbbbbbbbbbbb
cccccccccccccccccccccccccccccccccccccccccccccccccccccccccccccccc
dddddddddddddddddddddddddddddddddddddddddddddddddddddddddddddddd
eeeeeeeeeeeeeeeeeeeeeeeeeeeeeeeeeeeeeeeeeeeeeeeeeeeeeeeeeeeeeeee
fffgffffffgffffffgffffffgffffffgffffffgffffffgffffffgffffffgffff
dddddddddddddddddddddddddddddddddddddddddddddddddddddddddddddddd
cccccccccccccccccccccccccccccccccccccccccccccccccccccccccccccccc
bbbbbbbbbbbbbbbbbbbbbbbbbbbbbbbbbbbbbbbbbbbbbbbbbbbbbbbbbbbbbbbb
"}
