//MAP CONVERTED BY dmm2tgm.py THIS HEADER COMMENT PREVENTS RECONVERSION, DO NOT REMOVE
"a" = (
/turf/dmm_suite/clear_turf,
/area/dmm_suite/clear_area)
"b" = (
/turf/simulated/liquid/lava,
/area/dmm_suite/clear_area)
"c" = (
/turf/simulated/floor/basalt,
/area/dmm_suite/clear_area)
"d" = (
/turf/simulated/floor/boss,
/area/dmm_suite/clear_area)
"e" = (
/obj/marker/map_node,
/turf/simulated/floor/boss,
/area/dmm_suite/clear_area)
"f" = (
/obj/marker/map_node/x2,
/turf/simulated/floor/boss,
/area/dmm_suite/clear_area)
"g" = (
/obj/marker/map_node/x3,
/mob/living/simple/ash_drake,
/turf/simulated/floor/basalt,
/area/dmm_suite/clear_area)
"h" = (
/obj/marker/map_node,
/turf/dmm_suite/clear_turf,
/area/dmm_suite/clear_area)

(1,1,1) = {"
a
a
a
a
a
a
a
b
b
b
b
b
b
b
c
e
c
a
a
a
a
a
a
a
a
a
a
a
a
a
a
a
"}
(2,1,1) = {"
a
a
a
a
a
b
b
b
b
b
b
b
b
b
c
d
c
a
a
a
a
a
a
a
a
a
a
a
a
a
a
a
"}
(3,1,1) = {"
a
a
a
a
b
b
b
b
b
b
b
b
b
b
c
d
c
a
a
a
a
a
a
a
a
a
a
a
a
a
a
a
"}
(4,1,1) = {"
a
a
a
b
b
b
b
b
b
b
b
b
b
b
c
d
c
b
a
a
a
a
a
a
a
a
a
a
a
a
a
a
"}
(5,1,1) = {"
a
a
a
b
b
b
b
b
b
b
b
b
b
b
c
d
c
b
a
a
a
a
a
a
a
a
a
a
a
a
a
a
"}
(6,1,1) = {"
a
a
b
b
b
b
b
b
b
b
b
b
b
b
c
d
c
b
b
b
b
b
b
b
b
b
a
a
a
a
a
a
"}
(7,1,1) = {"
a
a
b
b
b
b
b
b
b
b
b
b
b
b
c
d
c
b
b
b
b
b
b
b
b
b
b
b
a
a
a
a
"}
(8,1,1) = {"
a
b
b
b
b
b
b
b
b
b
b
b
b
b
c
d
c
b
b
b
b
b
b
b
b
b
b
b
b
b
a
a
"}
(9,1,1) = {"
a
b
b
b
b
b
b
b
b
b
b
b
b
b
c
d
c
b
b
b
b
b
b
b
b
b
b
b
b
b
a
a
"}
(10,1,1) = {"
a
b
b
b
b
b
b
b
b
b
b
b
b
b
c
f
c
b
b
b
b
b
b
b
b
b
b
b
b
b
a
a
"}
(11,1,1) = {"
b
b
b
b
b
b
b
b
b
b
b
b
b
b
c
d
c
b
b
b
b
b
b
b
b
b
b
b
b
b
a
a
"}
(12,1,1) = {"
b
b
b
b
b
b
b
b
b
b
b
b
b
b
c
d
c
b
b
b
b
b
b
b
b
b
b
b
b
b
a
a
"}
(13,1,1) = {"
b
b
b
b
b
b
b
b
b
b
b
b
b
c
c
d
c
c
b
b
b
b
b
b
b
b
b
b
b
b
a
a
"}
(14,1,1) = {"
b
b
b
b
b
b
b
b
b
b
b
b
c
d
d
d
d
d
c
b
b
b
b
b
b
b
b
b
b
b
a
a
"}
(15,1,1) = {"
c
c
c
c
c
c
c
c
c
c
c
c
c
d
c
c
c
d
c
c
c
c
c
c
c
c
c
c
c
c
c
a
"}
(16,1,1) = {"
e
d
d
d
d
d
d
d
f
d
d
d
d
d
c
g
c
d
d
d
f
d
d
d
d
f
d
d
d
d
d
h
"}
(17,1,1) = {"
c
c
c
c
c
c
c
c
c
c
c
c
c
d
c
c
c
d
c
c
c
c
c
c
c
c
c
c
c
c
c
c
"}
(18,1,1) = {"
b
b
b
b
b
b
b
b
b
b
b
b
c
d
d
d
d
d
c
b
b
b
b
b
b
b
b
b
b
b
b
b
"}
(19,1,1) = {"
b
b
b
b
b
b
b
b
b
b
b
b
b
c
c
d
c
c
b
b
b
b
b
b
b
b
b
b
b
b
b
b
"}
(20,1,1) = {"
b
b
b
b
b
b
b
b
b
b
b
b
b
b
c
d
c
b
b
b
b
b
b
b
b
b
b
b
b
b
b
b
"}
(21,1,1) = {"
a
b
b
b
b
b
b
b
b
b
b
b
b
b
c
d
c
b
b
b
b
b
b
b
b
b
b
b
b
b
b
b
"}
(22,1,1) = {"
a
b
b
b
b
b
b
b
b
b
b
b
b
b
c
d
c
b
b
b
b
b
b
b
b
b
b
b
b
b
b
b
"}
(23,1,1) = {"
a
a
b
b
b
b
b
b
b
b
b
b
b
b
c
f
c
b
b
b
b
b
b
b
b
b
b
b
b
b
b
b
"}
(24,1,1) = {"
a
a
a
b
b
b
b
b
b
b
b
b
b
b
c
d
c
b
b
b
b
b
b
b
b
b
b
b
b
b
b
b
"}
(25,1,1) = {"
a
a
a
a
b
b
b
b
b
b
b
b
b
b
c
d
c
b
b
b
b
b
b
b
b
b
b
b
b
b
b
b
"}
(26,1,1) = {"
a
a
a
a
a
b
b
b
b
b
b
b
b
b
c
d
c
b
b
b
b
b
b
b
b
b
b
b
b
b
b
b
"}
(27,1,1) = {"
a
a
a
a
a
b
b
b
b
b
b
b
b
b
c
d
c
b
b
b
b
b
b
b
b
b
b
b
b
b
b
b
"}
(28,1,1) = {"
a
a
a
a
a
a
b
b
b
b
b
b
b
b
c
d
c
b
b
b
b
b
b
b
b
b
b
b
b
b
b
a
"}
(29,1,1) = {"
a
a
a
a
a
a
a
b
b
b
b
b
b
b
c
d
c
b
b
b
b
b
b
b
b
b
b
b
b
b
a
a
"}
(30,1,1) = {"
a
a
a
a
a
a
a
a
a
b
b
b
b
b
c
d
c
b
b
b
b
b
b
b
b
b
b
b
b
b
a
a
"}
(31,1,1) = {"
a
a
a
a
a
a
a
a
a
a
a
a
b
b
c
d
c
b
b
b
b
b
b
b
b
b
b
b
b
a
a
a
"}
(32,1,1) = {"
a
a
a
a
a
a
a
a
a
a
a
a
a
a
c
e
c
b
b
b
b
b
b
b
b
b
b
b
a
a
a
a
"}
