//MAP CONVERTED BY dmm2tgm.py THIS HEADER COMMENT PREVENTS RECONVERSION, DO NOT REMOVE
"a" = (
/turf/dmm_suite/clear_turf,
/area/dmm_suite/clear_area)
"b" = (
/turf/simulated/floor/basalt,
/area/dmm_suite/clear_area)
"c" = (
/obj/marker/map_node/x2,
/turf/simulated/floor/basalt,
/area/dmm_suite/clear_area)
"d" = (
/turf/simulated/floor/boss,
/area/dmm_suite/clear_area)
"e" = (
/mob/living/simple/colossus,
/turf/simulated/floor/basalt,
/area/dmm_suite/clear_area)
"f" = (
/turf/dmm_suite/no_wall,
/area/dmm_suite/clear_area)
"g" = (
/obj/marker/map_node,
/turf/dmm_suite/no_wall,
/area/dmm_suite/clear_area)

(1,1,1) = {"
a
a
a
a
a
a
a
a
a
a
a
a
a
a
a
f
g
f
a
a
a
a
a
a
a
a
a
a
a
a
a
a
"}
(2,1,1) = {"
a
a
a
a
a
a
a
a
a
a
a
a
a
a
a
f
f
f
a
a
a
a
a
a
a
a
a
a
a
a
a
a
"}
(3,1,1) = {"
a
a
a
a
a
a
a
a
a
a
a
a
a
a
a
f
f
f
a
a
a
a
a
a
a
a
a
a
a
a
a
a
"}
(4,1,1) = {"
a
a
a
a
a
a
a
a
a
a
a
a
a
a
a
f
f
f
a
a
a
a
a
a
a
a
a
a
a
a
a
a
"}
(5,1,1) = {"
a
a
a
a
a
a
a
a
a
a
a
a
a
a
a
f
f
f
a
a
a
a
a
a
a
a
a
a
a
a
a
a
"}
(6,1,1) = {"
a
a
a
a
a
a
a
a
a
a
a
a
a
a
a
f
f
f
a
a
a
a
a
a
a
a
a
a
a
a
a
a
"}
(7,1,1) = {"
a
a
a
a
a
a
a
b
b
b
b
b
b
b
b
b
b
b
b
b
b
b
b
b
b
b
a
a
a
a
a
a
"}
(8,1,1) = {"
a
a
a
a
a
a
a
b
c
b
b
b
b
b
b
b
c
b
b
b
b
b
b
b
c
b
a
a
a
a
a
a
"}
(9,1,1) = {"
a
a
a
a
a
a
a
b
b
b
b
b
b
b
b
b
b
b
b
b
b
b
b
b
b
b
a
a
a
a
a
a
"}
(10,1,1) = {"
a
a
a
a
a
a
a
b
b
b
d
d
d
d
d
d
d
d
d
d
d
d
d
b
b
b
a
a
a
a
a
a
"}
(11,1,1) = {"
a
a
a
a
a
a
a
b
b
b
d
b
b
b
b
b
b
b
b
b
b
b
d
b
b
b
a
a
a
a
a
a
"}
(12,1,1) = {"
a
a
a
a
a
a
a
b
b
b
d
b
d
d
d
d
d
d
d
d
d
b
d
b
b
b
a
a
a
a
a
a
"}
(13,1,1) = {"
a
a
a
a
a
a
a
b
b
b
d
b
d
b
b
b
b
b
b
b
d
b
d
b
b
b
a
a
a
a
a
a
"}
(14,1,1) = {"
a
a
a
a
a
a
a
b
b
b
d
b
d
b
d
d
d
d
d
b
d
b
d
b
b
b
a
a
a
a
a
a
"}
(15,1,1) = {"
f
f
f
f
f
f
f
b
b
b
d
b
d
b
d
b
b
b
d
b
d
b
d
b
b
b
f
f
f
f
f
f
"}
(16,1,1) = {"
g
f
f
f
f
f
f
b
c
b
d
b
d
b
d
b
b
e
d
b
d
b
d
b
c
b
f
f
f
f
f
g
"}
(17,1,1) = {"
f
f
f
f
f
f
f
b
b
b
d
b
d
b
d
b
b
b
d
b
d
b
d
b
b
b
f
f
f
f
f
f
"}
(18,1,1) = {"
a
a
a
a
a
a
a
b
b
b
d
b
d
b
d
d
d
d
d
b
d
b
d
b
b
b
a
a
a
a
a
a
"}
(19,1,1) = {"
a
a
a
a
a
a
a
b
b
b
d
b
d
b
b
b
b
b
b
b
d
b
d
b
b
b
a
a
a
a
a
a
"}
(20,1,1) = {"
a
a
a
a
a
a
a
b
b
b
d
b
d
d
d
d
d
d
d
d
d
b
d
b
b
b
a
a
a
a
a
a
"}
(21,1,1) = {"
a
a
a
a
a
a
a
b
b
b
d
b
b
b
b
b
b
b
b
b
b
b
d
b
b
b
a
a
a
a
a
a
"}
(22,1,1) = {"
a
a
a
a
a
a
a
b
b
b
d
d
d
d
d
d
d
d
d
d
d
d
d
b
b
b
a
a
a
a
a
a
"}
(23,1,1) = {"
a
a
a
a
a
a
a
b
b
b
b
b
b
b
b
b
b
b
b
b
b
b
b
b
b
b
a
a
a
a
a
a
"}
(24,1,1) = {"
a
a
a
a
a
a
a
b
c
b
b
b
b
b
b
b
c
b
b
b
b
b
b
b
c
b
a
a
a
a
a
a
"}
(25,1,1) = {"
a
a
a
a
a
a
a
b
b
b
b
b
b
b
b
b
b
b
b
b
b
b
b
b
b
b
a
a
a
a
a
a
"}
(26,1,1) = {"
a
a
a
a
a
a
a
a
a
a
a
a
a
a
a
f
f
f
a
a
a
a
a
a
a
a
a
a
a
a
a
a
"}
(27,1,1) = {"
a
a
a
a
a
a
a
a
a
a
a
a
a
a
a
f
f
f
a
a
a
a
a
a
a
a
a
a
a
a
a
a
"}
(28,1,1) = {"
a
a
a
a
a
a
a
a
a
a
a
a
a
a
a
f
f
f
a
a
a
a
a
a
a
a
a
a
a
a
a
a
"}
(29,1,1) = {"
a
a
a
a
a
a
a
a
a
a
a
a
a
a
a
f
f
f
a
a
a
a
a
a
a
a
a
a
a
a
a
a
"}
(30,1,1) = {"
a
a
a
a
a
a
a
a
a
a
a
a
a
a
a
f
f
f
a
a
a
a
a
a
a
a
a
a
a
a
a
a
"}
(31,1,1) = {"
a
a
a
a
a
a
a
a
a
a
a
a
a
a
a
f
f
f
a
a
a
a
a
a
a
a
a
a
a
a
a
a
"}
(32,1,1) = {"
a
a
a
a
a
a
a
a
a
a
a
a
a
a
a
f
g
f
a
a
a
a
a
a
a
a
a
a
a
a
a
a
"}
