"a" = (/turf/simulated/floor/colored/grass/jungle,/area)
"b" = (/turf/simulated/wall/rock,/area)
"c" = (/turf/simulated/wall/river,/area)
"d" = (/turf/simulated/floor/wood/dock,/area)
"e" = (/turf/simulated/floor/colored/dirt/jungle,/area)
"f" = (/turf/simulated/floor/chasm,/area)
"g" = (/turf/simulated/floor/basalt,/area)
"h" = (/turf/simulated/floor/lava,/area)
"i" = (/turf/simulated/wall/metal/rusted,/area)
"j" = (/turf/simulated/floor/ash,/area)
"k" = (/turf/simulated/wall/rock/basalt,/area)
"l" = (/turf/simulated/floor/cave_dirt,/area)
"m" = (/obj/structure/interactive/nature/rocks,/turf/simulated/floor/colored/dirt/jungle,/area)
"n" = (/obj/structure/interactive/nature/rocks,/turf/simulated/floor/cave_dirt,/area)
"o" = (/obj/structure/interactive/nature/rocks,/turf/simulated/floor/basalt,/area)
"p" = (/obj/structure/interactive/nature/rocks,/turf/simulated/floor/colored/grass/jungle,/area)

(1,1,1) = {"
bbbbbbbbbbbbbbbbbbbbbbbbbbbbbbbbbbbbbbbbbbbbbbbbbbbbbbbbbbbbbbbbbbbbbbbbbbbccccccccccccccccccccccccbbbbbbbbbbbbbbbbbbbbbbbbbbbbb
bbbbbbbbbbbbbkkkkkkkkkkkkkkkbbbbbbbbbbbbbbbbbbbbbbbbbbbbbbbbbbbbbbbbbbbbbbbccccccccccccccccccccccccbbbbbbbbbbbbbbbbbbbbbbbbbbbbb
bbbbbbbbbbkkkkkkkkkkfkkkkkkkkbbbbbbbbbbbbbbbbbbbbbbbbbbbbbbbbbbbbbbbbbaaaacccccccccccccccccccccccccgggggeggbbbbbbbbbbbbbbbbbbbbb
bbbbbbbbbkkkkkkfffffffgggkkkkaaaaaaaaaaaaaaabbbbbbbbbbbaaaaaaaaaaaaaaaaaaacccccccccccccccccccccccccgghhgggggggggggeaaaaaabbbbbbb
bbbbbbbbkkkkffffffffggggkkkkkaaaaaaaaaaaaaaaaaaaccaaaaaaaaaaaaaaaaaaaaaaacccccccccccccccccccccccccceghhhhhgggggggeeaaaaaabbbbbbb
bbbbbbbkkkkffffffggggkkkkkkkaaaaaaaaaaaaaaaaaaacccaaaaaaaaaaaaaaaaaaaaaaaccccccccccccccccccccccccceeghhhhggggggeeeeaaaaaaabbbbbb
bbbbbbkkkfffffffgggggkkkaaaaaaaaaaaaaaaaaaaaaaaacccaaaaaaaaaaaaaaaaaaaaacccccccccccccccccccccccccceegggggggggeeeeeaaaaaaaaaabbbb
bbbbbkkkfffffffgggggkkkkaaaaaaaaaaaaaaaaaaaaaaaaccccaaaaaaaaaaaaaaaaaaaacccccccccccccccccccccccccceeegggggggeeeeaaaaaaaaaaabbbbb
bbbbkkkfffffffggggggkkkaaaaaaaaaaaaaaaaaaaaaaaaaacccaaaaaaaaaaaaaaaaaaaaccccccccccccccccccccccccccggggggggeeeeeaaaaaaaaaaaabbbbb
bbbbkkkfffffggghhgggkkkgaaaaaaaaaaaaaaaaaaaaaaaaaccccaaaaaaaaaaaaaaaaaaaccccccccccccccccccccccccgggggggggeeeaaaaaaaaaaaaaaaabbbb
bbbkkkkffffgghhhhggkkkkgaaaaaaaaaaaaaaaaaaaaaaaaaddddaaaaaaaaaaaaaaaaaaaaccccccccccccccccccccccgggggeeeeeeeaaaaaaaaaaaaaaaaabbbb
bbbkkkfffffgghhhgggkkkkggaaaaaaaaaaaaaaaaaaaaaaaaddddaaaaaaaeeaaaaaaaaaaaaccccccccccccccccccccceeeeeeaaaeeaaaaaaaaaaaaaaaaaaabbb
bbbkkffffffghhhhgggkkkkkggaaaaaaaaaaaaaaaaaaaaaaaccccaaaeeeeeeeaaaaaaaaaaaacccccccccccccccccccaaaaaaaaaaaaaaaaaaaaaaaaaaaaaaabbb
bbkkffffffgghhheeggkkkkkkgaaaaaaaaaaaaaaaaaaaaaaaccccaaeeeeeeeeaeeaaaaaaaaaaaccccccccccccccccccaaaaaaaaaaaaaaaaaaaaaaaaaaaaaabbb
bbkkffffffghhhheeegggkkkkgaaaaaaaaaaaaaaaaaaaaaaacacccaeeeeeeeeeeeeaaaaaaaaaaaccccccccccccccccccaaaaaaaaaaaaaaaaaaaaaaaaaaaaaabb
bbkkffffffghhheeeegggkkkkggeeaaaaaaaaaaaaaaaaaaaacaccccceeeeeeeeeeeeaaaaaaaaaaaccccccccccccccccccaaaaaaaaaaaaaaaaaaaaaaaaaaaaabb
bkkkfffffgghhheeeeggggkkkkgeeeaaaaaaaaaaaaaaaaaaaaaacccceeeeeeeeeeeeeaaaaaaaaaaaccccccccccccccccaaaaaaaaaaaaaaaaaaaaaaaaaaaaaabb
bkkfffffgggheeeeemmeegggkkgeeeaaaaaaaaaaaaaaaaaaaaaacccceeeggggggggeeeaaaaaaaaaaacccccccccccccccaaaaaaaaaaaaaaaaaaaaaaaaaaaaaaab
bbkffffgggeeeeeeeemmegggkkgeeeaaaaaaaaaaaaaaaaaaaaaacccceeghhhgggggaaaaaaaaaaaaaaacccccccccccccccaaaaaaaaaaaaaaaaaaaaeeaaaaaaaab
bbkfffgggeeemeeeeeemeeeggggeeeaaaaaaaaaaaaaaaaaaaaaacccceghhhhhhhggaaaaaaaaaaaaaaaacccccccccccccccccccaaaaaaaaaaaaaaaeeeaaaaaaab
bkkffgggeemmmeeeeeemmeeeeeeeeeaeaaaaaaaaaaaaaaaaaaaaccccgghhhhhhhgggaaaaaaaaaaaaaaaacccccccccccccccccccaaaaaaaaaaaaaaeeeeaaaaabb
bkkfgggeemmeeeeeeeeemmeeeeeeeeeeaaaaaaaaaaaaaaaaaaaaccccggghhhhhgggaaaaaaaaaaaaaaacccccccccccccccccccccaaaaaaaaaaaaaaeeeeeaaaabb
bkkffggemmeeeeemmmmeemeeeaaeeeeaaaaaaaaaaaaaaaaaaaacccccggggggggggaaaaaaaccccddcccccccccccccccccccccccccaaaaaaaaaaaaggeeeeaaaabb
bkkggggmmeeeeemmeemeeeeeaaaeeeeaaaaaaaaaaaaaaaaaaaccccccaagggggggaaaaacccccccddcccccccaccccccccccccccccccccaaaaaaaaggggeeeaaaabb
bkkkkkeeeeeeeeeeeeeeeeeaaaaaaaaaaaaaaaaaaaaaaaaeeccccacaaagggaaaaaaaaaaccccccddccccccaaacccccccccccccccccccccccaaaagggggeeeaabbb
bkkkkkeeeeeeeaeeeeeeaaaaaaaaaaaaaaaaaaaaaaaaaaeecccccaaaaaaaaaaaaaaaaacccccccddccccaaaaaaaccccaccccccccccccccccaaaaaggggggeabbbb
bbkkkkeeeeeeaaaaaaaaaaaaaaaaaaaaaaaaaggeeeaaaeecccccaaaaaaaaaaaaaaaacccccaaaaaaaaaaaaaaaaaaaacccccccccccccccccccaaaaaggggggabhhb
bbbeeeeeeeeaaaaaaaaaaaaaaaaaaaaaaggggggeeeeeeeccccccaaaaaaaaaaaaaaccccccaaaaaaaaaaaaaaaaaaaaaaaaaaaaaccccccccccccaaaaaggggggghhb
bbbeeeeeeeaaaaaaaaaaaaaaaaaaaaaagghhggeeeeeeeccccaacaaaaaaaaaaaaaacccccaaaaaaaaaaaaaaaaaaaaaaaaaaaaaaaccccccccccccaaaaagggghhhhb
bbbbeeeeeaaaaaaaaaaaaaaaaaaaaaaaggghggeeeeeeccccaaaaaaaaaaaaaaaaaacccaaaaaaaaaaaaaaaaaaaaaaaaaaaaaaaaaaaccccccccccccaaaaaggghhhb
bbbbbeeeggaaaaaaaaaaaaaaaaaaaaaaaggggeeeeeecccccaaaaaaaaaaaaaaaacccccaaaaaaaaaaaaaaaaaaaaaaaaaaaaaaaaaaaaaccccccccccaaaaeeeggbbb
bbbbbggggggaaaaaaaaaaaaaaaaaaaacccgeeeeeeecccccaaaaaaaaaaaaaaaacccccaaaaaaaaaaeeeeeeeeeeeaaaaaaaaaaaaaaaaaacccccccccaaaaaeeegbbb
bbbbbggggggaaaacccccccccddcccccccccccccccccccaaaaaaaaaaaggggaaccccccaaaaaaeeeeeeeeeeeeeeeeeeaggggaaeeaaaaaaaccccccccaaaaaaeeegbb
bbbbbhhhhgggccccccccccccddcccccccccccccccccccaaaaaaagggggggaaccccccaaaaaaaeeeeeeeeeeeeeeggegggggggaeeaaaaaaadddddddddaaaaaaeegbb
bbbbhhhhhhhgccccccccccccddcccccccaaaccccccccccccaaaggggeeeeecccaccaaaaaaaaaaaeeeeeeeeeeegggggghhhggeeeaaaaaadddddddddaaaaaaeeebb
bbbbhhhhhhhggcccccggggaaaaaaaaaaaaaaaaaacccccccaaaagggeeeeeeccaccaaaaaaaaaaaaaaeeeeeeaeeggggghhhhggeeeaaaaaadddddddddaaaaaaaeeab
bbbbhhhhhhhhgggggggggaaaaaaaaaaaaaaaaaaaacccccccccaggeeeeeeccccaaaaaaaaaaaaaaaaaaaaaaaaaaagggghhhhggeeeaaaaacccccccccaaaaaaaaaab
bbbbhhhhhhhhhhhggggaaaaaaaaaaaaaaaaaaaaaaaaaacccccccccccceacccaaaaaaaaaaaaaaaaaaaaaaaaaaaaagggghhhggeeeeaaaacccccccccaaaaaaaaaab
bbbbhhhhhhhhhhhggaaaaaaaaaaaaaaaaaaaaaaaeaaaaaacccccccccccccaaaaaaaaaaaaaaaaaaaaaaaaaaaaaaaaagggggggeeeeaaaacccccccccaaaaaaaaaab
bbbbhhhhhhggggggaaaaaaaaaaaaaaaaaaaeeeeeeaaeaaaaacccccccccccaaaaaaaaaaaaaaaaaaaaaaaaaaaaaaaaaaaaaaeeeeeeeaaaccccccccccaaaaaaaaab
bbbbhhhhhhgggggaaaaaaaaaaaaaaaaaaaeeeeeeeeeeaaaacccccacccccccccaaaaaaaaaaaaaaaaaaaaaaaaaaaaaaaaaaaaaeeeeeaaaccccccccccccaaaaaaab
bbbbghhhggggeeeaaaaaaaaaaaaaaaaaaeeeeeeeeeaaaacccccccaaaacccccccccaaaaaaaaccccccccccccccccccaaaaaaaaaeeeeeaaccccccccccccccaaaaab
bbbbgggggeeeeeeaaaaaaaaaaaaaaaaaaaeeeeeaaaaaaacccccccaaaaaaacccccccaaaaaccccccccccccccccccccccaaaaaaaaeeeeaacccccccccccccccaaaab
bbbeggeeeeeeeeaaaaaaaaaaaaaaaaaaaeeeggggggaaaccccccaaaaaaaaaaccccccaaaacccccccccccccccccccccccccaaaaaaaaaaaacccccccccccccccaaaab
bbbeeeeeeeeeeaaaaaaaaaaaaaaaaaaaaeggggggggaaccccccaaaaaaaaaaaaaccccaaccccccccaaaaaaaaaaaacccaccccccaaaaaaaaacccccccccccccccaaaab
bbbaeeeeeeaaaaaaaaaaaaaaaaaaaaaaaeggggggggddddddaaaaaaaaaaaaaaaaaaccccccccccaaaaaaaaaaaaaaaaaaccccccaaaaaaaacccccccccccccccaaaab
bbbaaaaaaaaaaaaaaaaaaaaaaaaaaaaaaaaaaaggaaddddddaaaaaaagaaaaaaaaaaccacccccaaaaaaaaaaaaaaaaaaaaaacccccaaaaaaaccccccccccccccccaaab
bbbaaaaaaaaaaaaaccccccccaccaaaaaaaaaaaaaacccccaaaaaagggggaaaaaaaacccccccccaaeeeeaaaaaaaaaaaaaaaaaccccaaaaaaacccccccccccccccccabb
bbbaaaaaaaaaccccccccccccccccaaaaaaaaaccaacccaaaaaaaagggggaggaaaaaccccccccaaaeeeeeeaaaaaaaaaaaaaaaaaccccaaaaaacccccccccccccccccbb
bbbaaaaaaaccccccaaaaaaaccccccaaaaaccccccccaaaaaaaaaagggggggggaaaacccccccaaeeeeeeeeeaaaaaaaaaaaaaaaaacccccaaaaccccccccccccccccbbb
bbbaaaaaacccccaaaaaaaaaaaaaccccccccccccaaaaaaaaaaaeegggghhhggaaaaacaccccaeeeeggeeeeeaaaaaaaaaaaaaaaaaccccaaaacccccccccccccccbbbb
bbbaaaaaccccaaaaaaaaaaaaaaaaaccaaccccccaaaaaaaaaaeeeeehhhhhggaaaaacccccceeeeeggggeeeeaaaaaaaaaaaaaaaaaacccccccccccccccccccccbbbb
bbbaaaacccaaaaaaaaaaaaaaaaaaaaaaaaccccccaaaaaaaaeeeeehhhhhhhgaaaaaccccccceeeeegggggggeggaaaaaaaaaaaaaaaaaccccccccccccccccccbbbbb
bbbbaccccaaaaaaaaaaaaaaaaaaaaaaaaaccccccaaaaaaaaeeeeehhhhhhggaaaaaaccccccceeeegghhgggggggaaaaaaaaaaaaaaaaaaccccccccccccccccbbbbb
bbbbccccaaaaaaaaaaaeeeeaaaaaaaaaaaccccccaaaaaaaaeeeeehhggggggaaaaaaaacccccceeeegghhghhggaaaaaaaaaaaaaaaaaaaaaccccccccccccccbbbbb
bbbbbaaaaaaaaaaaeeeeaeeaaaaaaaaaaaaacccccaaaaaaaeeeeeegggggaaaaaaaaaaaccccceeeeggghhhhhggaaaaaaaaaaaaaaaaaaaaccccccccccccccccbbb
bbbbbbaaaaaaaaeeeeeeeeeaaaaaaaaaaaaaaccccaaaaaaaaeeeeeggggaaaaaaaaaaaacccccceeeegggghhhhggaaaaaaaaaaaaaaaaaaaaaccccccccccccccbbb
bbbbbbaaaaaaaeeeeeeeeeaaaaaaaaaaaaaaaaccccaaaaaaaaeeeegggaaaaaaaaaaaaaacccccceeeeeeggggggggaaaaaaaaaaaaaaaaaaaacccccccccccccccbb
bbbbbbaaaaaaeeeeeeeeeaaaaaaaaaaaaaaaaaaccccaaaaaaaaaaaaaaaaaaaaaaaaaaaaaccccccceeeeegeegggggaaaaaaaaaaaaaaaaaaaccccccccccccccccb
bbbbbbaaaaeeeeeeeeeeaaaaaaaaaaaaaaaaaaaaaaccccaaaaaaaaaaaaaaaaaaaaaaaaaaccccccccceeeeeeeeeeeaaaaaaaaaaaaaaaaaaaccccccccccccccccb
bbbbbaaaaeeeeeeeeeeeaaaaaaaaaaaaaaaaaaaaaacccccccaaaaaaaaaaaaaaaaaaccccccccccccccceeeeeeeeeeeaaaaaaaaaaaaaaaaaaccccccccccccccccc
bbbbbaaaeeeeeeeeeeeaaaaaaaaaaaaaaaaaaaaaaaaccccccaaaaaaaaaaaaaaddcccccccccccccccccceeeeeeeeeeaaaaaaaaaaaaaaaaaaccccccccccccccccc
bbbbbaaeeeeeeeeeeeaaaaaaaaaaaaaaaaaaaaaaaaaaaacccccccaaaaaaacccddccccccccccacccccccccceeeeeeeeaaaaaaaaaaaaaaaaaccccccccccccccccc
bbbkkaggggeeeeeeaaaaaaaaaaaaaaaaaaaaaaaaaaaaaacccccccccccccccccddccccccccaaaaacccccccccceeeeeeeaaaaaaaaaaaaaaaaccccccccccccccccc
bbbkkaggggeeeeggggaaaaaaaaaaaaaaaaaaaaaaaaaaaaaaaacccccccccccccddcccccaaaaaaaaacccccccccceeeeeeaaaaaaaaaaaaaaaaccccccccccccccccc
bbkkkgggggggggggggaaaaaaaaaaaaaaaaaaaaaaaaggggaaaaaaaccccccccccddaaaaaaaaaaaaaaaccccccccceeeeeeeaaaaaaaaaaaaaaaccccccccccccccccc
bbkffggghhhgggggggaaaaaaaaaaaaaaaaaaaaaagggggggaaaaaacccaaaaaaaaaaaaaaaaaaaaaaaaaaaaaccccceeeeeeaaaaaaaaaaaaaaaacccccccccccccccc
bkkfffghhhhhgggggaaaaaaaaaaaaaaaaaaaaaaagggggggeeeeaccccaaaaaaaaaaeeeaaaaaaaaaaaaaaaaacccceeeeeeeaaaaaaaaaaaaaaacccccccccccccccc
bkkfffghhhhgggggaaaaaaaaaaaaaaaaaaaaaaagggggggeeeeeaccccaaaaaaaaeeeeaaaaaaaaaaaaaaaaaaaccccceeeeeeaaaaaaaaaaaaaacccccccccccccccc
bkkfffghhhhggggaaaaaaaaaaaaaaaaaaaaaaaaggggggeeeeeeaddddaaaaaaaeeeeeeaaaaaaaaaaaaaaaaaaacccccceeeeaaaaaaaaaaaaaacccccccccccccccc
bkkfffggggggaaaaaaaaaaaaaaaaaaaaaaaaaaagggggeeeeeaaaddddaaaaeeeeeeegggggggaaaaaaaaaaaaaaccccccceeeaaaaaaaaaaaaaacccccccccccccccc
bkkffffggggaaaaaaaaaaaaaaaaaaaaaaaaaaaaggggeeeeaaaaacccccaaaeeeeeeeggggggggaaaaaaaaaaaaaaccccccceeaaaaaaaaaaaaaacccccccccccccccc
bkkffffggggaaaaaaaaaaaaaaaaaaaaaaaaaaaaaggaaaaaaaaaacccccaaeeeeeeeeggggggggggggeeeeaaaaaaaccccccceaaaaaaaaaaaaaacccccccccccccccc
bkkffffggaaaaaaaaaaaaaaaaaaaaaaaaaaaaaaaaaaaaaaaaaaaacccaaaeaaaaaeaaggggggggggggeeeaaaaaaaccccccceeaaaaaaaaaaaaaaccccccccccccccc
bbkfffffgaaaaaaaaaaaaaaaaaaaaaaaaaaaaaaaaaaaaaccccccccccaaaaaaaaaaaaaaagggggggggeeaaaaaaaaadddddaaaaaaaaaaaaaaaaaccccccccccccccc
bbkkffffggaaaaaaaaaaaaaaaaaaaaaaaaaaaaaaaaccccccccccccccaaaaaaaaaaaaaaaaaaaaeeeeaaaaaaaaaaadddddaaaaaaaaaaaaaaaaaccccccccccccccc
bbkkfffffgaaaaaaaaaaaaaaaaaaaaaaaaaaaaaaccccccccccccaccccaaaaaaaaaaaaaaaaaaaeeeaaaaaaaaaaacccccaaaaaaaaaaaaaaaaaaccccccccccccccc
bbkkkfffggaaaaaaaaaaaaaaaaaaaaaaaaaaaccccccccccccccaaacccccaaaaaaaaaaaaaaaaaaaaaaaaaaaaaccccccaaaaaaaaaaaaaaaaaaaccccccccccccccc
bbkkkkkkgaaaaaaaaaaaaaaaaaaaaaaaacccccccccccaaaaaaaaaaacccccccaaaaaaaaaaaaaaaaaaaaaaaaacccccaaaaaaaaaaaaaaaaaaaaaccccccccccccccc
bbblkkkkgaaaaaaaaaaaaaaaaaaaacacccccccaaaaaaaaaaaaaaaaaacccccccccaaaaaaaaaaaaaaaaaaaaacccccaaaaaaaaaaaaaaaaaaaaaaccccccccccccccc
bbllllkkaaaaaaaaaaaaaaaaaaacaccccaaaaaaaaaaaaaaaaaaaaaaaacccccccccccccccccccccccaaaaacccccaaaaaaaaaeeeeeeeeeeeeeeccccccccccccccc
bblllbkkaaaaaaaaaaaaaaaaaaccccaaaaaaaaaaaaaaaaaaaaaaaaaaaacccccccccccccccccccccccccccccccaaaaaaaeeeeeeeeegeeeeeegccccccccccccccc
bblllbbaaaaaaaaaaaaaaaaaacccaaaaaaaaaaagggggggggaaaaaaaaaaaaaaaaaaccccccccccccccccccccccaaaaaaaeeeeegggggggggggggccccccccccccccc
blllbbbaaaaaaaaaaaaaacaacccaaaaaaaaaaaggggghgggggggggaaaaaaaaaaaaaaaaaccccccccccccccaaaaaaaaaaeeeegggghhhghhhhhhgecccccccccccccc
blllbbaaaaaaaaaaaaaaaccccccaaaaaaaaaggggggghhgggggggggggaaaaaaaaaaaaaaaaccccccccccaaaaaaaaaaaeeeggghhhhhhhhhhhhggecccccccccccccc
bllbbaaaaaaaaaaaaaaaccccccaaaaggggggggggggghhhgggggggggggggaaaaaaaaaaaaaacccccccaaaaaaaaaaaaeeeggghhhhggggggggggggcccccccccccccc
bllbbaaaaaaaaaaaaaaccccccaaaaaaggggggggggggghggggggghhhhgggggaaaaaaaaaaaaaaaaccccaaaaaaaaaaaeeegghhhggggeeeggggggecccccccccccccc
blllbbbaaaaaaaaaaccccccaaaaaaaaaggggggghhgggggggggghhhghgggggggaaaaaaaaaaaaaaacccaaaaaaaaaaaeegghhhgggeeeeeiiiiidddddccccccccccc
blllbbbbbbaaaaaaccccccaaaaaaaaaagghhgghhhgggggghhgghhhhhggggggggaaaaaaaaaaaaaaccccaaaaaaaaaaeegghgggeeeeaaaijjjjdddddccccccccccc
blllllnnlbaaaaaaccccaaaaaaaaaaaggghhgghhhgggghhhhgggghhgggggggggggeeaaaaaaaaaaaccccaaaaaaaaaegghhggeeeaaaaaijjjjdddddccccccccccc
bllllnnlbbllacddccaaaaaaaaaaaaaggghhggggggggghhhhgggggggggggggggaeeeeaaaaaaaaaaccccaaaaaaaaaeghhggeeeaaaaaaijjjidddddccccccccccc
bbllnnbbblllccddcaaaaaaaaaaaaaaaggghggggggggghhhhggggggoooooooogeeeeeeaaaaaaaaacccccaaaaaaaaeghggeeeeaaaaaaijjjidddddccccccccccc
bbllnbbllllcccddcaaaaaaaaaeeeeeeegggggggggggggggggoggooooooommmeeeeeeeeeaaaaaaaaccccaaaaaaaaegggeeeeeaaajjaijjjjdddddccccccccccc
bblnnbbllllcccddaaaaaaaaaaeeeeeaemmmmmmmmogggggggogogmmmmmmmmmeeeeeeeeeeeaaaaaaaaccccaaaaaaaegggeeeeeeaajjjijjjjdddddccccccccccc
bblnnbllllccccddaaaaaaaaaaeeeaeeemmmmmmmmmmmmmmmmmmmmmmmmmmmmeeaaaaeeeeeeaaaaaaaaccccaaaaaaaegggeeeeeeeaajjjjjjidddddccccccccccc
bblllllllcccccaaaaaaaaaaaaaaeeeeeemooooommmmmmmmmmmmmmmmmmeeeeeaaaaeeeeeeeaaaaaaaaccccaaaaagggggeeeeeeeaaajjjjjidddddccccccccccc
bbblllllcccccaaaaaaaaaaaaaaaaaaaaggggooooogggggggggggmmegggggeeaaaaeeeeeeeeaaaaaaaccccaaaaagggggeeeeeeeaaajjjjjjdddddccccccccccc
bblllllccccccbbaaaaaaaaaaaaaaaaaaggggggggggggghhhhhhgggggggggeaaaaaeeeeeeeeaaaaaaaccccaaaaggggggeeeeeeeaaaajjjjjdddddccccccccccc
bblllllccccbbbbaaaaaaaaaaaaaaaaagggggggggggggghhhhhhggggggggeeaaaaaeeeeeeeeaaaaaaaccccaaaagagggeeeeeeeaaaaaiiiiidddddccccccccccc
blllllccccbbbbbaaaaaaaaaaaaaaaaaaagggaggeeeggggghhhggggeegggeeaaaaaaeeeeeeeeaaaaaaaccciijjiiiiiieeeeeagggaaaaaaaaacccccccccccccc
bllllccccbbbbbbaaaaaaaaaaaaaaaaaaaaaaaaaeeeegggghhhgggeeeeeeeaaaaaaaeeeeeeeeaaaaaaacccijjjjjjjjieeggggggggaaaaaaaacccccccccccccc
bllllccccbbbbbbaaaaaaaaaaaaaaaaaaaaaaaaaeeeegggghhggggeeeeeaaaaaaaaaeeeeeeeeaaaaaaacccijjjjjjjjieeggggggggggaaaaaacccccccccccccc
bllllcccbbbbbbbbaaaaaaaaaaaaaaaaaaaaaaaaeeeggggggggggeeeeaaaaaaaaaaaeeeeeeeeaaaaaacccaijjjjjjjjieggghhhhgggggaaaaacccccccccccccc
bllllccbbbbbbbbaaaaaaaaaaaaaaaaaaaaaaaaaaeeggeeegeeeeeeeaaaaaaaaaaaaeeeeeeeaaaaaaacccaijjjjjjjjigggghhhhhggggaaeeccccccccccccccc
bllllcbbbbbbbbbaaaaaaaaaaaaaaaaaaaaaaaaaaeeeeeeeeegeeeeeaaaaaaaaaaaaaeeeeeeaaaaaacccaaiiiiiiiiiigggghhhhhhgggggeeccccccccccccccc
bllllbbbbbbbbbbaaaaaaaaaaaaaaaaaaaaaaaaaaaaaaeeeeeeeaaaaaaaaaaaaaaaaaeeeeeeaaaaaaccceeeeeeeeeeeieggghhhhhhhhgggeeccccccccccccccc
bllllbbbbbbbbbaaaaaaaaaaaaaaaaaaaaaaaaaaaaaaaaaaaaaaaaaaaaaaaaaaaaaaaeeeeeaaaaaacccceeeeeeeeeeeeegggghhhhhhhgggeeccccccccccccccc
blllllbbbbbbaaaaaaaaaaaaaaaaaaaaaaaaaaaaaaaaaaaaaaaaaaaaaaaaaaaaaaaaaaaaeeaaaaacccceeeeeeeeeeeeeeegggghhhhggggeeeccccccccccccccc
blllnnbbbbbbaeeeeaggggaaaaaaaaaaaaaaaaaaaaaaaaaaaaaaaaaaaaaaaaaaaaaaaaaaaaaaaaaccceeeeeeeeeeeeeieegggggggggggeeeeccccccccccccccc
bllllnbbbbbeeeeegggggggggaaaaaaaaaaaaaaaaaaaaaaaaaaaaaaaaaaaaaaaaaaaaaaaaaaaaccccaiiiiieeeeeiiiiiiiiiiigggggeeeeeccccccccccccccc
bllllnlbbbbeeeeeeegghhhhgggaaaaaaaaaaaababbbbaaaaaaaaaaaaaaaaaaaaaaaaaaaaaaaacccaaijjjjeeeeeijjjjjjjjjiggggeeeeeeccccccccccccccc
bllllnnbbbbaeeeeeeeggghhhgggaaaaaabbbbbbbbbbbaaaaaaaaaaaaaaaaaaaaaaaaaaaaaaacccaaaijjjjeeeeeijjjjjjjjjiggggeeeeeeccccccccccccccc
bbllllnbbbbbaeeeeeeeegghhhggaaaaabbbbnbnnbbbbbaaaaaaaaaaaaaaaaaaaaaaaaaaaaaacccaaaijjjieeeeejjjjjjjjjjieeeeeeeeeeccccccccccccccc
bbblllnnbbbbbbeeeeeeeegghhhggaaabbbnnnnnlllbbbaaaaaaaaaaaaaaaaaaaaaaaaaaaaaacccaaaijjjieeeeejjjjjjjjjjieeeeeeeeeeccccccccccccccc
bbbllllnbbbbbbaeeeeeeeegggggggaabbbnnnlllllbbbaaaaaaaaaaaaaaaaaaaaaaaaaaaaaacccaaaijjjieeeeeijjjjjjjjjieeeeeeeeecccccccccccccccc
bbblllllnnnbbbbaeeeeeeeeggggggaabbbbnnllllbbbbaaaaaaaaaaaaaaaaaaaaaaaaaaaaaacccccaijjjieeeeeijjjjjjjjjieeeeeeeeecccccccccccccccc
bbllllllllnbbbbbbbbeeeeeeeggeaaaaabbbbllllbbbbaaaaaaaaaaaaaaaaaaaaaaaaaaaaaaaccccaiiiiieeeeeijjjjjjjjjieeeeeeeeecccccccccccccccc
bbllllllllllbbbbbbbbbeeeeeeaeeaaaaabbblllllbbbbbaaaaaaaaaaaaaaaaaaaaaaaaaaaaacccccceeeeeeeeeiiiiiiiiiiicccceeeeecccccccccccccccc
bblllllllllllbbbbbbbbaeeeeeeeaaaaaabbbllllllbbbbbaaaaaaaaaaaaaaaaaaaaaaaaaaaaacccccccceeeeeeeeeccccccccccccccccccccccccccccccccc
bbbbllllllllllllbbbbbaaaaaeaaaaabbbbbbllbllllbbbbaaaaaaaaaaaaaaaaaaaaaaaaaaaaaccccccccccddcccccccccccccccccccccccccccccccccccccc
bbbbbllllllllllllbbbbbaaaaaaaabbbbbbblllblllllbbbbbbbbaaaaaaaaaaaaaaaaaaaaaaaaacccccccccddcccccccccccccccccccccccccccccccccccccc
bbbblllllllllllllbbbbbbaaaaabbbbbbbllllbblllllbbbbbbbbbaaaaaaaaaaaaaaaaaaaaaaaaaccccccccddccccccccccccccccccccaacccccccccccccccc
bbbllllllllllllllblllbbbbbabbbbbblllllbbbbllllllbbbbbbbbbbaaaaaaaabbbbbaaaaaaaaaaaacccccddccccccaaacccccaaaacaaccccccccccccccccc
bblllllllllllllllllllbbbbbbbbbblllllllbbbbbbllllllbllbbbbbbbaaaabbbbbbbbaaaaaaaaaabbbbaaaaaaaaaaaaaaaaapaaaacccccccccccccccccccc
bbllllnnbbbbbbllllllllbbbbbbbllllllllbbbbbbbbblllllllllllbbbbaabbblllllbbbaaaaaaabbbbbbaaaaaaaaaaallnnnbbbbaaacccccccccccccccccc
bbbbnnnbbbbbbbbbblllllllllllllllllbbbbbbbbbbbbbllllllllllbbbbbbbblllllllbbbbbbabbbbbbbbbbaaaaaaallllnbbbbbbbaccccccccccccccccccc
bbbbnnnbbbbbbbbbbbbbbbblllllllbbbbbbbbbbbbbbbbbblbllllllllllllllllllllllbbbbbbbbbbbbbbbbbbbaaaabbllnnbbbbbbbaccccccccccccccccccc
bbbbbbbbbbbbbbbbbbbbbbbbbbbbbbbbbbbbbbbbbbbbbbbbbbbbbbbbbbbbbbbbbbbbbbbbbbbbbbbbbbbbbbbbbbbbbbbbbnnnnbbbbbbbcccccccccccccccccccc
"}
