"a" = (/turf/simulated/wall/rock/snow,/area/overworld/snow)
"b" = (/turf/simulated/floor/colored/snow,/area/overworld/snow)
"c" = (/turf/simulated/wall/wood/brown,/area/overworld/south_cabin)
"d" = (/turf/simulated/floor/wood/brown,/area/overworld/south_cabin)
"e" = (/turf/simulated/floor/colored/dirt/snow,/area/overworld/snow)
"f" = (/turf/simulated/floor/colored/snow,/area/overworld/snow/south_entrance)
"g" = (/turf/simulated/floor/colored/dirt/snow,/area/overworld/snow/south_entrance)
"h" = (/turf/simulated/floor/ice,/area/overworld/snow)
"i" = (/turf/simulated/floor/ice,/area/overworld/snow/south_entrance)
"j" = (/turf/simulated/floor/chasm,/area/overworld/snow)
"k" = (/obj/structure/interactive/lighting/streetlamp/snow,/turf/simulated/floor/colored/snow,/area/overworld/snow/south_entrance)
"l" = (/obj/structure/interactive/lighting/streetlamp,/turf/simulated/floor/colored/dirt/snow,/area/overworld/snow/south_entrance)
"m" = (/obj/structure/interactive/lighting/streetlamp/snow,/turf/simulated/floor/colored/snow,/area/overworld/snow)
"n" = (/obj/structure/interactive/nature/rocks,/turf/simulated/floor/colored/dirt/snow,/area/overworld/snow)
"o" = (/obj/marker/spawnpoint/new_character,/turf/simulated/floor/cave_dirt,/area/overworld/south_cave)
"p" = (/obj/structure/interactive/wishgranter/normal/northern_heights,/turf/simulated/floor/colored/dirt/snow,/area/overworld/snow/south_entrance)
"q" = (/turf/simulated/wall/rock,/area/overworld/south_cave)
"r" = (/turf/simulated/floor/colored/snow,/area/overworld/south_cave)
"s" = (/turf/simulated/floor/cave_dirt,/area/overworld/snow)
"t" = (/turf/simulated/floor/cave_dirt,/area/overworld/caves)
"u" = (/turf/simulated/floor/colored/snow,/area/overworld/caves)
"v" = (/turf/simulated/floor/cave_dirt,/area/overworld/snow/south_entrance)
"w" = (/turf/simulated/floor/cave_dirt,/area/overworld/south_cave)
"x" = (/turf/simulated/wall/rock,/area/overworld/caves)
"y" = (/turf/simulated/wall/wood/brown,/area/overworld/caves)
"z" = (/turf/simulated/floor/wood/brown,/area/overworld/caves)
"A" = (/turf/simulated/wall/rock/snow,/area/overworld/caves)
"B" = (/obj/structure/interactive/nature/rocks,/turf/simulated/floor/cave_dirt,/area/overworld/south_cave)
"C" = (/obj/effect/fake_lighting/solid/black,/turf/simulated/floor/cave_dirt,/area/overworld/south_cave)
"D" = (/obj/effect/fake_lighting/gradient/black{icon_state = "gradient"; dir = 1},/turf/simulated/floor/cave_dirt,/area/overworld/south_cave)
"E" = (/obj/structure/interactive/nature/rocks,/obj/effect/fake_lighting/gradient/black{icon_state = "gradient"; dir = 1},/turf/simulated/floor/cave_dirt,/area/overworld/south_cave)
"F" = (/obj/structure/smooth/table/wood,/turf/simulated/floor/wood/brown,/area/overworld/south_cabin)

(1,1,1) = {"
jjjjjjjjjjjjjjjjjjjjjjjjjjjjjjjjjjjjjjaaaaaaaaaaaaaaaaaaaaaaaaaaaaaaaaaaaaaaaaaaaaaaaaaaaaaaaaaaaaaaaaaaaaaaaaaaaaaaaaaaaaaaaaaa
jjjjjjjjjjjjjjjjjjjjjjjjjjjjjjjjjjjjjjjaaaaaaaaaaaaaaaaaaaaaaaaaaaaaaaaaaaaaaaaaaaaaaaaaaaaaaaaaaaaaaaaaaaaaaaaaaaaaaaaaaaaaaaaa
jjjjjjjjjjjjjjjjjjjjjjjjjjjjjjjjjjjjjjjjaaaaaaaaaaaaaaajjjjjjjjjjjjaaaaaaaaaaaaaaaaaaaaaaaaaaaaaaaaaaaaaaaaaaaaaaaaaaaaaaaaaaaaa
jjjjjjjjjjjjjjjjjjjjjjjjjjjjjjjjjjjjjjjjjjaaaaaaaaajjjjjjjjjjjjjjjjjjaaaaaaaaaaaaaaaaaaaaaaaaaaaaaaaaaaaaaaaaaaaaaaaaaaaaaaaaaaa
jjjjjjjjjjjjjjjjjjjjjjjjjjjjjjjjjjjjjjjjjjjaaaajjjjjjjjjjjjjjjjjjjjjjjjjaaaaaaaaaaaaaaaaaaaaaaaaaaaaaaaaaaaaaaaaaaaaaaaaaaaaaaaa
jjjjjjjjjjjjjjjjjjjjjjjjjjjjjjjjjjjjjjjjjjjjajjjjjjjjjjjbbbbbjjjjjjjjjjjjjaaaaaaaaaaaaaaaaaaaaaaaaaaaaaaaaaaaabbaaaaaaaaaaaaaaaa
jjjjjjjjjjjjjjjjjjjjjjjjjjjjjjjjjjjjjjjjjjjjjjjjjjbbbbbbbbbbbbbbbbjjjjjjjjjaaaaaaaaaaaaaaaaaaaaaaaabbbbbbbbbbbbbbbaaaaaaaaaaaaaa
jjjjjjjjjjjjjjjjjjjjjjjjjjjjjjjjjjjjjjjjjjjjjjjjbbbhhhbbbbbbbbbbbbjjjjjjjjjjaaaaaaaaaaaaaaaaaabbbbbbbbbbbbbbbbbbbbbbaaaaaaaaaaaa
jjjjjjjjjjjjjjjjjjjjjjjjjjjjjjjjjjjjjjjjjjjjjjjbbbhhhhhbbbbbbbbbbbbjjjjjjjjjjjaaaaaaaaaaaaabbbbbbbbbbbbbbbbbbbbbbbbbbaaaaaaaaaaa
jjjjjjjjjjjjjjjjjjjjjjjjjjjjjjjjjjjjjjjjjjjjjjbbbhhhhhbbbbbbbbbbbbbbbbbbjjjjjjjaaaaaaaaaaabbbbbbbbbbbbbbbbbbbbbbbbbbbbaaaaaaaaaa
jjjjjjjjjjjjjjjjjjjjjjjjjjjjjjjjjjjjjjjjjjjjjbbbhhhhhbbbbbbbbbbbbbbbbbbbbjjjjjjjaaaaaaaaaabbbbbbbbbbbbbbbbbbbbbbbbbbbbbaaaaaaaaa
jjjjjjjjjjjjjjjjjjjjjjjjjjjjjjjjjjjjjjjjjjjjbbbbhhhhhbbbbbbbbbbbbbbbbbbbbjjjjjjjjbaaaaaaaabbbbbbbbbbbbbbbbbbbbbbbbbbbbbbaaaaaaaa
jjjjjjjjjjjjjjjjjjjjjjjjjjjjjjjjjjjjjjjjjjjbbbbhhhhhbbbbbbbbbbbbbbbbbbbbbbjjjjjjjbbaaaaaabbbbbbbbbbbbbbbbbbbbbbbbbbbbbbbbaaaaaaa
jjjjjjjjjjjjjjjjjjjjjjjjjjjjjjjjjjjjjjjjjjjbbbbhhhbbbbbbbbbbbbbbbbbbbbbbbbbjjjjjjbbbaaaaabbbbbbbbbbbbbbbbbbbbbbbbbbbbbbbbbaaaaaa
jjjjjjjjjjjjjjjjjjjjjjjjjjjjjjjjjjjjjjjjjjjbbbbhbbbbbbbbbbbbbbbbbbbbbbbbbbbjjjjjjbbbaaaabbbbbbbbbbbbbbbbbbbbbbbbbbbbbbbbbbbaaaaa
jjjjjjjjjjjjjjjjjjjjjjjjjjjjjjjjjjjjjjjjjjjbbbbbbbbbbbbbbbbbbbbbbbbbbbbbbbbjjjjjbbbbbaaabbbbbbbbbbbbbbbbbbbbbbbbbbbbbbbbbbbaaaaa
jjjjjjjjjjjjjjjjjjjjjjjjjjjjjjjjjjjjjjjjjjjbbbbbbbbbbbbbbbbbbbbbbbbbbbbbbbbjjjjjbbbbbbabbbbbbbbbbbbbbbbbbbbbbbbbbbbbbbbbbbbbaaaa
jjjjjjjjjjjjjjjjjjjjjjjjjjjjjjjjjjjjjjjjjjbbbbbbbbbbbbbbbbbbbbbbbbbbbbbbbbbjjjjjbbbbbbbbbbbbbbbbbbbbbbbbbbbbbbbbbbbbbbbbbbbbaaaa
jjjjjjjjjjjjjjjjjjjjjjjjjjjjjjjjjjjjjjjjjbbbbbbbbbbbbbbbbbbbbbbbbbbbbbbbbbjjjjjbbbbbbbbbbbbbbbbbbbbbbbbbbbbbbbbbbbbbbbbbbbbbbaaa
jjjjjjjjjjjjjjjjjjjjjjjjjjjjjjjjjjjjjjjjjbbbbbbbbbbbbbbbbbbbbbbbbbbbbbbbbbjjjjjbbbbbbbbbbbbbbbbbbbbbbbbbbbbbbbbbbbbbbbbbbbbbbaaa
jjjjjjjjjjjjjjjjjjjjjjjjjjjjjjjjjjjjjjjjbbbbbbbbbbbbbbbbbbbbbbbbbbbbbbbbbjjjjbbbbbbbbbbbbbbbbbbbbbbbbbbbbbbbbbbbbbbbbbbbbbbbbaaa
jjjjjjjjjjjjjjjjjjjjjjjjjjjjjjjjjjjjjjjjbbbbbbbbbbbbbbbbbbbbbbbbbbbbbbjjjjjjjbbbbbbbbbbbbbbmbbbbbbbbbbbbbbbbbbbbbbbbbbbbbbbbbbaa
jjjjjjjjjjjjjjjjjjjjjjjjjjjjjjjjjjjjjjbbbbbbbbbbbbbbbbbbbbbbbbbbbbbbjjjjjjjjjbbbbbbbbbbbbbbbbbbbbbbbbbbbbbbbbbbbbbbbbbbbbbbbbbaa
jjjjjjjjjjjjjjjjjjjjjjjjjjjjjjjjjjjjjjbbbbbbbbbbbbbbbbbbbbbbbbbbbbbbjjjjjjjbbbbbbbbbbbbbbbbbbbaaaabbbbbbbbbbbbbbbbhhhbbbbbbbbaaa
jjjjjjjjjjjjjjjjjjjjjjjjjjjjjjjjjjjjbbbbbbbbbbbbbbbbbbbbbbbbbjjjbbbbjjjjjjbbbbbbbbbbbbbbbbbbbbaaaaabbbbbbbbhhhhhhhhhhhbbbbbbaaaa
jjjjjjjjjjjjjjjjjjjjjjjjjjjjjjjjjjjjbbbbbbbbbbbbbbbbbbbbbbbbjjjjbbbbjjjjjbbbbbbbbbbbbbbbbbbbbaaaaaabbbbbbhhhhhhhhhhhhbbbbbbaaaaa
jjjjjjjjjjjjjjjjjjjjjjjjjjjjjjjjjjbbbbbbbbbbbbbbbbbbbbbbbbbjjjbbbbbbbbbbbbbbbbbbbbbbbbbbbbbbbaaaaaaabbbbhhhhhhhhhhhhhbbbbbaaaaaa
jjjjjjjjjjjjjjjjjjjjjjjjjjjjjjjjjjbbbbbbbbbbbbbbbbbbbbbbbjjjjbbbbbbbbbbbbbbbbbbbbbbbbbbbbbbbbaaaaaaaabbbhhhhhhhhhhhhbbbbaaaaaaaa
jjjjjjjjjjjjjjjjjjjjjjjjjbbbbbbbbbbbbbbbbbbbbbbbbbbbbbbbbjjjjbbbbbbbbbbbbbbbbbbbbbbbbbbbbbbbbbaaaaaaaabbbhhhhhhhhhbbbbaaaaaaaaaa
jjjjjjjjjjjjjjjjjjjjjjjjbbbbbbbbbbbbbbbbbbbbbbbbbbbbbjjbjjjjjbbbbbbbbbbbbbbbbbbbbbbbbbbbbbbbbbbaabbaaaabbbbbbbbbbbbaaaaaaaaaaaaa
ajjjjjjjjjjjjjjjjjjjjbbbbbbbbbbbbbbbbbbbbbbbbbbbbbbbbjjjjjjjjbbbbbbbbbbbbbbbbbbbbbbbbbbbbbbbbbbbbbbaaaaaaaaaaaaaaaaaaaaaaaaaaaaa
aajjjjjjjjjjjjjjjjjbbbbbbbbbbbbbbbbbbbbbbbbbbbbbbbbbjjjjjjjjjjbbbbbbbbbbbbbbbbbbbbbbbbbbbbbbbbbbbbbbaaaaaaaaaaaaaaaaaaaaaaaaaaaa
aajjjjjjjbjjjjjjbbbbbbbbbbbbbbbbbbbbbbbbbbbbbbbbbbbjjjjjjjjjjjbbbbbbbbbbbbbbbbbbbbbbbbbbbbbbbbmbbbbbbbaaaaaaaaaaaaaaaaaaaaaaaaaa
aaajjjjjbbbbjjbbbbbbbbbbbbbbbbbbbbbbbbbbbbbbbbbbbbjjjjjjbjjjjjbbbbbbbbbbbbbbbbbbbbbbbbbbbbbbbbbbbbbbbbbbaaaaaaaaaaaaaaaaaaaaaaaa
aaaajjbbbbbbbbbbbbbbbbbbbbbbbbbbbbbbbbbbbbbbbbbbbbjjjjbbbbjjjjjjbbbbbbbbbbbbbbbbbbbbbbbbbbbbbbbbbbbbbbbbbaaaaaaaaaaaaaaaaaaaaaaa
aaaajbbbbbbbbbbbbbbbbbbbbbbbbbbbbbbbbbbbbbbbbbbbjjjjjbbbbbbjjjjjbbbbbbbbbbbbbbbbbbbbbbbbbbbbbbbbbbbbbbbbbbaaaaaaaaaaaaaaaaaaaaaa
aaaajbbbbhhhhhbbbbbbbbbbbbbbbbbbbbbbbbbbbbbbbbbbjjjjbbbbbbbbjjjjbbbbbbbbbbbbbbbbbbbbbbbbbbbbbbbbbbbbbbbbbbbaaaaaaaaaaaaaaaaaaaaa
aaaabbbbhhhhhhhbbbbbbbbbbbbbbbbbbbbbbbbbbbbbbbbbjjjbbbbbbbbbjjjjjbbbbbbbbbbbbbbbbbbbbbbbbbbbbbbbbbbbbbbbbbbbaaaaaaaaaaaaaaaaaaaa
aaaabbbbhhhhhhhbbbbbbbbbbbbbbbbbbbbbbbbbbbbbbbbbjjjbbbbbbbbbbjjjjbbbbbbbbbbbbbbbbbbbbbbbbbbbbbbbbbbbbbbbbbbbbaaaaaaaaaaaaaaaaaaa
aaaabbbbhhhhhhhhbbbbbbbbbbbbbbbbbbbbbbbbbbbbbbbbjjbbbbbbbbbbbjjjjbbbbbbbbbbbbbbbbbbbbbbbbbbbbbbbbbbbbbbbbbbbbbbaaaaaaaaaaaaaaaaa
aaabbbbbhhhhhhhbbbbbbbbbbbbbbbbbbbbbbbbbbbbbbbbjjjbbbbbbbbbbbjjjjbbbbbbbbbbbbbbbbbbbbbbbbbbbbbbbbbbbbbbbbbbbbbbbaaaaaaaaaaaaaaaa
aaabbbbbhhhhhhhbbbbbbbbbbbbbbbbbbbbbbbbbbbbbbbbjjjbbbbbbbbbbbbjjjbbbbbbbbbbbbbbbbbbbbbbbbbbbbbbbbbbbbbbbbbbbbbbbbbaaaaaaaaaaaaaa
aaabbbbbhhhhhhhbbbbbbbbbbbbbbbbbbbbbbbbbbbbbbbbjjjbbbbbbbbbbbbjjjbbbbbbbbbbbbbbbbbbbbbbbbbbbbbbbbbbbbbbbbbhhbbbbbbbaaaaaaaaaaaaa
aaabbbbbhhhhhhbbbbbbbbbbbbbbbbbbbbbbbbbbbbbbbbbjjjbbbbbbbbbbbbjjjbbbbbbbbbbbbbbbbbbbbbbbbbbbbbbbbbbbbbbbbbhhhhbbbbbbaaaaaaaaaaaa
aaabbbbbhhhhhbbbbbbbbbbbbbbbbbbbbbbbbbbbbbbbbbbjjjbbbbbbbbbbbbjjjbbbbbbbbbbbbbbbbbbbbbbbbbbbbbbbbbbbbbbbbhhhhhhhbbbbbaaaaaaaaaaa
aaaabbbbbbbbbbbbbbbbbbbbbbbbbbbbbbbbbbbbbbbbbbbjjjjbbbbsssbbbjjjjbbbbbbbbbbbbbbbbbbbbbbbbbbbbbbbbbbbbbbbhhhhhhhhhbbbbbbAAxxxxxxx
aaaabbbbbbbbbbbbbbbbbbbbbbbbbbbbbbbbbbbbbbbbbbbaaaaaaattttaaaaaaaaaaaabbbbbbbbbbbbbbbbbbbbbbbbbbbbbbbbhhhhhhhhhhhhbbbbbuuuxxxxxx
aaaaaabbbbbbbbbbbbbbbbbbbbbbbbbbbbbbbbbbbbbbbaaaxxxxxxttttxxxxxxxxxxaaaaaaabbbbbbbbbbbbbbbbbbbbbbbbbbhhhhhhhhhhhhhbbbbbuuuuxxxxx
aaaaaabbbbbbbbbbbbbbbbbbbbbbbbbbbbbbbbbbbbbaaaxxxxxxxxttttxxxxxxxxxxxaaaaaaaaabbbbbbbbbbbbbbbbbbbbbbbhhhhhhhhhhhhhbbbbbuuuuutxxx
aaaaaabbbbbbbbbbbbbbbbbbbbbbbbbbbbbbbbbbbaaaaaxxxxxxxttttttttxxxxxxxxaaaaaaaaaaabbbbbbbbbbbbbbbbbbbbbbhhhhhhhhhhhhbbbbAuuxttttxx
aaaaaabbbbbbbbbbbbbbbbbbbbbbbbbbbbbbbbbbaaaaaaxxxxxtttttttttttxxxxxxxxxxxaaaaaaaabbbbbbbbbbbbbmbbbbbbbbhhhhhhhhhhbbbbaAAAxxttttx
aaaaaabbbbbbbbbbbbbbbbbbbbbbbbbbbbbbbbbaaaaaaaxxxxttttttttttttttttttxxxxxxaaaaaaaabbbbbbbbbbbbbbbbbbbbbbhhhhhhhhbbbbaaAxxxxttttx
aaaaaaaabbbbbhhhhhhhhhhhhhhhhhhhhbbbbbaaaxxxxxxxxxttttttttttttttttttxxxxxxxxxxaaaaabbbbbbbbbbbbbbbbbbbbbbbhhhhhbbbbaaaAxxxxxtttx
aaaaaaaabhhhhhhhhhhhhhhhhhhhhhhhhhhbbaaaaxxxxxxxxxtttttttttttttttttxxxxxxxxxxxaaaaaabbbbbbbbbbbbbbbbbbbbbbhhhbbbbbaaaaxxxttxxttx
aaaaaaahhhhhhhhhhhhhhhhhhhhhhhhhhhhhbaaaaxxxttxxxtttttttttttttttttttxxxxxxxxxxxxxaaaabbbbbbbbbbbbbbbbbbbbbbbbbbbbaaaxxxxttxxtttx
aaaaaaahhhhhhhhhhhhhhhhhhhhhhhhhhhhhhaaaaxttttxxtttttttttttttttttttttttxxxxxxxxxxaaaaabbbbbbbbbbbbbbbbbbbbbbbbbbaaxxxxttttxxtttx
aaaaaahhhhhhhhhhhhhhhhhhhhhhhhhhhhhaaaaaaxttttttttttttttttttttttttttttttxxxxxxxxxaaaaabbbbbbbbbbeebbbbbbbbbbbbbaaaxxttttxxxxttxx
aaaaaaahhhhhhhhhhhhhhhhhhhhhhhhhhhaaaaxxxxttttttttttttttttttttttttttttttttxxxxxxxxaaaabbbbbbbbbbebbbbbbbbbbbbbaaaaxxttttxxxtttxx
aaaaaaahhhhhhhhhhhhhhhhhhhhhhhhhhaaaaaxxtttxxxxxxxxxxxxxxxxxxxxxttxttttttttxxxxxxxaaaaabbbbbbbbbebbbbbbbbbbbbaaaxxxttxttxxtttxxx
aaaaaahhhhhhhhhhhhhhhhhhhhhhhhhhhaaxxxxxtxxxxxxxxxxxxxxxxxxxxxxxxxxxxxxttttxxxxxxxxaaaabbbbbbbbbebbbbbbbbbbbbaaaxxttxxttttttxxxx
aaaaaahhhhhhhhhhhhhhhhhhhhhhhhhhhaaxtttttxxxtttttxxxxxxxxxttttttttttttttttttxxxxxxxaaaabbbbbbbbbebbbbbbbbbbbaaaaxxttxxtttttxxxxx
aaaaahhhhhhhhhhhhhhhhhhhhhhhhhhhhaaxttttxxtttttttxxxtttttttttttttttttttttxxxxxxxxxxaaaaabbbbbbbembbbbbbbbbbbaaaaxxxxxtttttxxxxxx
aaaaaahhhhhhhhhhhhhhhhhhhhhhhhhhhaaxttttxxttttttttttttttttxttxxxxxxxxxxxtxxxxxxxxxxaaaaabbbbbbebbbbbbbbbbbbaaaaaxxxxxtttxxxxxxxx
aaaaaaahhhhhhhhhhhhhhhhhhhhhhhhhhaaxxtttxtttttxttttttttxxxxxxxxxxxtxxxxxxxxxxxxxxxxaaaaabbbbbeebbbbbbbbbbbbaaaaaxxxxtttxxxxxxxxx
aaaaaahhhhhhhhhhhhhhhhhhhhhhhhhhhaaaxxtxxttttxxxxttxxxxxxxxxtttttttttttxxxxxxttttxxaaaaabbbbbebbbbbbbbbbbbaaaaaaxxxxttxxxxxxxxxx
aaaaaaahhhhhhhhhhhhhhhhhhhhhhhhhhhaaxxxxxtttxxxxxxxxxxxtxxtttttttttttttxxxxxttttttxaaaaabbbbeebbbbbbbbbbbbaaaaaaxxxtttxxxxtxxxxx
aaaaaaahhhhhhhhhhhhhhhhhhhhhhhhhhhaaxxxxxtttxxxxxxxxttttttttxxxxxxxxxttttxttttttttxaaaaabbbbebbbbbbbbbbbbaaaaaaaxxxtttxxttttxxxx
aaaaaaaahhhhhhhhhhhhhhhhhhhhhhhhhhaaaaxxxtttxxxxxxxtttttttxxxxxxxxxxxxttttttttttttxaaaaabbbbebbbbbbbbbbbaaaaxxxxxttttxxxtttttxxx
aaaaaaaahhhhhhhhhhhhhhhhhhhhhhhhhhhaaaxxxxttttxxxxtttttttxxxtttttxxxxxtttttttttttxxaaaaabbbebbbbbbbbbbbaaaaaxxxxxtttxxxxttttttxx
aaaaaaahhhhhhhhhhhhhhhhhhhhhhhhhhhhaaaaaxxttttttttttttxxxxtttttttxxxxxxttxxxxtttxxxaaaabbbbbbbbbbbbbbaaaaaaaxxxxttttxxxxttttttxx
aaaaaahhhhhhhhhhhhhhhhhhhhhhhhhhhhhhaaaaxxxtttttttxxxxxxxtttttttttxxxxtttxxxxxxxxxxaaaabbbebbbbbbbaaaaaaaaaaxxxxtttxxxxxttttttxx
aaaaahhhhhhhhhhhhhhhhhhhhhhhhhhhhhhbaaaaxxxxtttttxxxxxxxtttttxxtttttttttttttxxxxxxxaaaabbbebbbbbaaaaaaaaaaxxxxxxtttxxxxtttttttxx
aaaaaaahhhhhhhhhhhhhhhhhhhhhhhhhbbbbaaaaxxxxxttxxxxxxxxtttttxxxttttttttttttttxxxxxxaaaabbeebbbbaaaaaaaaaaaxxtttttttxxxtttttttttx
aaaaaahhhhhhhhhhhhhhhhhhhhhhhhbbbbbbaaaaxxxxxxxxxxxxxttttttxxxxttttttttttttttxxxxxxaaaabbebbbbaaaaaaaaaaxxxxttttttxxxxtttttttttx
aaaaaaahhhhhhhhhhhhhhhhhhhhbbbbbbbbbbbbaaaxxxxxxxxxxtttttxxxxxtttttttxxxxttttxxxxxaaaabbbebbbaaaaaaaaaaaxxxxttttxxxxxttttttttttx
aaaaaahhhhhhhhhhhhhhhhhhhbbbbbbbbbbbbbbbbaaaxxxxxxxtttttxxxxttttttttxxxxxttttxxxxxaaaabbbebbbaaaaaaxxxxxxxttttxxxxxxxtttttttttxx
aaaaaahhhhhhhhhhhhhhhhhbbbbbbbbbbbbbbbbbbbaaaxxxxxxttttxxxxtttttttttxxxxxtttxxxxxxaaaabbebbbaaaaaaaxxxxxxttttttxxxxxxtttttttttxx
aaaaaahhhhhhhhhhhhhhbbbbbbbbbbbbbbbbbbbbbbbaaaaxxxxttttxxxxttttttttxxxxtttxxxxxxxxaaabbeebbbaaaaaaxxxxxxtttttttxxxxxxxttttttttxx
aaaaahhhhhhhhhhhhhbbbbbbbbbbbbbbbbbbbbbbbbbbaaaxxxxttttxxtttttttxxxxxxttttxxxxxxxxaaabbebbbaaaaaaaxxxxtttttxxttttxxxxxttttttttxx
aaaahhhhhhhhhhhhbbbbbbbbbbbbbbbbbbbbbbbbbbbbaaaaxxxxtttxxttttttxxxxxtttttxxxxxxxxaaabbeebbbaaaaxxxxxxtttxxxxxxttttxxxxttttttttxx
aaaaahhhhhhhhhhbbbbbbbbbbbbbbbbbbbbbbbbbbbbbbaaaaaxxtttxxttttttxxxxxttttxxxxxxxxaabbbbembbbaaaaxxtxxxtttxxxxxxttttxxxxttttttttxx
aaaahhhhhhhhhhbbbbbbbbbbbbbbbbbbbbbbbbbbbbbbbbbaaaxxxxxxxtttttxxxxxxxxxxxxxxxxaaabbbbeebbbbaaaaxtttttttxxxtttxxxtttxxxxttttttttx
aaaahhhhhhhhhbbbbbbbbbbbbbbbbbbbbbbbbbbbbbbbbbbbbaaaaaaayyyzyyyyyyyyxxxxxxxaaaabbbbbbebbbbbaaaaxttttttttxxtttttxtttxxxxxtttttttx
aaaahhhhhhhhhbbbbbbbbbbbbbbbbbbbbbbbbbbbbbbbbbbbbbbaaaaayzzzzzzzzzzyxxxxxaaabbbbbbbbeebbbbbaaaaxttttttttxxtttttxttttxxxxtttttttx
aaaahhhhhhhhbbbbbbbbbbbbbbbbbbbbbbbbbbbbbbbbbbbbbbbbbaaayzzzzzzzzzzyaaaaaabbbbbbbbbeebbbbbbaaaaxxxtxxxttxxxttxxxxtttxxxxtttttttx
aaaahhhhhhhbbbbbbbbbbbbbbbbbbbbbbbbbbbbbbbbbbbbbbbbbbbbbyzzzzzzzzzzybbbbbbbbbbbbbbeebbbbbbbaaaaxxxxxxxtttxxxtxxxxttxxxxxttttttxx
aaaahhhhhhhbbbbbbbbbbbbbbbbbbbbbbbbbbbbbbbbbbbbbbbbbbbbbyzzzzzzzzzzybbbbbbbbbbbbbeebbbbbbbbaaaaxxxxxxxttttxxtxxxttttxxxxttttttxx
aaaahhhhhhhbbbbbbbbbbbbbbbbbbbbbbbbbbbbbbbbbbbbbbbbbbbbbyzzzzzzzzzzybbbbbbbbbbbbbeebbbbbbbbaaaaaaaxxxxxttttxtxttttxxxxxxxtttttxx
aaaahhhhhhhbbbbbbbbbbbbbbbbbbbbbbbbbbbbbbbbbbbbbbbbbbbbbyyyyyyyyyzyybbbbbbbbbbbbeebbbbbbbbbaaaaaaaxxtxxxtttxttttttxxxxxxxtttttxx
aaaahhhhhhhbbbbbbbbbbbbbbbbbbbbbbbbbbbbbbbbbbbbbbbbbbbbbmbbbbbbbbbbmbhhhbbbbbbbeebbbbbbbbbbbaaaaaaxxtxxxxttttttxxxxxxxxxxtttttxx
aaaahhhhhhhbbbbbbbbbbbbbbbbbbbbbbbbbbbbbbbbbbbbbbbbbbbbbbbbbbbbbbbbbbhhhhbbbbbeebbbbbbbbbbbbaaaaaaaxttxxtttttxxxxxxxxxxxxxttttxx
aaaahhhhhhhbbbbbbbbbbbbaaaaaaabbbbbbbbbbbbbbbbbbbbbbbbbbbbbbbbbbbbbbbhhhhhbbbbeebbbbbbbbbbbbaaaaaaaxtttttxxttttxxxxxxxxxttttttxx
aaaahhhhhhhbbbbbbbbaaaaaaaaaaaaabbbbbbbbbbbbbbbbbbbbbbbbbbbbbbbbbbbbbhhhhhhbbbebbbbbbbbbbbbbbaaaaaaxxttttxxxxttttttxxxttttttttxx
aaaahhhhhhhhbbbbaaaaxxxxxxxxxxaaaabbbbbbbbbbbbbbbbbbbbbbbbbbbbbbbbbbhhhhhhhbbeebbbbbbbbbbbbbbbaaaaaxxtttxxxxxxttttttttttttttttxx
aaaahhhhhhhhbbbaaaxxtttttttttxxaaaabbbbbbbbbbbbbbbbbbbbbbbbbbbbbbbbbbhhhhhbbbeebbbbbbbbbbbbbbbaaaaaxxxxxxxxxxxxxxttttttttttttttx
aaaahhhhhhhhbbbaaaxtttttttttttxxxaabbbbbbbbbbbbbbbbbbbbbbbbbbbbbbbbbbbbhhbbbbeebbbbbbbbbbbbbbbbbaaaxxxxxxxxxxxxxxxtttttttttttttx
aaaabhhhhhhhbbaaaaxtttttttttttttxxaabbbbbbbbbbbbbbbbbbbbbbbeeeeemebbbbbbbbbbbeebbbbbbbbbbbbbbbbbbaaaaaaaaxxxxxxxxxxxtttttttttttx
aaaabhhhhhhhhbbbaaxttttttttttttttxaabbbbbbbbbbbbbbbbbeeeeeeebbeeeeeebbbbbbbbeebbbbbbbbbbbbbbbbbbbbaaaaaaaaaaaaaaxxxxxxttttttttxx
aaaabbhhhhhhhbbbbaxxttuutttttttttxaabbbbbbbbbbbbbbbbeebbbbbbbbbbebeeeebbbbbbeebbbbbbbbbbbbbbbbbbbbbbaaaaaaaaaaaaxxxxxxxxxxxxxxxx
aaaabbhhhhhhhhbbbbaxtuuutttttttttxaabbbbbbbbbbbbbeebebbbbbbbbbbbbbbbeeeeebbbeebbbbbbbbbbbbbbbbbbbbbbbbaaaaaaaaaaaaaaaaaaaaaaaaaa
aaaabbbhhhhhhhhbbbbauuuuuttttttttxaabbbbbbbbbbbbebbbbbbbbbbbbbbbbbbbbbeeeeebeebbneeebeeebeeebbbbbbbbhhhhhbbbaaaaaaaaaaaaaaaaaaaa
aaaabbbhhhhhhhhhbbbbbuuuuutttttttxaabbbbbbbbbbbembbbbbbbbbbbbbbbbbbbbbbbbeeeeeeeeeeebbbbbbbebbbbbbbhhhhhhhbbbbbbbbbbaaaaaaaaaaaa
aaaaabbbhhhhhhhhhbbbbbuuuuutttttxxabbbbbbbbbbbbbbbbbbbbbbbbbbbbbbbbbbbbbbbbeeeebbbbbbbbbbbbbbbbbbbhhhhhhhhhbbbbbbbbbbaaaaaaaaaaa
aaaaabbbbhhhhhhhhhbbbbbaxxttttttxaabbbbbbbbbbbbbbbbbbbbbbhhhbbbbbbbbbbbbbbbbeebbbbbbbbbbbbbbbbbbbhhhhhhhhhhhbbbbbbbbbbaaaaaaaaaa
aaaabbbbbhhhhhhhhhhbbbbaaxxttttxxabbbbbbbbbbbbbbbbbbbbbhhhhhbbbbbbbbbbbaaakfggfkaaaaaaaabbbbbbbbhhhhhhhhhhhhhhbbbbhhhbbaaaaaaaaa
aaaabbbbbbhhhhhhhhhhbbbbaaxxxttxaabbbbbbbbbbbbbbbbbbbbbhhhhbbbbbbbbbbaaaffffgggfffiiiffaaabbbbbhhhhhhhhhhhhhhhhhhhhhhhbbaaaaaaaa
aaaabbbbbbhhhhhhhhhhhbbbbaaaxxxxabbbbbbbbbbbbbbbbbbbbbbhhhbbbbbbbbbaaaffffffggggfiiiiifffabbbbhhhhhhhhhhhhhhhhhhhhhhhhbbbaaaaaaa
aaaabbbbbbbhhhhhhhhhhhbbbbbaaaaabbbbbbbbbbbbbbbbbbbbbbbbbbbbbbbbbbaaffffffffffgggfiiiiiffaabbhhhhhhhhhhhhhhhhhhhhhhhhhbbbbaaaaaa
aaaabbbbbbbbbhhhhhhhhhbbbbbbbaabbbbbbbbbbbbbbbbbbbbbbbbbbbbbbbbbbaafffffffffgggggffiiiiiffabbhhhhhhhhhhhhhhhhhhhhhhhhhhbbbbaaaaa
aaabbbbbbbbbbbhhhhhhhhbbbbbbbbbbbbbbbbbbbbbbbbbbbbbbbbbbbbbbbbbbaaffffccccccccclggffiiiiifabbhhhhhhhhhhhhhhhhhhhhhhhhhhhbbbbaaaa
aaabbbbbbbbbbbbhhhhhhhbbbbbbbbbbbbbbbbbbbbbbbbbbbbbbbbbbbbbbbbbbaaffffcdddddddcgggffiiiiifaabbhhhhhhhhhhhhhhhhhhhhhhhhhhbbbbaaaa
aabbbbbbbbbbbbbbhhhhhhhbbbbbbbbbbbbbbbbbbbbbbbbbbbbbbbbbbbbbbbbbaaafffcdddddddcgggfffiiiifaabbbhhhhhhhhhhhhhhhhhhhhhhhhhbbbbbaaa
aaabbbbbbbbbbbbbbhhhhhhbbbbbbbbbbmbbbbbbbbbbbbbbbbbbbbbbbbbbbbbbaaafffcFFFFFFFcgfgffffiiifaaabbbhhhhhhhhhhhhhhhhhhhhhhhbbbbbbbaa
aaabbbbbbbbbbbbbbhhhhhhbbbbbbbbbbbbbbbbbbbbbbbbbbbbbbbbbbbbbbbbaaaaaffcdddddddcgggfgpffiffaaaabbhhhhhhhhhhhhhhhhhhhhhhhbbbbbbbaa
aaabbbbbbbbbbbbbbbhhhhhbbbbbbbbbbbbbbbbbbbbbbbbbbbbbbbbbbbbbbbbaaaaaffcdddddddcggggggfffffaaaabbbhhhhhhhhhhhhhhhhhhhhhhhbbbbbbaa
aaaabbbbbbbbbbbbbbhhhhhhbbbbbbbbbbbbbbbbbbbbbbbbbbbbbbbbbbbbbbbbaaaaffcddddddddgfgggffffffaaaaabbhhhhhhhhhhhhhhhhhhhhhhhhbbbbbba
aaaabbbbbbbbbbbbbbhhhhhhbbbbbbbbbbbbbbbbbbbbbbbbbbbbbbbbbbbbbbbbaaaaffcdddddddcgfggffffffffaaaaabbhhhhhhhhhhhhhhhhhhhhhhhbbbbbba
aaaabbbbbbbbbbbbbbbhhhhhbbbbbbbbbbbbbbbbbbbbbbbbbbbbbbbbbbbbbbbbaaaaffcdddddddcffggffffffffaaaaaabbhhhhhhhhhhhhhhhhhhhhhbbbbbbba
aaaaabbbbbbbbbbbbbbhhhhhbbbbbbbbbbbbbbbbbbbbbbbbbbbbbbbbbbbbbbbbaaaaffccccccccckffvvfffffffaaaaaaabbhhhhhhhhhhhhhhhhhhhhhbbbbbba
aaaaabbbbbbbbbbbbbbhhhhhbbbbbbbbbbbbbbbbbbbbbbbbbbbbbbbbbbbbbbbbbaaffffffffffffffffvvvfffffaaaaaaaabbhhhhhhhhhhhhhhhhhhhhbbbbbba
aaaaabbbbbbbbbbbbbbbhhhhbbbbbbbbbbbbbbbbbbbbbbbbbbbaaaabbbbbbbbbbbkfffffffaaaaaffffvvvffffaaaaaaaaaabbhhhhhhhhhhhhhhhhhhhbbbbbba
aaaabbbbbbbbbbbbbbbbhhhhbbbbbbbbbbbbbbbbbbbbbbbbbbaaaaaaabbbbbbbbbfffffaaaaaaaaaafffvvvffaaaaaaaaaaaabbbhhhhhhhhhhhhhhhbbbbbbaaa
aaaabbbbbbbbbbbbbbbbhhhhbbbbbbbbbbbbbbbbbbbbbbbbbaaaaaaaabbbbbbbbbfffaaaaaaaaaaqqqrrwwwwBqqqqqaaaaaaaabbbbbbhhhhhhhhbbbbbbbbbaaa
aaabbbaaaaaaabbbbbbbhhhhbbbaaabbbbbbbbbbbbbbbbbbbaaaaaaaaabbbbbbbbffaaaaaaaaaaaqqqqwwwwwwqqqqqaaaaaaaaaabbaaaahhhhhbbbbbbbbbaaaa
aaaaaaaaaaaaaabbbaaahhhaaaaaabbbbbbbbbbbbbbbbaaaaaaaaaaaaaabbbbbbbkaaaaaaaaaaaaqqqqwwwwwwwqqqqaaaaaaaaaaaaaaaaaaaaaaaaabbbbaaaaa
aaaaaaaaaaaaaabaaaaaaaaaaaaaaaaaaaaaaaabbbbbaaaaaaaaaaaaaaaaabbbbaaaaaaaaaaaaaaqqqqBwowwwwqqqqaaaaaaaaaaaaaaaaaaaaaaaaaaaaaaaaaa
aaaaaaaaaaaaaaaaaaaaaaaaaaaaaaaaaaaaaaaaaaaaaaaaaaaaaaaaaaaaaaaaaaaaaaaaaaaaaaaqqqqDDDDDDEqqqqaaaaaaaaaaaaaaaaaaaaaaaaaaaaaaaaaa
aaaaaaaaaaaaaaaaaaaaaaaaaaaaaaaaaaaaaaaaaaaaaaaaaaaaaaaaaaaaaaaaaaaaaaaaaaaaaaaqqqqCCCCCCCqqqqaaaaaaaaaaaaaaaaaaaaaaaaaaaaaaaaaa
"}
