"a" = (/turf,/area)
"b" = (/turf/simulated/floor/colored/grass,/area/special/lobby)
"c" = (/turf/simulated/floor/colored/dirt,/area/special/lobby)
"d" = (/obj/structure/interactive/lighting/streetlamp,/turf/simulated/floor/colored/dirt,/area/special/lobby)
"e" = (/obj/structure/interactive/lighting/streetlamp,/turf/simulated/floor/colored/grass,/area/special/lobby)
"f" = (/turf/simulated/wall/wood/brown,/area/special/lobby)
"g" = (/obj/structure/interactive/wishgranter/fake,/turf/simulated/floor/colored/dirt,/area/special/lobby)
"h" = (/turf/simulated/wall/river,/area/special/lobby)
"i" = (/obj/structure/interactive/door/wood,/turf/simulated/floor/wood/brown,/area/special/lobby)
"j" = (/turf/unsimulated,/area)
"k" = (/obj/structure/scenery/grass,/turf/simulated/floor/colored/grass,/area/special/lobby)
"l" = (/obj/structure/scenery/grass_bush,/turf/simulated/floor/colored/grass,/area/special/lobby)
"m" = (/obj/structure/scenery/flowers,/turf/simulated/floor/colored/grass,/area/special/lobby)
"n" = (/obj/structure/scenery/rocks,/turf/simulated/floor/colored/dirt,/area/special/lobby)
"o" = (/obj/structure/scenery/evergreen,/turf/simulated/floor/colored/grass,/area/special/lobby)
"p" = (/obj/marker/spawnpoint/lobby,/turf/simulated/floor/colored/dirt,/area/special/lobby)
"q" = (/obj/structure/interactive/bed,/obj/marker/spawnpoint/new_character,/turf/simulated/floor/wood/brown,/area/singleplayer)
"r" = (/turf/simulated/wall/wood/brown,/area/singleplayer)
"s" = (/turf/simulated/floor/wood/brown,/area/special/lobby)
"t" = (/obj/structure/smooth/table/wood,/turf/simulated/floor/wood/brown,/area/singleplayer)
"u" = (/obj/structure/smooth/table/wood,/obj/item/torch/candle,/turf/simulated/floor/wood/brown,/area/singleplayer)
"v" = (/turf/simulated/floor/stair/wood,/area/singleplayer)
"w" = (/turf/simulated/floor/wood/brown,/area/singleplayer)
"x" = (/obj/marker/mob_spawn/marwani/ship,/turf/simulated/floor/wood/brown,/area/singleplayer)
"y" = (/obj/structure/interactive/bed,/turf/simulated/floor/wood/brown,/area/singleplayer)
"A" = (/obj/structure/interactive/door/wood,/turf/simulated/floor/wood/brown,/area/singleplayer)
"B" = (/obj/marker/mob_spawn/player_debug,/turf/simulated/floor/wood/brown,/area/singleplayer)
"C" = (/turf/simulated/wall/river/non_moving,/area/singleplayer)

(1,1,1) = {"
aaaaaaaaaaaaaaaaaaaaaaaaaaaaaaaaaaaaaaaaaaaaaaaaaaaaaaaaaaaaaaaaaaaaaaaaaaaaaaaaaaaaaaaCCCCCCCCCCCCCCCCCCCCCCCCCCCCCCCCCCCCCaaaa
aaaaaaaaaaaaaaaaaaaaaaaaaaaaaaaaaaaaaaaaaaaaaaaaaaaaaaaaaaaaaaaaaaaaaaaaaaaaaaaaaaaaaaaCCCCCCCCCCCCCCCCCCCCCCCCCCCCCCCCCCCCCaaaa
aaaaaaaaaaaaaaaaaaaaaaaaaaaaaaaaaaaaaaaaaaaaaaaaaaaaaaaaaaaaaaaaaaaaaaaaaaaaaaaaaaaaaaaCCCCCCCCCCCCCCCCCCCCCCCCCCCCCCCCCCCCCaaaa
aaaaaaaaaaaaaaaaaaaaaaaaaaaaaaaaaaaaaaaaaaaaaaaaaaaaaaaaaaaaaaaaaaaaaaaaaaaaaaaaaaaaaaaCCCCCCCCCCCCCCCCCCCCCCCCCCCCCCCCCCCCCaaaa
aaaaaaaaaaaaaaaaaaaaaaaaaaaaaaaaaaaaaaaaaaaaaaaaaaaaaaaaaaaaaaaaaaaaaaaaaaaaaaaaaaaaaaaCCCCCCCCCCCCCCCCCCCCCCCCCCCCCCCCCCCCCaaaa
aaaaaaaaaaaaaaaaaaaaaaaaaaaaaaaaaaaaaaaaaaaaaaaaaaaaaaaaaaaaaaaaaaaaaaaaaaaaaaaaaaaaaaaCCCCCCCCCCCCCCCCCCCCCCCCCCCCCCCCCCCCCaaaa
aaaaaaaaaaaaaaaaaaaaaaaaaaaaaaaaaaaaaaaaaaaaaaaaaaaaaaaaaaaaaaaaaaaaaaaaaaaaaaaaaaaaaaaCCCCCCCCCCCCCCCCCCCCCCCCCCCCCCCCCCCCCaaaa
aaaaaaaaaaaaaaaaaaaaaaaaaaaaaaaaaaaaaaaaaaaaaaaaaaaaaaaaaaaaaaaaaaaaaaaaaaaaaaaaaaaaaaaCCCCCCCCCCCCCCCCCCCCCCCCCCCCCCCCCCCCCaaaa
aaaaaaaaaaaaaaaaaaaaaaaaaaaaaaaaaaaaaaaaaaaaaaaaaaaaaaaaaaaaaaaaaaaaaaaaaaaaaaaaaaaaaaaCCCCCCCCCCCCCCCCCCCCCCCCCCCCCCCCCCCCCaaaa
aaaaaaaaaaaaaaaaaaaaaaaaaaaaaaaaaaaaaaaaaaaaaaaaaaaaaaaaaaaaaaaaaaaaaaaaaaaaaaaaaaaaaaaCCCCCCCCCCCCCCCCCCCCCCCCCCCCCCCCCCCCCaaaa
aaaaaaaaaaaaaaaaaaaaaaaaaaaaaaaaaaaaaaaaaaaaaaaaaaaaaaaaaaaaaaaaaaaaaaaaaaaaaaaaaaaaaaaCCCCCCCCCCCCCCCCrrrrrCCCCCCCCCCCCCCCCaaaa
aaaaaaaaaaaaaaaaaaaaaaaaaaaaaaaaaaaaaaaaaaaaaaaaaaaaaaaaaaaaaaaaaaaaaaaaaaaaaaaaaaaaaaaCCCCCCCCCCCCCCCrrrrrrrCCCCCCCCCCCCCCCaaaa
aaaaaaaaaaaaaaaaaaaaaaaaaaaaaaaaaaaaaaaaaaaaaaaaaaaaaaaaaaaaaaaaaaaaaaaaaaaaaaaaaaaaaaaCCCCCCCCCCCCCCrrrrrrrrrCCCCCCCCCCCCCCaaaa
aaaaaaaaaaaaaaaaaaaaaaaaaaaaaaaaaaaaaaaaaaaaaaaaaaaaaaaaaaaaaaaaaaaaaaaaaaaaaaaaaaaaaaaCCCCCCCCCCCCCCrturvrttrCCCCCCCCCCCCCCaaaa
aaaaaaaaaaaaaaaaaaaaaaaaaaaaaaaaaaaaaaaaaaaaaaaaaaaaaaaaaaaaaaaaaaaaaaaaaaaaaaaaaaaaaaaCCCCCCCCCCCCCCrwwxwBwwrCCCCCCCCCCCCCCaaaa
aaaaaaaaaaaaaaaaaaaaaaaaaaaaaaaaaaaaaaaaaaaaaaaaaaaaaaaaaaaaaaaaaaaaaaaaaaaaaaaaaaaaaaaCCCCCCCCCCCCCCrwwwwwwwrCCCCCCCCCCCCCCaaaa
aaaaaaaaaaaaaaaaaaaaaaaaaaaaaaaaaaaaaaaaaaaaaaaaaaaaaaaaaaaaaaaaaaaaaaaaaaaaaaaaaaaaaaaCCCCCCCCCCCCCCrrrrwrrrrCCCCCCCCCCCCCCaaaa
aaaaaaaaaaaaaaaaaaaaaaaaaaaaaaaaaaaaaaaaaaaaaaaaaaaaaaaaaaaaaaaaaaaaaaaaaaaaaaaaaaaaaaaCCCCCCCCCCCCCCryurwruyrCCCCCCCCCCCCCCaaaa
aaaaaaaaaaaaaaaaaaaaaaaaaaaaaaaaaaaaaaaaaaaaaaaaaaaaaaaaaaaaaaaaaaaaaaaaaaaaaaaaaaaaaaaCCCCCCCCCCCCCCrwwrwAwwrCCCCCCCCCCCCCCaaaa
aaaaaaaaaaaaaaaaaaaaaaaaaaaaaaaaaaaaaaaaaaaaaaaaaaaaaaaaaaaaaaaaaaaaaaaaaaaaaaaaaaaaaaaCCCCCCCCCCCCCCrwwAwrwwrCCCCCCCCCCCCCCaaaa
aaaaaaaaaaaaaaaaaaaaaaaaaaaaaaaaaaaaaaaaaaaaaaaaaaaaaaaaaaaaaaaaaaaaaaaaaaaaaaaaaaaaaaaCCCCCCCCCCCCCCrwwrwrwwrCCCCCCCCCCCCCCaaaa
aaaaaaaaaaaaaaaaaaaaaaaaaaaaaaaaaaaaaaaaaaaaaaaaaaaaaaaaaaaaaaaaaaaaaaaaaaaaaaaaaaaaaaaCCCCCCCCCCCCCCrrrrwrrrrCCCCCCCCCCCCCCaaaa
aaaaaaaaaaaaaaaaaaaaaaaaaaaaaaaaaaaaaaaaaaaaaaaaaaaaaaaaaaaaaaaaaaaaaaaaaaaaaaaaaaaaaaaCCCCCCCCCCCCCCrqurwruyrCCCCCCCCCCCCCCaaaa
aaaaaaaaaaaaaaaaaaaaaaaaaaaaaaaaaaaaaaaaaaaaaaaaaaaaaaaaaaaaaaaaaaaaaaaaaaaaaaaaaaaaaaaCCCCCCCCCCCCCCrwwrwAwwrCCCCCCCCCCCCCCaaaa
aaaaaaaaaaaaaaaaaaaaaaaaaaaaaaaaaaaaaaaaaaaaaaaaaaaaaaaaaaaaaaaaaaaaaaaaaaaaaaaaaaaaaaaCCCCCCCCCCCCCCrwwAwrwwrCCCCCCCCCCCCCCaaaa
aaaaaaaaaaaaaaaaaaaaaaaaaaaaaaaaaaaaaaaaaaaaaaaaaaaaaaaaaaaaaaaaaaaaaaaaaaaaaaaaaaaaaaaCCCCCCCCCCCCCCrwwrwrwwrCCCCCCCCCCCCCCaaaa
aaaaaaaaaaaaaaaaaaaaaaaaaaaaaaaaaaaaaaaaaaaaaaaaaaaaaaaaaaaaaaaaaaaaaaaaaaaaaaaaaaaaaaaCCCCCCCCCCCCCCrrrrwrrrrCCCCCCCCCCCCCCaaaa
aaaaaaaaaaaaaaaaaaaaaaaaaaaaaaaaaaaaaaaaaaaaaaaaaaaaaaaaaaaaaaaaaaaaaaaaaaaaaaaaaaaaaaaCCCCCCCCCCCCCCCrwwwwwrCCCCCCCCCCCCCCCaaaa
aaaaaaaaaaaaaaaaaaaaaaaaaaaaaaaaaaaaaaaaaaaaaaaaaaaaaaaaaaaaaaaaaaaaaaaaaaaaaaaaaaaaaaaCCCCCCCCCCCCCCCrruttrrCCCCCCCCCCCCCCCaaaa
aaaaaaaaaaaaaaaaaaaaaaaaaaaaaaaaaaaaaaaaaaaaaaaaaaaaaaaaaaaaaaaaaaaaaaaaaaaaaaaaaaaaaaaCCCCCCCCCCCCCCCCrrrrrCCCCCCCCCCCCCCCCaaaa
aaaaaaaaaaaaaaaaaaaaaaaaaaaaaaaaaaaaaaaaaaaaaaaaaaaaaaaaaaaaaaaaaaaaaaaaaaaaaaaaaaaaaaaCCCCCCCCCCCCCCCCCCCCCCCCCCCCCCCCCCCCCaaaa
aaaaaaaaaaaaaaaaaaaaaaaaaaaaaaaaaaaaaaaaaaaaaaaaaaaaaaaaaaaaaaaaaaaaaaaaaaaaaaaaaaaaaaaCCCCCCCCCCCCCCCCCCCCCCCCCCCCCCCCCCCCCaaaa
aaaaaaaaaaaaaaaaaaaaaaaaaaaaaaaaaaaaaaaaaaaaaaaaaaaaaaaaaaaaaaaaaaaaaaaaaaaaaaaaaaaaaaaCCCCCCCCCCCCCCCCCCCCCCCCCCCCCCCCCCCCCaaaa
aaaaaaaaaaaaaaaaaaaaaaaaaaaaaaaaaaaaaaaaaaaaaaaaaaaaaaaaaaaaaaaaaaaaaaaaaaaaaaaaaaaaaaaCCCCCCCCCCCCCCCCCCCCCCCCCCCCCCCCCCCCCaaaa
aaaaaaaaaaaaaaaaaaaaaaaaaaaaaaaaaaaaaaaaaaaaaaaaaaaaaaaaaaaaaaaaaaaaaaaaaaaaaaaaaaaaaaaCCCCCCCCCCCCCCCCCCCCCCCCCCCCCCCCCCCCCaaaa
aaaaaaaaaaaaaaaaaaaaaaaaaaaaaaaaaaaaaaaaaaaaaaaaaaaaaaaaaaaaaaaaaaaaaaaaaaaaaaaaaaaaaaaCCCCCCCCCCCCCCCCCCCCCCCCCCCCCCCCCCCCCaaaa
aaaaaaaaaaaaaaaaaaaaaaaaaaaaaaaaaaaaaaaaaaaaaaaaaaaaaaaaaaaaaaaaaaaaaaaaaaaaaaaaaaaaaaaCCCCCCCCCCCCCCCCCCCCCCCCCCCCCCCCCCCCCaaaa
aaaaaaaaaaaaaaaaaaaaaaaaaaaaaaaaaaaaaaaaaaaaaaaaaaaaaaaaaaaaaaaaaaaaaaaaaaaaaaaaaaaaaaaCCCCCCCCCCCCCCCCCCCCCCCCCCCCCCCCCCCCCaaaa
aaaaaaaaaaaaaaaaaaaaaaaaaaaaaaaaaaaaaaaaaaaaaaaaaaaaaaaaaaaaaaaaaaaaaaaaaaaaaaaaaaaaaaaCCCCCCCCCCCCCCCCCCCCCCCCCCCCCCCCCCCCCaaaa
aaaaaaaaaaaaaaaaaaaaaaaaaaaaaaaaaaaaaaaaaaaaaaaaaaaaaaaaaaaaaaaaaaaaaaaaaaaaaaaaaaaaaaaCCCCCCCCCCCCCCCCCCCCCCCCCCCCCCCCCCCCCaaaa
aaaaaaaaaaaaaaaaaaaaaaaaaaaaaaaaaaaaaaaaaaaaaaaaaaaaaaaaaaaaaaaaaaaaaaaaaaaaaaaaaaaaaaaCCCCCCCCCCCCCCCCCCCCCCCCCCCCCCCCCCCCCaaaa
aaaaaaaaaaaaaaaaaaaaaaaaaaaaaaaaaaaaaaaaaaaaaaaaaaaaaaaaaaaaaaaaaaaaaaaaaaaaaaaaaaaaaaaCCCCCCCCCCCCCCCCCCCCCCCCCCCCCCCCCCCCCaaaa
aaaaaaaaaaaaaaaaaaaaaaaaaaaaaaaaaaaaaaaaaaaaaaaaaaaaaaaaaaaaaaaaaaaaaaaaaaaaaaaaaaaaaaaCCCCCCCCCCCCCCCCCCCCCCCCCCCCCCCCCCCCCaaaa
aaaaaaaaaaaaaaaaaaaaaaaaaaaaaaaaaaaaaaaaaaaaaaaaaaaaaaaaaaaaaaaaaaaaaaaaaaaaaaaaaaaaaaaCCCCCCCCCCCCCCCCCCCCCCCCCCCCCCCCCCCCCaaaa
aaaaaaaaaaaaaaaaaaaaaaaaaaaaaaaaaaaaaaaaaaaaaaaaaaaaaaaaaaaaaaaaaaaaaaaaaaaaaaaaaaaaaaaCCCCCCCCCCCCCCCCCCCCCCCCCCCCCCCCCCCCCaaaa
aaaaaaaaaaaaaaaaaaaaaaaaaaaaaaaaaaaaaaaaaaaaaaaaaaaaaaaaaaaaaaaaaaaaaaaaaaaaaaaaaaaaaaaCCCCCCCCCCCCCCCCCCCCCCCCCCCCCCCCCCCCCaaaa
aaaaaaaaaaaaaaaaaaaaaaaaaaaaaaaaaaaaaaaaaaaaaaaaaaaaaaaaaaaaaaaaaaaaaaaaaaaaaaaaaaaaaaaCCCCCCCCCCCCCCCCCCCCCCCCCCCCCCCCCCCCCaaaa
aaaaaaaaaaaaaaaaaaaaaaaaaaaaaaaaaaaaaaaaaaaaaaaaaaaaaaaaaaaaaaaaaaaaaaaaaaaaaaaaaaaaaaaCCCCCCCCCCCCCCCCCCCCCCCCCCCCCCCCCCCCCaaaa
aaaaaaaaaaaaaaaaaaaaaaaaaaaaaaaaaaaaaaaaaaaaaaaaaaaaaaaaaaaaaaaaaaaaaaaaaaaaaaaaaaaaaaaCCCCCCCCCCCCCCCCCCCCCCCCCCCCCCCCCCCCCaaaa
aaaaaaaaaaaaaaaaaaaaaaaaaaaaaaaaaaaaaaaaaaaaaaaaaaaaaaaaaaaaaaaaaaaaaaaaaaaaaaaaaaaaaaaCCCCCCCCCCCCCCCCCCCCCCCCCCCCCCCCCCCCCaaaa
aaaaaaaaaaaaaaaaaaaaaaaaaaaaaaaaaaaaaaaaaaaaaaaaaaaaaaaaaaaaaaaaaaaaaaaaaaaaaaaaaaaaaaaCCCCCCCCCCCCCCCCCCCCCCCCCCCCCCCCCCCCCaaaa
aaaaaaaaaaaaaaaaaaaaaaaaaaaaaaaaaaaaaaaaaaaaaaaaaaaaaaaaaaaaaaaaaaaaaaaaaaaaaaaaaaaaaaaCCCCCCCCCCCCCCCCCCCCCCCCCCCCCCCCCCCCCaaaa
aaaaaaaaaaaaaaaaaaaaaaaaaaaaaaaaaaaaaaaaaaaaaaaaaaaaaaaaaaaaaaaaaaaaaaaaaaaaaaaaaaaaaaaCCCCCCCCCCCCCCCCCCCCCCCCCCCCCCCCCCCCCaaaa
aaaaaaaaaaaaaaaaaaaaaaaaaaaaaaaaaaaaaaaaaaaaaaaaaaaaaaaaaaaaaaaaaaaaaaaaaaaaaaaaaaaaaaaCCCCCCCCCCCCCCCCCCCCCCCCCCCCCCCCCCCCCaaaa
aaaaaaaaaaaaaaaaaaaaaaaaaaaaaaaaaaaaaaaaaaaaaaaaaaaaaaaaaaaaaaaaaaaaaaaaaaaaaaaaaaaaaaaCCCCCCCCCCCCCCCCCCCCCCCCCCCCCCCCCCCCCaaaa
aaaaaaaaaaaaaaaaaaaaaaaaaaaaaaaaaaaaaaaaaaaaaaaaaaaaaaaaaaaaaaaaaaaaaaaaaaaaaaaaaaaaaaaCCCCCCCCCCCCCCCCCCCCCCCCCCCCCCCCCCCCCaaaa
aaaaaaaaaaaaaaaaaaaaaaaaaaaaaaaaaaaaaaaaaaaaaaaaaaaaaaaaaaaaaaaaaaaaaaaaaaaaaaaaaaaaaaaCCCCCCCCCCCCCCCCCCCCCCCCCCCCCCCCCCCCCaaaa
aaaaaaaaaaaaaaaaaaaaaaaaaaaaaaaaaaaaaaaaaaaaaaaaaaaaaaaaaaaaaaaaaaaaaaaaaaaaaaaaaaaaaaaCCCCCCCCCCCCCCCCCCCCCCCCCCCCCCCCCCCCCaaaa
aaaaaaaaaaaaaaaaaaaaaaaaaaaaaaaaaaaaaaaaaaaaaaaaaaaaaaaaaaaaaaaaaaaaaaaaaaaaaaaaaaaaaaaCCCCCCCCCCCCCCCCCCCCCCCCCCCCCCCCCCCCCaaaa
aaaaaaaaaaaaaaaaaaaaaaaaaaaaaaaaaaaaaaaaaaaaaaaaaaaaaaaaaaaaaaaaaaaaaaaaaaaaaaaaaaaaaaaCCCCCCCCCCCCCCCCCCCCCCCCCCCCCCCCCCCCCaaaa
aaaaaaaaaaaaaaaaaaaaaaaaaaaaaaaaaaaaaaaaaaaaaaaaaaaaaaaaaaaaaaaaaaaaaaaaaaaaaaaaaaaaaaaCCCCCCCCCCCCCCCCCCCCCCCCCCCCCCCCCCCCCaaaa
aaaaaaaaaaaaaaaaaaaaaaaaaaaaaaaaaaaaaaaaaaaaaaaaaaaaaaaaaaaaaaaaaaaaaaaaaaaaaaaaaaaaaaaCCCCCCCCCCCCCCCCCCCCCCCCCCCCCCCCCCCCCaaaa
aaaaaaaaaaaaaaaaaaaaaaaaaaaaaaaaaaaaaaaaaaaaaaaaaaaaaaaaaaaaaaaaaaaaaaaaaaaaaaaaaaaaaaaCCCCCCCCCCCCCCCCCCCCCCCCCCCCCCCCCCCCCaaaa
aaaaaaaaaaaaaaaaaaaaaaaaaaaaaaaaaaaaaaaaaaaaaaaaaaaaaaaaaaaaaaaaaaaaaaaaaaaaaaaaaaaaaaaCCCCCCCCCCCCCCCCCCCCCCCCCCCCCCCCCCCCCaaaa
aaaaaaaaaaaaaaaaaaaaaaaaaaaaaaaaaaaaaaaaaaaaaaaaaaaaaaaaaaaaaaaaaaaaaaaaaaaaaaaaaaaaaaaCCCCCCCCCCCCCCCCCCCCCCCCCCCCCCCCCCCCCaaaa
aaaaaaaaaaaaaaaaaaaaaaaaaaaaaaaaaaaaaaaaaaaaaaaaaaaaaaaaaaaaaaaaaaaaaaaaaaaaaaaaaaaaaaaCCCCCCCCCCCCCCCCCCCCCCCCCCCCCCCCCCCCCaaaa
aaaaaaaaaaaaaaaaaaaaaaaaaaaaaaaaaaaaaaaaaaaaaaaaaaaaaaaaaaaaaaaaaaaaaaaaaaaaaaaaaaaaaaaCCCCCCCCCCCCCCCCCCCCCCCCCCCCCCCCCCCCCaaaa
aaaaaaaaaaaaaaaaaaaaaaaaaaaaaaaaaaaaaaaaaaaaaaaaaaaaaaaaaaaaaaaaaaaaaaaaaaaaaaaaaaaaaaaCCCCCCCCCCCCCCCCCCCCCCCCCCCCCCCCCCCCCaaaa
aaaaaaaaaaaaaaaaaaaaaaaaaaaaaaaaaaaaaaaaaaaaaaaaaaaaaaaaaaaaaaaaaaaaaaaaaaaaaaaaaaaaaaaCCCCCCCCCCCCCCCCCCCCCCCCCCCCCCCCCCCCCaaaa
aaaaaaaaaaaaaaaaaaaaaaaaaaaaaaaaaaaaaaaaaaaaaaaaaaaaaaaaaaaaaaaaaaaaaaaaaaaaaaaaaaaaaaaCCCCCCCCCCCCCCCCCCCCCCCCCCCCCCCCCCCCCaaaa
aaaaaaaaaaaaaaaaaaaaaaaaaaaaaaaaaaaaaaaaaaaaaaaaaaaaaaaaaaaaaaaaaaaaaaaaaaaaaaaaaaaaaaaCCCCCCCCCCCCCCCCCCCCCCCCCCCCCCCCCCCCCaaaa
aaaaaaaaaaaaaaaaaaaaaaaaaaaaaaaaaaaaaaaaaaaaaaaaaaaaaaaaaaaaaaaaaaaaaaaaaaaaaaaaaaaaaaaCCCCCCCCCCCCCCCCCCCCCCCCCCCCCCCCCCCCCaaaa
aaaaaaaaaaaaaaaaaaaaaaaaaaaaaaaaaaaaaaaaaaaaaaaaaaaaaaaaaaaaaaaaaaaaaaaaaaaaaaaaaaaaaaaCCCCCCCCCCCCCCCCCCCCCCCCCCCCCCCCCCCCCaaaa
aaaaaaaaaaaaaaaaaaaaaaaaaaaaaaaaaaaaaaaaaaaaaaaaaaaaaaaaaaaaaaaaaaaaaaaaaaaaaaaaaaaaaaaCCCCCCCCCCCCCCCCCCCCCCCCCCCCCCCCCCCCCaaaa
aaaaaaaaaaaaaaaaaaaaaaaaaaaaaaaaaaaaaaaaaaaaaaaaaaaaaaaaaaaaaaaaaaaaaaaaaaaaaaaaaaaaaaaCCCCCCCCCCCCCCCCCCCCCCCCCCCCCCCCCCCCCaaaa
aaaaaaaaaaaaaaaaaaaaaaaaaaaaaaaaaaaaaaaaaaaaaaaaaaaaaaaaaaaaaaaaaaaaaaaaaaaaaaaaaaaaaaaCCCCCCCCCCCCCCCCCCCCCCCCCCCCCCCCCCCCCaaaa
aaaaaaaaaaaaaaaaaaaaaaaaaaaaaaaaaaaaaaaaaaaaaaaaaaaaaaaaaaaaaaaaaaaaaaaaaaaaaaaaaaaaaaaCCCCCCCCCCCCCCCCCCCCCCCCCCCCCCCCCCCCCaaaa
aaaaaaaaaaaaaaaaaaaaaaaaaaaaaaaaaaaaaaaaaaaaaaaaaaaaaaaaaaaaaaaaaaaaaaaaaaaaaaaaaaaaaaaCCCCCCCCCCCCCCCCCCCCCCCCCCCCCCCCCCCCCaaaa
aaaaaaaaaaaaaaaaaaaaaaaaaaaaaaaaaaaaaaaaaaaaaaaaaaaaaaaaaaaaaaaaaaaaaaaaaaaaaaaaaaaaaaaCCCCCCCCCCCCCCCCCCCCCCCCCCCCCCCCCCCCCaaaa
aaaaaaaaaaaaaaaaaaaaaaaaaaaaaaaaaaaaaaaaaaaaaaaaaaaaaaaaaaaaaaaaaaaaaaaaaaaaaaaaaaaaaaaCCCCCCCCCCCCCCCCCCCCCCCCCCCCCCCCCCCCCaaaa
aaaaaaaaaaaaaaaaaaaaaaaaaaaaaaaaaaaaaaaaaaaaaaaaaaaaaaaaaaaaaaaaaaaaaaaaaaaaaaaaaaaaaaaCCCCCCCCCCCCCCCCCCCCCCCCCCCCCCCCCCCCCaaaa
aaaaaaaaaaaaaaaaaaaaaaaaaaaaaaaaaaaaaaaaaaaaaaaaaaaaaaaaaaaaaaaaaaaaaaaaaaaaaaaaaaaaaaaCCCCCCCCCCCCCCCCCCCCCCCCCCCCCCCCCCCCCaaaa
aaaaaaaaaaaaaaaaaaaaaaaaaaaaaaaaaaaaaaaaaaaaaaaaaaaaaaaaaaaaaaaaaaaaaaaaaaaaaaaaaaaaaaaCCCCCCCCCCCCCCCCCCCCCCCCCCCCCCCCCCCCCaaaa
aaaaaaaaaaaaaaaaaaaaaaaaaaaaaaaaaaaaaaaaaaaaaaaaaaaaaaaaaaaaaaaaaaaaaaaaaaaaaaaaaaaaaaaCCCCCCCCCCCCCCCCCCCCCCCCCCCCCCCCCCCCCaaaa
aaaaaaaaaaaaaaaaaaaaaaaaaaaaaaaaaaaaaaaaaaaaaaaaaaaaaaaaaaaaaaaaaaaaaaaaaaaaaaaaaaaaaaaCCCCCCCCCCCCCCCCCCCCCCCCCCCCCCCCCCCCCaaaa
aaaaaaaaaaaaaaaaaaaaaaaaaaaaaaaaaaaaaaaaaaaaaaaaaaaaaaaaaaaaaaaaaaaaaaaaaaaaaaaaaaaaaaaCCCCCCCCCCCCCCCCCCCCCCCCCCCCCCCCCCCCCaaaa
aaaaaaaaaaaaaaaaaaaaaaaaaaaaaaaaaaaaaaaaaaaaaaaaaaaaaaaaaaaaaaaaaaaaaaaaaaaaaaaaaaaaaaaCCCCCCCCCCCCCCCCCCCCCCCCCCCCCCCCCCCCCaaaa
aaaaaaaaaaaaaaaaaaaaaaaaaaaaaaaaaaaaaaaaaaaaaaaaaaaaaaaaaaaaaaaaaaaaaaaaaaaaaaaaaaaaaaaCCCCCCCCCCCCCCCCCCCCCCCCCCCCCCCCCCCCCaaaa
aaaaaaaaaaaaaaaaaaaaaaaaaaaaaaaaaaaaaaaaaaaaaaaaaaaaaaaaaaaaaaaaaaaaaaaaaaaaaaaaaaaaaaaCCCCCCCCCCCCCCCCCCCCCCCCCCCCCCCCCCCCCaaaa
aaaaaaaaaaaaaaaaaaaaaaaaaaaaaaaaaaaaaaaaaaaaaaaaaaaaaaaaaaaaaaaaaaaaaaaaaaaaaaaaaaaaaaaCCCCCCCCCCCCCCCCCCCCCCCCCCCCCCCCCCCCCaaaa
aaaaaaaaaaaaaaaaaaaaaaaaaaaaaaaaaaaaaaaaaaaaaaaaaaaaaaaaaaaaaaaaaaaaaaaaaaaaaaaaaaaaaaaCCCCCCCCCCCCCCCCCCCCCCCCCCCCCCCCCCCCCaaaa
aaaaaaaaaaaaaaaaaaaaaaaaaaaaaaaaaaaaaaaaaaaaaaaaaaaaaaaaaaaaaaaaaaaaaaaaaaaaaaaaaaaaaaaCCCCCCCCCCCCCCCCCCCCCCCCCCCCCCCCCCCCCaaaa
aaaaaaaaaaaaaaaaaaaaaaaaaaaaaaaaaaaaaaaaaaaaaaaaaaaaaaaaaaaaaaaaaaaaaaaaaaaaaaaaaaaaaaaCCCCCCCCCCCCCCCCCCCCCCCCCCCCCCCCCCCCCaaaa
aaaaaaaaaaaaaaaaaaaaaaaaaaaaaaaaaaaaaaaaaaaaaaaaaaaaaaaaaaaaaaaaaaaaaaaaaaaaaaaaaaaaaaaCCCCCCCCCCCCCCCCCCCCCCCCCCCCCCCCCCCCCaaaa
aaaaaaaaaaaaaaaaaaaaaaaaaaaaaaaaaaaaaaaaaaaaaaaaaaaaaaaaaaaaaaaaaaaaaaaaaaaaaaaaaaaaaaaCCCCCCCCCCCCCCCCCCCCCCCCCCCCCCCCCCCCCaaaa
jjjjjjjjjjjjjjjjjjjjjjjjjjjjjjjjjjjaaaaaaaaaaaaaaaaaaaaaaaaaaaaaaaaaaaaaaaaaaaaaaaaaaaaCCCCCCCCCCCCCCCCCCCCCCCCCCCCCCCCCCCCCaaaa
jkkkkkkkbbbbkkkkbccebkbchhhhcbkkkkjaaaaaaaaaaaaaaaaaaaaaaaaaaaaaaaaaaaaaaaaaaaaaaaaaaaaCCCCCCCCCCCCCCCCCCCCCCCCCCCCCCCCCCCCCaaaa
jkkkkdcccccccccdbccbbkochhhhcbbkkkjaaaaaaaaaaaaaaaaaaaaaaaaaaaaaaaaaaaaaaaaaaaaaaaaaaaaCCCCCCCCCCCCCCCCCCCCCCCCCCCCCCCCCCCCCaaaa
jbbbbcfffffffffcbcccbkkchhhhccbkkkjaaaaaaaaaaaaaaaaaaaaaaaaaaaaaaaaaaaaaaaaaaaaaaaaaaaaCCCCCCCCCCCCCCCCCCCCCCCCCCCCCCCCCCCCCaaaa
jbbbbcfsssssssfcbbccebbchhhhccbkkkjaaaaaaaaaaaaaaaaaaaaaaaaaaaaaaaaaaaaaaaaaaaaaaaaaaaaCCCCCCCCCCCCCCCCCCCCCCCCCCCCCCCCCCCCCaaaa
jbbbbcfsssssssfcbbcccbbchhhhccbkkkjaaaaaaaaaaaaaaaaaaaaaaaaaaaaaaaaaaaaaaaaaaaaaaaaaaaaCCCCCCCCCCCCCCCCCCCCCCCCCCCCCCCCCCCCCaaaa
jbbbbcfsssssssfclbmccbnnhhhhccbkkkjaaaaaaaaaaaaaaaaaaaaaaaaaaaaaaaaaaaaaaaaaaaaaaaaaaaaCCCCCCCCCCCCCCCCCCCCCCCCCCCCCCCCCCCCCaaaa
jbbbbcfsssssssfcbbeccnnnhhhhccbokkjaaaaaaaaaaaaaaaaaaaaaaaaaaaaaaaaaaaaaaaaaaaaaaaaaaaaCCCCCCCCCCCCCCCCCCCCCCCCCCCCCCCCCCCCCaaaa
jkkbbcfsssssssfckbbccnnnhhhhccbkkkjaaaaaaaaaaaaaaaaaaaaaaaaaaaaaaaaaaaaaaaaaaaaaaaaaaaaCCCCCCCCCCCCCCCCCCCCCCCCCCCCCCCCCCCCCaaaa
jkkbbcfsssssssfckkbcccnnhhhhcbkkkkjaaaaaaaaaaaaaaaaaaaaaaaaaaaaaaaaaaaaaaaaaaaaaaaaaaaaCCCCCCCCCCCCCCCCCCCCCCCCCCCCCCCCCCCCCaaaa
jkkbbcfsssssssfcbkocccnnhhhhcbkkkkjaaaaaaaaaaaaaaaaaaaaaaaaaaaaaaaaaaaaaaaaaaaaaaaaaaaaCCCCCCCCCCCCCCCCCCCCCCCCCCCCCCCCCCCCCaaaa
jkkbbcfsssssssfcbkkccbcchhhhcbbkkkjaaaaaaaaaaaaaaaaaaaaaaaaaaaaaaaaaaaaaaaaaaaaaaaaaaaaCCCCCCCCCCCCCCCCCCCCCCCCCCCCCCCCCCCCCaaaa
jkkbbcffffiffffcbbbccbbchhhhccbkkkjaaaaaaaaaaaaaaaaaaaaaaaaaaaaaaaaaaaaaaaaaaaaaaaaaaaaCCCCCCCCCCCCCCCCCCCCCCCCCCCCCCCCCCCCCaaaa
jkkbbdcccccccccdbbecccbchhhhcnbkkkjaaaaaaaaaaaaaaaaaaaaaaaaaaaaaaaaaaaaaaaaaaaaaaaaaaaaCCCCCCCCCCCCCCCCCCCCCCCCCCCCCCCCCCCCCaaaa
jbkbbbbblbcbbbbbblcccbbchhhhccbkkkjaaaaaaaaaaaaaaaaaaaaaaaaaaaaaaaaaaaaaaaaaaaaaaaaaaaaCCCCCCCCCCCCCCCCCCCCCCCCCCCCCCCCCCCCCaaaa
jbkbobbbbbcckkkbbccccblchhhhccbkkkjaaaaaaaaaaaaaaaaaaaaaaaaaaaaaaaaaaaaaaaaaaaaaaaaaaaaCCCCCCCCCCCCCCCCCCCCCCCCCCCCCCCCCCCCCaaaa
jbkbmmmmmkkckokbcpccbbcchhhhcbbkkkjaaaaaaaaaaaaaaaaaaaaaaaaaaaaaaaaaaaaaaaaaaaaaaaaaaaaCCCCCCCCCCCCCCCCCCCCCCCCCCCCCCCCCCCCCaaaa
jbkbmmmmmkkcccbeccccbbcchhhhckkkkkjaaaaaaaaaaaaaaaaaaaaaaaaaaaaaaaaaaaaaaaaaaaaaaaaaaaaCCCCCCCCCCCCCCCCCCCCCCCCCCCCCCCCCCCCCaaaa
jbkbmmgmmkkkkccccccbbbcchhhhcbkkkkjaaaaaaaaaaaaaaaaaaaaaaaaaaaaaaaaaaaaaaaaaaaaaaaaaaaaCCCCCCCCCCCCCCCCCCCCCCCCCCCCCCCCCCCCCaaaa
jbkkmmcmmkkkbbccccebbbbchhhhcbkkkkjaaaaaaaaaaaaaaaaaaaaaaaaaaaaaaaaaaaaaaaaaaaaaaaaaaaaCCCCCCCCCCCCCCCCCCCCCCCCCCCCCCCCCCCCCaaaa
jbbkbmcmbkkbbbccccbbombchhhhcbbkokjaaaaaaaaaaaaaaaaaaaaaaaaaaaaaaaaaaaaaaaaaaaaaaaaaaaaCCCCCCCCCCCCCCCCCCCCCCCCCCCCCCCCCCCCCaaaa
jbbkbbccbmobecccclbkkbcchhhhccbkkkjaaaaaaaaaaaaaaaaaaaaaaaaaaaaaaaaaaaaaaaaaaaaaaaaaaaaCCCCCCCCCCCCCCCCCCCCCCCCCCCCCCCCCCCCCaaaa
jbbkkbbccbbbccccbbbkkbcchhhhccbkkkjaaaaaaaaaaaaaaaaaaaaaaaaaaaaaaaaaaaaaaaaaaaaaaaaaaaaCCCCCCCCCCCCCCCCCCCCCCCCCCCCCCCCCCCCCaaaa
jbeobbbbcelccccebmkkkmcchhhhnckkkkjaaaaaaaaaaaaaaaaaaaaaaaaaaaaaaaaaaaaaaaaaaaaaaaaaaaaCCCCCCCCCCCCCCCCCCCCCCCCCCCCCCCCCCCCCaaaa
jcccccbbcccccccbbkkkkbcchhhhnckkkkjaaaaaaaaaaaaaaaaaaaaaaaaaaaaaaaaaaaaaaaaaaaaaaaaaaaaCCCCCCCCCCCCCCCCCCCCCCCCCCCCCCCCCCCCCaaaa
jccccccccccccclbmkkkkbbchhhhnckkkkjaaaaaaaaaaaaaaaaaaaaaaaaaaaaaaaaaaaaaaaaaaaaaaaaaaaaCCCCCCCCCCCCCCCCCCCCCCCCCCCCCCCCCCCCCaaaa
jcccccccccccbbbbbkkokbbchhhhcckkkkjaaaaaaaaaaaaaaaaaaaaaaaaaaaaaaaaaaaaaaaaaaaaaaaaaaaaCCCCCCCCCCCCCCCCCCCCCCCCCCCCCCCCCCCCCaaaa
jbeccccccebbbbbbkkkkkbbchhhhccbkkkjaaaaaaaaaaaaaaaaaaaaaaaaaaaaaaaaaaaaaaaaaaaaaaaaaaaaCCCCCCCCCCCCCCCCCCCCCCCCCCCCCCCCCCCCCaaaa
jbbbbbbbbbbkkkkkkkkkbbbchhhhccbkkkjaaaaaaaaaaaaaaaaaaaaaaaaaaaaaaaaaaaaaaaaaaaaaaaaaaaaCCCCCCCCCCCCCCCCCCCCCCCCCCCCCCCCCCCCCaaaa
jbbobbbbkkkkkkkkkkkbbbbnhhhhcnbokkjaaaaaaaaaaaaaaaaaaaaaaaaaaaaaaaaaaaaaaaaaaaaaaaaaaaaCCCCCCCCCCCCCCCCCCCCCCCCCCCCCCCCCCCCCaaaa
jbbbbbkkkkkkkkkkkkkbbbcnhhhhcnbkkkjaaaaaaaaaaaaaaaaaaaaaaaaaaaaaaaaaaaaaaaaaaaaaaaaaaaaCCCCCCCCCCCCCCCCCCCCCCCCCCCCCCCCCCCCCaaaa
jbbbbbbbbbbbbbbbbbbbobcnhhhhcnbkkkjaaaaaaaaaaaaaaaaaaaaaaaaaaaaaaaaaaaaaaaaaaaaaaaaaaaaCCCCCCCCCCCCCCCCCCCCCCCCCCCCCCCCCCCCCaaaa
jjjjjjjjjjjjjjjjjjjjjjjjjjjjjjjjjjjaaaaaaaaaaaaaaaaaaaaaaaaaaaaaaaaaaaaaaaaaaaaaaaaaaaaCCCCCCCCCCCCCCCCCCCCCCCCCCCCCCCCCCCCCaaaa
"}
