"a" = (/turf/simulated/floor/lava,/area)
"b" = (/turf/simulated/floor/basalt,/area)
"c" = (/turf/simulated/wall/rock/basalt,/area)

(1,1,1) = {"
cccccccccccccccccccccccccccccccccccccccccccccccccccccccccccccccccccccccccccccccccccccccccccccccccccccccccccccccccccccccccccccccc
ccccccccccccccccccccccccccccccccccccccccccccccccccccccccccccccccccccccccccccccccccccccccccccccccccccccaaaaaaaaaaaaaaaaaaaaaaaaac
cccccccccccccbbbbbbbbbbbccccccccccccccccccccccccccccccccccccccccccccccccccccccccccccccccccccccccccccccaaaaaaaaaaaaaaaaaaaaaaaaac
cccccccccccbbbbbbbbbbbbbbbccccccccccccccccccccccccccccccccccccccccccccccccccccccccccccccccccccccccccaaaaaaaaaaaaaaaaaaaaaaaaaaac
cccccccccbbbbbbbbbbbbbbbbbbbccccccbbbbcccccccccccccccccccccccccccccccccccccccccccccccccccccccccccccaaaaaaaaaaaaaaaaaaaaaaaaaaaac
cccccccbbbbbbbbbbbbbbbbbbbbbbcccccbbbbbbbcccccccccccccccccccccccccccccccccccccccccccccccccccccccccaaaaaaaaaaaaaaaaaaaaaaaaaaaaac
ccccccbbbbbbbbbbbbbbbbbbbbbbbbccccbbbbbbbbbbbbccccccccccccccccccccccccccccccccccccccccccacaaaaaaaaaaaaaaaaaaaaaaaaaaaaaaaaaaaaac
cccccbbbbbbbbbbbbbbbbbbbbbbbbbcccccbbbbbbbbbbbccccccccccccccccccccccccccccccccccccaccccaaaaaaaaaaaaaaaaaaaaaaaaaaaaaaaaaaaaaaaac
cccccbbbbbbbbbbbbbbbbbbbbbbbbbcccccbbbbbbbbbbbbcccccccccccccccccccccccccccccccaaaaaaaaaaaaaaaaaaaaaaaaaaaaaaaaaaaaaaaaaaaaaaaaac
ccccbbbbbbbbbbbbbbbbbbbbbbbbbbbccccbbbbbbbbbbbbccbbbccccccccccccccccccccccccaaaaaaaaaaaaaaaaaaaaaaaaaaaaaaaaaaaaaaaaaaaaaaaaaaac
ccccbbbbbbbbbbbbbbbbbbbbbbbbbbcccccbbbbbbbbbbbbbbbbcccccccccccccccaaaaaaaaaaaaaaaaaaaaaaaaaaaaaaaaaaaaaaaaaaaaaaaaaaaaaaaaaaaaac
ccccbbbbbbbbbbbbbbbbbbbbbbbbbbccccccbbbbbbbbbbbbbbbcccccccccccccaaaaaaaaaaaaaaaaaaaaaaaaaaaaaaaaaaaaaaaaaaaaaaaaaaaaaaaaaaaaaaac
cccbbbbbbbbbbbbbbbbbbbbbbbbbbbccccccbbbbbbbbbbbbbbbbcccccccccccacaaaaaaaaaaaaaaaaaaaaaaaaaaaaaaaaaaaaaaaaabaaaaaaaaaaaaaaaaaaaac
cccbbbbbbbbbbbbbbbbbbbbbbbbbbbccccbbbbbbbbbbbbbbbbccccccccccbabaaaaaaaaaaaaaaaaaaaaaaaaaaaaaaaaaaaaaaaaaaabaaaaaaaaaaaaaaaaaaaac
ccbbbbbbbbbbbbbbbbbbbbbbbbbbbbcccccccbbbbbbbbbbbbbcccccccbbbbbbbbaaaaaaaaaaaaaaaaaaaaaaaaabaabbaaaabaaaabaaaabaaaaaaaaaaaaaaaaac
ccbbbbbbbbbbbbbbbbbbbbbbbbbbbccccccccbbbbbbbbbbbbbbbbbccbbbbbbbbbbbbaaaaaaaaaaaaaaaaaaaabbabbaaaaaaaaaaaaaaaabaaaaaaaaaaaaaaaaac
ccbbbbbbbbbbbbbbbbbbbbbbbbbbccccccbbbbbbbbbbbbbbbbbbbbccbbbbbbbbbbbbbababbbbbabaaaaababbbbaaaaaaaaaaaaaaaaaaaaaaaaaaaaaaaaaaaaac
ccbbbbbbbbbbbbbbbbbbbbbbbbbcccccccbbbbbbbbbbbbbbbbbbbbbbbbbbbbbbbbbbbbbbbbbbbbbbbbbababbbbbaabaaaaaaaaaaaaaaaaaaaaaaaaaaaaaaaaac
ccbbbbbbbbbbbbbbbbbbbbbbbcccccccbbbbbbbbbbbbbbbbbbbbbbbbbbbbbbbbbbbbbbbbbbbbbbbbbbbbabbabbaaaaaaaaaaabaaaaabaaaaaaaaaaaaaaaaaaac
ccbbbbbbbbbbbbbbbbbbbbbbbccccccbbbbbbbbbbbbbbbbbbbbbbbbbbbbbbbbbbbbbbbbbbbbbbbbbbbbbbbbbbbabbabaaaaaaaaaaaaaaaaaabaaabaaaaaaaaac
ccbbbbbbbbbbbbbbbbbbbbbccccbcbbbbbbbbbbbbbbbbbbbbbbbbbbbbbbbbbbbbbbbbbbbbbbbbbbbbbbbbbbbbbbbbaaaaaaabaaaaaaaaabaaaaaaaaaaaaaaaac
ccbbbbbbbbbbbbbbbbbbbcccccccbbbbbbbbbbbbbbbbbbbbbbbbbbbbbbbbbbbbbbbbbbbbbbbbbbbbbbbbabbbbbbbbaaabaaaaaaaaaaaaaaaaaaaabaaaaaaaaac
cccbbbbbbbbbbbbbbbbbccccccbbbbbbbbbbbbbbbbbbbbbbbbbbbbbbbbbbbbbbbbbbbbbbbbbbbbbbbbbabbbbbbbbbaaabbaabbaabaaaababaaaaaaaaaaaaaaac
ccccbbbbbbbbbbbbbbbccccccbbbbbbbbbbbbbbbbbbbbbbbbbbbbbbbbbbbbbbbbbbbbbbbbbbbbbbbbbbbbbbbbbabaaaaabbaabaaaabaaaabaaaaaaaaaaaaaaac
cccccccccccccbbbbbbbcccbbbbbbbbbbbbbbbbbbbbbbbbbbbbbbbbbbbbbbbbbbbbbbbbbbbbbbbbbbbbbbbbbbbbbaaaaaaaaaaabaaabbaaaaaaaaaaaaaaaaaac
cccccccccccccbbbbbbbcbbbbbbbbbbbbbbbbbbbbbbbbbbbbbbbbbbbbbbbbbbbbbbbbbbbbbbbbbbbbbbbbbbabbaaabaaaaaaaabaaaaaaabaaaaaaaaaaaaaaaac
cccccccccccccbbbbbbbbbbbbbbbbbbbbbbbbbbbbbbbbbbbbbbbbbbbbbbbbbbbbbbbbbbbbbbbbbbbbbbbbbbabaaaaaaaabaaaabaaaaaaaabaabaaaaaaaaaaaac
cccccccccccbbbbbbbbbbbbbbbbbbbbbbbbbbbbbbbbbbbbbbbbbbbbbbbbbbbbbbbbbbbbbbbbbbbbbbbbbbbbbbbbaaaaaabbaaaaaaabaaaaaaaaaaaaaaaaaaaac
cccccbbbbbbbbbbbbbbbbbbbbbbbbbbbbbbbbbbbbbbbbbbbbbbbbbbbbbbbbbbbbbbbbbbbbbbbbbbbbbbbbbbbbbbbaaaaaaabaaabaaaaaaaaaaaaaaaaaaaaaaac
ccccccbbbbbbbbbbbbbbbbbbbbbbbbbbbbbbbbbbbbbbbbbbbbbbbbbbbbbbbbbbbbbbbbbbbbbbbbbbbbbbbbbbbaabaaaaaababaaabaaaaaaaaaaaaaaaaaaaaaac
ccccccbbbbbbbbbbbbbbbbbbbbbbbbbbbbbbbbbbbbbbbbbbbbbbbbbbbbbbbbbbbbbbbbbbbbbbbbbbbbbbbaaabbbaaaaabbaaabaaaaaaaaaaaaaaaaaaaaaaaaac
ccccccbbbbbbbbbbbbbbbbbbbbbbbbbbbbbbbbbbbbbbbbbbbbbbbbbbbbbbbbbbbbbbbbbbbbbbbbbbbbbabbbbbababaabbaabbaaaaaaaaaaaabaaaaaaaaaaaaac
cccccccbbbbbbbbbbbbbbbbbbbbbbbbbbbbbbbbbbbbbbbbbbbbbbbbbbbbbbbbbbbbbbbbbbbbbbbbbbbbbbabbaaaaaabbabbaaabaaaaaaaaaaaaaaaaaaaaaaaac
cccccccbbbbbbbbbbbbbbbbbbbbbbbbbbbbbbbbbbbbbbbbbbbbbbbbbbbbbbbbbbbbbbbbbbbbbbbbbbbbbbbbabaabaaaaaaaaaaaaaaabaaaaaaaaaaaaaaaaaaac
ccccccbbbbbbbbbbbbbbbbbbbbbbbbbbbbbbbbbbbbbbbbbbbbbbbbbbbbbbbbbbbbbbbbbbbbbbbbbbbbbbbbbbaaaaaaaaabaaaaaaaaaaaaaaaaaaaaaaaaaaaaac
ccccccbbbbbbbbbbbbbbbbbbbbbbbbbbbbbbbbbbbbbbbbbbbbbbbbbbbbbabbbbbbbbbbbbbbbbbbbbbaaabaaabaaaaaaaaaaaaaaaaaaaaaaaaaaaaaaaaaaaaaac
cccccbbbbbbbbbbbbbbbbbbbbbbbbbbbbbbbbabbbbbbbbbbaaaaaaaaaaaaaaaaaaaaaaababbbaaabbbbbaabaaaaabaaaaaaaaaaaaaaaaaaaaaaaaaaaaaaaaaac
ccccbbbbbbbbbbbbbbbbbbbbbbbbbbbbbabbbbaaaabbbbbaaaaaaaaaaaaaaaaaaaaaaaaaaaaaaaaaabaaaaaaaaaaaaaaaaaaaaaaaaaaaaaaaaaaaaaaaaaaaaac
ccccbbbbbbbbbbbbbbbbbbbbbbbbbbbbbaaaaaaaaaaabbbaaaaaaaaaaaaaaaaaaaaaaaaaaaaaaaaaaaaaaaaaaaaaaaaaaaaaaaaaaaaaaaaaaaaaaaaaaaaaaaac
cccccbbbbbbbbbbbbbbbbbbbbbbbbbbbaaaaaaaaaaabbbbaaaaaaaaaaaaaaaaaaaaaaaaaaaaaaaaaaaaaaaaaaaaaaaaaaaaaaaaaaaaaaaaaaaaaaaaaaaaaaaac
cccccbbbbbbbbbbbbbbbbbbbbbbbbbaaaaaaaaaaaaaabbbbaaaaaaaaaaaaaaaaaaaaaaaaaaaaaaaaaaaaaaaaaaaaaaaaaaaaaaaaaaaaaaaaaaaaaaaaaaaaaaac
cccccbbbbbbbbbbbbbbbbbbbbbbaaaaaaaaaaaaaaaaabbbbbbbbbbabaaaaaaaaaaaaaaaaaaaaaaaaaaaaaaaaaaaaaaaaaaaaaaaaaaaaaaaaaaaaaaaaaaaaaaac
cccccaaaaabbbbbbbbbbbbbbbbbaaaaaaaaaaaaaaaaabbbabbbaabbbbbbbaaaaaaaaaaaaaaaaaaaaaaaaaaaaaaaaaaaaaaaaaaaaaaaaaaaaaaaaaaaaaaaaaaac
cccccaaaaaaabbbbbbbbbbbbbbaaaaaaacccaaaaaaabbbbaaaaaaaaaaabbbbbaaaaaaaaaaaaaaaaaaaaaaaaaaaaaaaaaaaaaaaaaaaaaaaaaaaaaaaaaaaaaaaac
cccccaaaaaaaabbbbbbbbbbbaaaaaaaaaacccaaaaaabbbbaaaaaacaaaaaaabbbbaaaaaaaaaaaaaaaaaaaaaaaaaaaaaaaaaaaaaaaaaaaaaaaaaaaaaaaaaaaaaac
ccccaaaaaaaaaabbbbbbbbbbaaaaaaaaccccccaaaabbbaaaacaccccaaaaaaabbbbaaaaaaaaaaaaaaaaaaaaaaaaaaaaaaaaaaaaaaaaaaaaaaaaaaaaaaaaaaaaac
ccccaaaaaaaaaaabbbbbbbbaaaaaaaaaaccccaaaabbbaaaacccccccaaaaaaaabbbbaaaaaaaaaaaaaaaaaaaaaaaaaaaaaaaaaaaaaaaaaaaaaaaaaaaaaaaaaaaac
cccaaaaaaaaaaaaabbbbbbbaaaaaaaaaccccccaaabbbbaaccccccccaaaaaaaaaabbbaaaaaaaaaaaaaaaaaaaaaaaaaaaaaaaaaaaaaaaaaaaaaaaaaaaaaaaaaaac
ccaaaaaaaaaaaaaaabbbbbbaaaaaaaaaccccaaaaabbbaaacacccccaaaaaaaaaaaabbbaaaaaaaaaaaaaaaaaaaaaaaaaaaaaaaaaaaaaaaaaaaaaaaaaaaaaaaaaac
caaaaaaaaaaaaaaaabbbbbbaaaaaaaaacccaaaaabbbaaaaaaaaaaaaaaaaaabbaabbbbbaaaaaaaaaaaaaaaaaaaaaaaaaaaaaaaaaaaaaaaaaaaaaaaaaaaaaaaaac
caaaaaaaaaaaaaaaaabbbbbbaaaaaaaaacaaaaabbbbaaaaaaaaaaaaaaaaaabbbbbbbbbbaaaaaaaaaaaaaaaaaaaaaaaaaaaaaaaaaaaaaaaaaaaaaaaaaaaaaaaac
caaaaaaaaaaaaaaaabbbbbbbaaaaaaaaaaaaaaabbbbbaaaaaaaaaaaaabbbbbbbbbbbbbbaaaaaaaaaaaaaaaaaaaaaaaaaaaaaaaaaaaaaaaaaaaaaaaaaaaaaaaac
caaaaaaacccaaaaaaaabbbbbaaaaaaaaaaaaaaabbabbabbaaaaaababbbbbbbbbaaabbbbbaaaaaaaaaaaaaaaaaaaaaaaaaaaaaaaaaaaaaaaaaaaaaaaaaaaaaaac
caaaaaaccccaaaaaaaabbbbbbaaaaaaaaaaaabbbaaabbbbbaaabbbbbbbbaaaaaaaaaabbbbaaaaaaaaaaaaaaaaaaaaaaaaaccccaacacaaaaaaaaaaccaaaaaaaac
caaaaaacccccaaaaaaabbbbbbaaaaaaaaaaabbaaaaaaabbbabbbbbbbaaaaaaaaaaaaaabbbaaaaaaaaaaaaaaaaaaaaccccccccccccccccccccccccccccaaaaaac
caaaaaacccccaaaaaaabbbbbbaaaaaaaaaabbbaaacaaaabbbbbbbaaaaaaaaaaaaaaaaaaabaaaaaaaaaaaaaaaaaaaccccccccccccccacccccccacaccccaaaaaac
caaaaaaccccccaaaaaaabbbbbaaaaaaaaaabbbaaccccaaabbbaaaaaaaaaaaacccaaaaaaabbaaaaaaaaaaaaaaaaccccccaaabbbaabbbbbbbbbbbbbacccccccaac
caaaaaaccccccaaaaaaabbbbbaaaaaaaaaabbaaaccccaaaabbbaaaaaaaaccccccaaaaaaabbaaaaaaaaaaaaaaaaccabbbbbbbbbbbbbbbbbbbbbbbbbbbbccccccc
caaaaaacccccccaaaaaabbbbbaaaaaaaaabbbaaccccccaaaabbaaaaaaaaacccccaaaaaaaabbbaaaaaaaaaaaaaccbbbbbbbbbbbbbbbbbbbbbbbbbbbbbbbaacccc
caaaaaaaccccccaaaaaabbbbbaaaaaaaaabbaaaccccccaaaaabbaaaaaaaaaccccaaaaaaaabbaaaaaaaaaaaaaaccbbbbbbbbbbbbbbbbbbbbbbbbbbbbbbbbbaccc
caaaaaaaccccccaaaaaabbbbbaaaaaaaaabbaaaacccacaaaaabbbaaaaaaaaaccaaaaaaaabbbaaaaaaaaaaaaaccbbbbbbbbbbbbbbbbbbbbbbbbbbbbbbbbbbaccc
caaaaaaaaccccaaaaaaabbbbbaaaaaaaaabbbaaaccccaaaaaaabbaaaaaaaaaaaaaaaaabbbbaaaaaaaaaaaaaacccbbbbbbbbbbbbbbbbbbbbbbbbbbbbbbbbbaccc
caaaaaaaaaaaaaaaaaaabbbbbbaaaaaaaaabbbaaaaaaaaaaaaabbbaaaaaaaaaaaaaaaabbbbaaaaaaaaaaaaaaccbbbbbbbbbbbbbbbbbbbbbbbbbbbbbbbbbbaccc
caaaaaaaaaaaaaaaaaaabbbbbbaaaaaaaaaabbbaaaaaaaaaaaabbbaaaaaaaaaaaaaaabbbbaaaaaaaaaaaaaaaccbbbbbbbbbbbbbbbbbbbbbbbbbbbbbbbbbbaccc
caaaaaaaaaaaaaaaaaabbbbbbbaaaaaaaaaaabbbaaaaaaaaaaaabbbaaaaaaaaaaabbbbbbaaaaaaaaaaaaaaaacccbbbbbbbbbbbbbbbbbbbbbbbbbbbbbbbbbaacc
caaaaaaaaaaaaaaaaaabbbbbbaaaaaaaaaaaaabbbbaaaaaaaaaabbbaaaaaabbbbbbbbbaaaaaaaaaaaaaaaaaacccabbbbbbbbbbbbbbbbbbbbbbbbbbbbbbbaaccc
caaaaaaaaaaaaaaaaabbbbbbbaaaaaaaaaaaaaaaabbbbbaaababbbbaaabbbbbbbbbaaaaaaaaaaaaaaaaaaaaacccbbbbbbbbbbbbbbbbbbbbbbbbbbbbbbbbaaccc
caaaaaaaaaaaaaaaaabbbbbbbaaaaaaaaaaaaaaaaaaabbbbbbbbbbbabbbbbbbbaaaaaaaaaaaaaaaaaaaaaaaaaccabbbbbbbbbbbbbbbbbbbbbbbbbbbbbbbbaccc
caaaaaaaaaaaaaaaaabbbbbbbaaaaaaaaaaaaaaaaaaaaaaabbbbbbbbbbbbbbaaaaaaaaaaaaaaaaaaaaaaaaaaacccbbbbbbbbbbbbbbbbbbbbbbbbbbbbbbbbaccc
caaaaaaaaaaaaaaaaabbbbbbaaaaaaaaaaacccccaaaaaaaaaabbbbbbbbabbaaaaaaaaaaaaaaaaaaaaaaaaaaaacccbbbbbbbbbbbbbbbbbbbbbbbbbbbbbbbaaccc
caaaaaaaaaaaaaaaabbbbbabaaaaaaaaacccccccaaaaaaaaaaabbbbbbaaaaaaaaaaaaaaaaaaaaaaaaaaaaaaaaaccabbbbbbbbbbbbbbbbbbbbbbbbbbbbbbaaccc
caaaaaaaaaaaaaaaabbbbbbaaaaaaaaaccccccccccaaaaaabbbbbbaaaaaaaaaaaaaaaaaaaaaaaaaaaaaaaaaaaacccbbbbbbbbbbbbbbbbbbbbbbbbbbbbbbaaccc
caaaaaaaaaaaaaaaabbbbaaaaaaaaaacccccccccaaaaaabbbbbbbaaaaaaaaaaaaaaaaaaaaaaaaaaaaaaaaaaaaacccbbbbbbbbbbbbbbbbbbbbbbbbbbbbbbacccc
caaaaaaaaaaaaaaabbbbbaaaaaaaaaaaaacccaaaaaaabbbbbaaaaaaaaaaaaaaaaaaaaaaaaaaaaaaaaaaaaaaaaaaccbbbbbbbbbbbbbbbbbbbbbbbbbbbbbbacccc
caaaaaaaaaaaaaaabbbbaaaaaaaaaaaaaaaaaaaaaaaabbbbbaaaaaccaaaaaaaaaaaaaaaaaaaaaaaaaaaaaaaaaaacccbbbbbbbbbbbbbbbbbbbbbbbbbbbbbacccc
caaaaaaaaaaaaaaabbbaaaaaaabaaaaaaaaaaaaaaabbbbbaaaaaacccaaaaaaaaaaaaaaaaaaaaaaaaaaaaaaaaaaaaccbbbbbbbbbbbbbbbbbbbbbbbbbbbbbacccc
caaaaaaaaaaaaaaabbbaaaaaaabbaaaaaaaaaaaaabbbbbbaaaacccccaaaaaaaaaaaaaaaaaaaaaaaaaaaaaaaaaaaaccabbbbbbbbbbbbbbbbbbbbbbbbbbbaccccc
caaaaaaaaaaaaaaabbbaaaaaabbbbbbaaaaaaaaaabbbbbaaaaaccccccaaaaaaaaaaaaaaaaaaaaaaaaaaaaaaaaaaaacccbbbbbbbbbbbbbbbbbbbbbbbbbbaacccc
caaaaaaaaaaaaaaaabbaaaaaabbbbbbaaaaaaaaaabbbbbaaaaaccccccaaaaaaaaaaaaaaaaaaaaaaaaaaaaaaaaaaaaaccccbbbbbbbbbbbbbbbbbbbbbbbbaacccc
caaaaaaaaaaaaaaabbbbaaaaabbbbbbaaaaaaaaaaabbbaaaaaacccccccaaaaaaaaaaaaaacccccccccaaaaaaaaaaaaaaccccbbbbbbbbbbbbbbbbbbbbbaaaccccc
caaaaaaaaaaaaaaabbbbaaaaabbbbbbaaaaaaaaaaabbbbbaaaaaccccccaaaaaaaaaaaaacccccccccccccaaaaaaaaaaaccccbbbbbbbbbbbbbbbbbbbbaaacccccc
caaaaaaaaaaaaaaababbbaaaaababbaaaaaaaaaaaaabbbbaaaacccccccaaaaaaaaaaaaaccccccccccccccccaaaaaaaaaacccbbbbbbbbbbbbbbbbbbaaaacccccc
caaaaaaaaaaaaaaaabbbbbaaaaaaaaaaaaaaaaaaaaabbbbbaaaaacccccaaaaaaaaaacccccbbbbbbbbcccccccccaaaaaaaaccaabbbbbbbbbbaaaaaaaaaccccccc
caaaaaaaaaaaaaaaaabbbbaaaaaaaaaaaaaaaaaaaaabbbbbaaaaacccccaaaaaaaaaaccccbbbbbbbbbbccbcccccaaaaaaaaaccccbbbbbbbaaaaaaaaaccccccccc
caaaaaaaaaaaaaaaaabbbbbaaaaaaaaaaaccaaaaaaaabbbbbaaaaaaaccaaaaaaaaacccbbbbbbbbbbbbbbbbbcccaaaaaaaaaaacccbbbbbaaaaaaccccccccccccc
caaaaaaaaaaaaaaaaaaabbbaaaaaaaaaacccccaaaaaaabbbbbaaaaaaaaaaaaaaaacccbbbbbbbbbbbbbbbbbbbcccaaaaaaaaaaacccbbbbaaaaacccccccccccccc
caaaaaaaaaaaaaaaaaaaabbbbaaaaaaaacccccccaaaaaabbbbaaaaaaaaaaaaaaaacccbbbbbbbbbbbbbbbbbbbccccaaaaaaaaaaaccabbbaaaaccccccccccccccc
caaaaaaaaaaaaaaaaaaaaabbbaaaaaaaacccccaaaaaaaabbbbbaaaaaaaaaaaaaaacccbbbbbbbbbbbbbbbbbbbccccaaaaaaaaaaaaaabbbaaaaccccccccccccccc
caaaaaaaaaaaaaaaaaaaaabbbbbaaaaaaaacccccaaaaaaabbbbbaaaaaaaaaaaaaacccbbbbbbbbbbbbbbbbbbbcccaaaaaaaaaaaaaaabbbbaaaccccccccccccccc
caaaaaaaaacaaaaaaaaaaaaabbbaaaaaaaacccccccaaaaabbbbbaaaaaaaaaaaaaaccccbbbbbbbbbbbbbbbbbbccccaaaaaaaaaaaaaabbbbaaaccccccccccccccc
caaaaaaaaaccccaaaaaaaaaabbbbaaaaaaaaccccaacaaaaabbbbbbaaaaaaaaaaaacccccbbbbbbbbbbbbbbbbbccccaaaaaaaaaaaaaababbaaaacccccccccccccc
caaaaaaaaacacccaaaaaaaaaaabbbaaaaaaaccccccaaaaaaabbbbbaaaaaaaaaaaaacccccbbbbbbbbbbbbbbbccccaaaaaaaaaaaaaaababbaaaaaccccccccccccc
caaaaaaaaaacccccaaaaaaaaaabbbbaaaaaaacccccaaaaaaabbbbbbaaaaaaaaaaaaaccccbbbbbbbbbbbbbbcccccaaaaaaaaaaaaaaaaaabaaaaaccccccccccccc
caaaaaaaaaaccccccaaaaaaaaaaabbbaaaaaacccccacaaaaabbbbbbaaaaaaaaaaaaacccccccbbbbbbbbbbccccccaaaaaaaaaaaaaaaaaabbaaaaccccccccccccc
caaaaaaaaaacccccaaaaaaaaaaaaabbbaaaaaaccccccaaaaaaaabbbbbbaaaaaaaaaaaaccccccbbbbcccccccacccaaaaaaaaaaaaaaaaaaabbaaaccccccccccccc
caaaaaaaaaaaccccccaaaaaaaaaaaabbbaaaaaaccacaaaaaaaaaaabbbbbbaaaaaaaaaaaccccccbbbccccccccaaaaaaaaaaaaaaaaaaaaaabbbaaacccccccccccc
caaaaaaaaaaaacccccaaaaaaaaaaaaabbbaaaaaaaaaaaaaaaaaaaaabbbbbbaaaaaaaaaaacccccbbbccaaaaaaaaaaaaaaaaaaaaaaaaaaaaabbaaacccccccccccc
caaaaaaaaaaaaaacccaaaaaaaaaaaaaabbbaaaaaaaaaaaaaaaaaaaaaabbbbaaaaaaaaaaaaaaaabbbaaaaaaaaaaaaaaaaaaaaaaaaaaaaaaaabbaaaccccccccccc
caaaaaaaaaaaaaaaaaaaaaaaaaaaaaaaabbaaaaaaaaaaaaabaaaaaaaaabbbbaaaaaaaaaaaaaaabbbaaaaaaaaaaaaaaaaaaaaaaaaaaaaaaaabbbaaacccccccccc
caaaaaaaaaaaaaaaaaaaaaaaaaaaaaaaaabbaaaaaaaaabbbbbaaaaaaaabbbbaaaaaaaaaaaaaaabbbaaaaaaaaaaaaaaaaaaaaaaaaaacccaaaabbbaacccccccccc
caaaaaaaaaaaaaaaaaaaaaaabbbaaaaaaabbaaaaaaaabbbbbbbaaaaaaaabbbbaaaaaaaaaaaaabbbbaaaaaaaaaaaaaaaaaaaaaaaccccccaaaaabbaacccccccccc
caaaaaaaaaaaaaaaaaaaaaaabbbaaaaaaabbbaaaaaaabbbbbbbaaaaaaaabbbbbaaaaaaaaaaabbbbaaaaaaaaaaaaaaaaaaaaaaacccccccaaaaabbaaaccccccccc
caaaaaaaaaaaaaaaaaaaaabbbbbbaaaaaaabbaaaaaabbbbbbbbaaaaaaaabbbbbaaaaaaaaaaabbbbaaaaaaaaaaaaaaaaaaaaaccccccccaaaaaabbaaaacccccccc
caaaaaaaaaaaaaaaaaaaabbbbbbaaaaaaaabbbaaaaaabbbbbbbaaaaaaaabbbbbbbaaaaaabbbbbbbaaaaaaaaaaaaaaaaaaaaaccccccccaaaaabbbaaaaaccccccc
caaaaaaaaaaaaaaaaaaaabbbbbbaaaaaaaaabbaaaaaaaaaaaaaaaaaaaabbbbbbbbbbbaaabbbbbbaaaaaaaaaaaaaaaaaaaaaacccaccaaaaaabbbbaaaaaccccccc
caaaaaaaaaaaaaaaaaaaabbbbbaaaaaaaaaabbaaaaaaaaaaaaaaaaaaaabbbbbbbbbbbbbbbbbbbbaaaaaaaaaaaaaaaaaaaaaaaaaaaaaaaaabbbbaaaaaaacccccc
caaaaaaaaaaaaaaaaaaaaabbbaaaaaaaaaabbbaaaaaaaaaaaaaaaaaaabbbbbabbbbbbbbbbbbbbaaaaaaaaaaaaaaaaaaaaaaaaaaaaaaaabbbbaaaaaaaaacccccc
caaaaaaaaaaaaaaaaaaaaaaaaaaaaaaaaaabbbbbaaaaaaaaaaaaabbbbbbbbaaaabbbbbbbbbbbbbbbaaaaaaaaaaaaaaaaaaaaaaaaaababbbbaaaaaaaaaccccccc
caaaaaaaaaaaaaaaaaaaaaaaaaaaaaaaaaabbbbbbbbbbbbbbbbbbbbbbbbbaaaaaaaaabbbbbbbbbbbbabbbbbaaaaaaaaaaaaabbabbbbbbbbaaaaaaaaaaccccccc
caaaaaaaaaaaaaaaaaaaaaaaaaaaaaaaaaabababbbbbbbbbbbbbbbbbbbbbaaaaaaaaaaaaabbbbbbbbbbbbbbbbbbbababaabbbbbbbbbbbaaaaaaaaaaaaccccccc
caaaaaaaaaaaaaaaaaaaaaaaaaaaaaaaaaaaaaabbbaaabababbbbbaaaaaaaaaaaaaaaaaaaaaaaaabbbbbbbbbbbbbbbbbbbbbbbbbbbbaaaaaaaaaaaaacccccccc
caaaaaaaaaaaaaaaaaaaaaaaaaaaaaaaaaaaaaaaaaaaaaaaaaaaaaaaaaaaaaaaaaaaaaaaaaaaaaaaaaaaabbbbbbbbabbbbabbabbbbaaaaaaaaaaaaaacccccccc
caaaaaaaaaaaaaaaaaaaaaaaaaaaaaaaaaaaaaaaaaaaaaaaaaaaaaaaaaaaaaaaaaaaaaaaaaaaaaaaaaaaaaaaaaaaaaaaaaaaaaaaaaaaaaaaaaaaaaaccccccccc
caaaaaaaaaaaaaaaaaaaaaaaaaaaaaaaaaaaaaaaaaaaaaaaaaaaaaaaaaaaaaaaaaaaaaaaaaaaaaaaaaaaaaaaaaaaaaaaaaaaaaaaaaaaaaaaaaaaaaaccccccccc
caaaaaaaaaaaaaaaaaaaaaaaaaaaaaaaaaaaaaaaaaaaaaaaaaaaaaaaaaaaaaaaaaaaaaaaaaaaaaaaaaaaaaaaaaaaaaaaaaaaaaaaaaaaaaaaaaaaaaaccccccccc
caaaaaaaaaaaaaaaaaaaaaaaaaaaaaaaaaaaaaaaaaaaaaaaaaaaaaaaaaaaaaaaaaaaaaaaaaaaaaaaaaaaaaaaaaaaaaaaaaaaaaaaaaaaaaaaaaaaaaaccccccccc
caaaaaaaaaaaaaaaaaaaaaaaaaaaaaaaaaaaaaaaaaaaaaaaaaaaaaaaaaaaaaaaaaaaaaaaaaaaaaaaaaaaaaaaaaaaaaaaaaaaaaaaaaaaaaaaaaaaaaaccccccccc
caaaaaaaaaaaaaaaaaaaaaaaaaaaaaaaaaaaaaaaaaaaaaaaaaaaaaaaaaaaaaaaaaaaaaaaaaaaaaaaaaaaaaaaaaaaaaaaaaaaaaaaaaaaaaaaaaaaaacccccccccc
caaaaaaaaaaaaaaaaaaaaaaaaaaaaaaaaaaaaaaaaaaaaaaaaaaaaaaaaaaaaaaaaaaaaaaaaaaaaaaaaaaaaaaaaaaaaaaaaaaaaaaaaaaaaaaaaaaaaccccccccccc
caaaaaaaaaaaaaaaaaaaaaaaaaaaaaaaaaaaaaaaaaaaaaaaaaaaaaaaaaaaaaaaaaaaaaaaaaaaaaaaaaaaaaaaaaaaaaaaaaaaaaaaaaaaaaaaaaaacccccccccccc
caaaaaaaaaaaaaaaaaaaaaaaaaaaaaaaaaaaaaaaaaaaaaaaaaaaaaaaaaaaaaaaaaaaaaaaaaaaaaaaaaaaaaaaaaaaaaaaaaaaaaaaaaaaaaaaaaaacccccccccccc
caaaaaaaaaaaaaaaaaaaaaaaaaaaaaaaaaaaaaaaaaaaaaaaaaaaaaaaaaaaaaaaaaaaaaaaaaaaaaaaaaaaaaaaaaaaaaaaaaaaaaaaaaaaaaaaaacccccccccccccc
caaaaaaaaaaaaaaaaaaaaaaaaaaaaaaaaaaaaaaaaaaaaaaaaaaaaaaaaaaaaaaaaaaaaaaaaaaaaaaaaaaaaaaaaaaaaaaaaaaaaaaaaaaaaaaaaacccccccccccccc
caaaaaaaaaaaaaaaaaaaaaaaaaaaaaaaaaaaaaaaaaaaaaaaaaaaaaaaaaaaaaaaaaaaaaaaaaaaaaaaaaaaaaaaaaaaaaaaaaaaaaaaaaaaaaaaaacccccccccccccc
caaaaaaaaaaaaaaaaaaaaaaaaaaaaaaaaaaaaaaaaaaaaaaaaaaaaaaaaaaaaaaaaaaaaaaaaaaaaaaaaaaaaaaaaaaaaaaaaaaaaaaaaaaaaaaaaccccccccccccccc
caaaaaaaaaaaaaaaaaaaaaaaaaaaaaaaaaaaaaaaaaaaaaaaaaaaaaaaaaaaaaaaaaaaaaaaaaaaaaaaaaaaaaaaaaaaaaaaaaaaaaaaaaaaaccccccccccccccccccc
caaaaaaaaaaaaaaaaaaaaaaaaaaaaaaaaaaaaaaaaaaaaaaaaaaaaaaaaaaaaaaaaaaaaaaaaaaaaaaaaaaaaaaaaaaaaaaaaaaaaaacaccccccccccccccccccccccc
cccccccccccccccccccccccccccccccccccccccccccccccccccccccccccccccccccccccccccccccccccccccccccccccccccccccccccccccccccccccccccccccc
"}
